"SurveyID","nb_species","aesthe_survey","aesthe_SR_survey","nb_sp_pos_survey","nb_sp_neg_survey"
"10000001",47,1689.65738901202,2602.36394728806,10,37
"10000002",36,1876.99584729396,2464.33502634194,9,27
"10000003",26,1906.88693352526,2305.75108410937,9,17
"10000004",22,1794.72974512693,2228.3491786518,7,15
"10000006",26,1849.85532559623,2305.75108410937,6,20
"10000007",14,1796.22618430527,2031.70713799962,4,10
"10000008",11,1839.7204177948,1933.98659929558,1,10
"10000009",12,1668.33241852466,1968.69006049611,3,9
"10000010",12,1823.64631809646,1968.69006049611,1,11
"10000011",17,1825.91576043503,2113.95669457394,5,12
"10000012",14,1828.86351035815,2031.70713799962,3,11
"10000013",28,1975.45302094827,2340.94327947849,9,19
"10000014",34,1905.4196025513,2435.71163614839,12,22
"10000015",24,1860.80866207597,2268.33468283819,9,15
"10000016",17,1694.11234350228,2113.95669457394,5,12
"10000017",24,1953.86612760003,2268.33468283819,5,19
"10000018",24,1860.48219808173,2268.33468283819,5,19
"10000019",22,2029.0387647882,2228.3491786518,4,18
"10000020",35,2000.29842930584,2450.1860183293,8,27
"10000021",23,1942.1481174765,2248.68783741607,6,17
"10000022",31,1998.07090284555,2390.15469389133,9,22
"10000023",23,1935.86858041663,2248.68783741607,5,18
"10000024",22,1892.03698802097,2228.3491786518,7,15
"10000025",23,1901.17214329471,2248.68783741607,8,15
"10000026",33,1895.03822870217,2420.89448855093,10,23
"10000027",34,1850.07581443343,2435.71163614839,7,27
"10000028",27,1863.79393150102,2323.60649590586,5,22
"10000029",33,1828.62006918989,2420.89448855093,10,23
"10000030",27,2087.80410690636,2323.60649590586,13,14
"10000031",28,1989.37828008576,2340.94327947849,8,20
"10000032",30,1976.34049782605,2374.18906024059,8,22
"10000033",30,1985.75621545174,2374.18906024059,7,23
"10000034",25,1912.89309755213,2287.34065519221,8,17
"10000035",22,1949.56424095665,2228.3491786518,7,15
"10000036",32,1981.83733764749,2405.71569249515,7,25
"10000038",33,1709.27497442523,2420.89448855093,8,25
"10000039",25,1952.45859773346,2287.34065519221,6,19
"10000040",30,1758.5196459306,2374.18906024059,7,23
"10000041",28,2060.1337880786,2340.94327947849,7,21
"10000042",20,1885.64703641527,2185.35845629437,6,14
"10000043",25,2002.90762519614,2287.34065519221,7,18
"10000044",16,1957.22880360216,2087.92318348224,1,15
"10000045",23,1899.96912537419,2248.68783741607,2,21
"10000046",20,1958.99932733398,2185.35845629437,3,17
"10000047",21,1986.12262453953,2207.26116887512,3,18
"10000048",20,2047.31721678014,2185.35845629437,4,16
"10000049",23,2073.83605001639,2248.68783741607,5,18
"10000050",22,2122.39911426602,2228.3491786518,4,18
"10000051",28,2093.16666329495,2340.94327947849,6,22
"10000052",22,2024.33547595696,2228.3491786518,3,19
"10000053",20,1969.02141939206,2185.35845629437,2,18
"10000054",19,1896.64386047544,2162.56636020013,4,15
"10000055",23,2014.62924219693,2248.68783741607,3,20
"10000056",27,1904.82266212284,2323.60649590586,5,22
"10000057",26,1954.86683162799,2305.75108410937,4,22
"10000058",23,2047.54958739718,2248.68783741607,3,20
"10000059",19,1996.66714526275,2162.56636020013,4,15
"10000060",46,1914.41016330168,2590.94954296761,6,40
"10000061",30,2015.5307683192,2374.18906024059,2,28
"10000062",48,1878.53979653229,2613.58673801098,10,38
"10000063",39,1859.23233863237,2504.98447234734,6,33
"10000064",13,1950.26066598413,2001.16379457045,1,12
"10000065",27,2273.43349117556,2323.60649590586,2,25
"10000066",27,1979.63369229289,2323.60649590586,4,23
"10000067",25,2045.88601180584,2287.34065519221,5,20
"10000068",38,1961.62446915845,2491.71993967651,9,29
"10000069",31,1982.43583049537,2390.15469389133,3,28
"10000070",33,2065.19687538944,2420.89448855093,5,28
"10000071",21,1906.62024201561,2207.26116887512,2,19
"10000072",22,1887.22438930971,2228.3491786518,3,19
"10000073",27,1951.84715774092,2323.60649590586,2,25
"10000074",23,1811.49221768779,2248.68783741607,1,22
"10000075",25,1910.34270802815,2287.34065519221,2,23
"10000076",29,2303.81011508469,2357.79423966008,4,25
"1003253",7,1559.8151853441,1763.32076508842,1,6
"1003254",13,1663.62695009119,2001.16379457045,2,11
"1003255",11,1640.36749544789,1933.98659929558,1,10
"1003256",9,1599.30197343925,1856.26587460569,1,8
"1003257",14,1634.03090222011,2031.70713799962,3,11
"1003258",14,1652.11556309622,2031.70713799962,2,12
"1003259",6,1522.38740446081,1708.62817714657,0,6
"1003260",1,1150.67276488192,1184.66451052022,1,0
"1003261",1,1150.67276488192,1184.66451052022,1,0
"1003262",1,1150.67276488192,1184.66451052022,1,0
"1003263",15,1593.82620679338,2060.56118614118,4,11
"1003264",8,1655.03112680806,1812.11073017574,2,6
"1003265",14,1628.7471848617,2031.70713799962,3,11
"1003266",15,1656.95688222986,2060.56118614118,2,13
"1003267",17,1684.78242192917,2113.95669457394,3,14
"1003268",12,1632.78388073325,1968.69006049611,1,11
"1003269",16,1674.21679900608,2087.92318348224,3,13
"1003270",10,1633.2476523296,1896.67490607898,2,8
"1003271",15,1582.61238885653,2060.56118614118,3,12
"1003272",10,1674.62376777482,1896.67490607898,2,8
"1003273",6,1575.89362503288,1708.62817714657,0,6
"1003274",6,1603.32514092396,1708.62817714657,0,6
"1003275",5,1580.49112338288,1646.12614877363,0,5
"1003276",7,1596.2473738543,1763.32076508842,1,6
"1003277",3,1387.60699582282,1482.92019466158,1,2
"1003278",39,2599.42314243449,2504.98447234734,11,28
"1003280",35,2516.49181799662,2450.1860183293,9,26
"1003281",28,2351.62397354974,2340.94327947849,9,19
"1003282",29,2464.4883646079,2357.79423966008,6,23
"1003283",32,2364.8507817237,2405.71569249515,6,26
"1003284",35,2532.97864671476,2450.1860183293,11,24
"1003285",35,2530.87691459948,2450.1860183293,13,22
"1003286",42,2557.54060457247,2543.21752514954,9,33
"1003287",35,2400.7629484452,2450.1860183293,13,22
"1003288",47,2784.98042378518,2602.36394728806,13,34
"1003289",33,2413.63770571857,2420.89448855093,9,24
"1003290",8,1667.45946380247,1812.11073017574,0,8
"1003291",34,2561.13719572092,2435.71163614839,8,26
"1003292",33,2533.97804565574,2420.89448855093,15,18
"1003629",33,2569.58938349731,2420.89448855093,10,23
"1003630",21,2243.91064218312,2207.26116887512,6,15
"1003631",28,2364.61648982158,2340.94327947849,8,20
"1003632",19,2139.88571142237,2162.56636020013,5,14
"1003633",34,2368.88365902195,2435.71163614839,8,26
"1003634",33,2309.28114110992,2420.89448855093,10,23
"1003635",28,2447.20059263555,2340.94327947849,10,18
"1003636",38,2340.06429993657,2491.71993967651,12,26
"1003637",33,2415.25867162178,2420.89448855093,9,24
"1003638",28,2348.87319718083,2340.94327947849,7,21
"1003639",31,2344.15793606863,2390.15469389133,9,22
"1003640",34,2437.06780045695,2435.71163614839,11,23
"1003641",30,2340.80328626336,2374.18906024059,9,21
"1003642",42,2499.51114830787,2543.21752514954,12,30
"1003643",37,2306.47154307044,2478.17471526668,13,24
"1003644",29,2232.23818748268,2357.79423966008,9,20
"1003645",28,2418.81128723172,2340.94327947849,11,17
"1003646",37,2396.50421975434,2478.17471526668,14,23
"1003647",35,2290.96102130184,2450.1860183293,11,24
"1003648",35,2294.50371235196,2450.1860183293,13,22
"1003649",36,2363.75167225217,2464.33502634194,13,23
"1003650",37,2416.61061153113,2478.17471526668,11,26
"1003651",36,2159.70793735488,2464.33502634194,10,26
"1003652",31,2463.04104872067,2390.15469389133,12,19
"1003653",28,2354.30354670168,2340.94327947849,9,19
"1003654",26,2558.94586740275,2305.75108410937,8,18
"1003655",23,2348.3300380793,2248.68783741607,9,14
"1003656",20,2284.70853147766,2185.35845629437,6,14
"1003657",20,2251.54287482032,2185.35845629437,7,13
"1003659",23,2458.50749482836,2248.68783741607,6,17
"1003660",25,2498.41922398817,2287.34065519221,8,17
"1003661",30,2583.69920239004,2374.18906024059,9,21
"1003662",29,2594.25524156462,2357.79423966008,8,21
"1003663",28,2572.62780966433,2340.94327947849,9,19
"1003664",28,2469.94837409552,2340.94327947849,7,21
"1003665",31,2451.73225172032,2390.15469389133,9,22
"1003666",36,2471.22942971928,2464.33502634194,14,22
"1003667",39,2548.59281446504,2504.98447234734,13,26
"1003668",29,2555.36773762609,2357.79423966008,11,18
"1003669",35,2731.92288603869,2450.1860183293,16,19
"1003670",36,2412.44322316614,2464.33502634194,10,26
"1003671",28,2525.40713342215,2340.94327947849,9,19
"1003672",32,2379.26235170032,2405.71569249515,8,24
"1003673",35,2566.58484109583,2450.1860183293,12,23
"1003674",34,2465.04383976526,2435.71163614839,12,22
"1003675",44,2567.87607010656,2567.51523707907,13,31
"1003676",34,2508.91967784241,2435.71163614839,12,22
"1003677",37,2515.61435022753,2478.17471526668,12,25
"1003678",36,2298.04441962733,2464.33502634194,11,25
"1003679",42,2600.64532284612,2543.21752514954,16,26
"1003680",43,2469.95236639491,2555.47878346624,14,29
"1003681",23,2459.84235153874,2248.68783741607,7,16
"1003682",34,2708.38651033587,2435.71163614839,10,24
"1003683",34,2573.53848724014,2435.71163614839,11,23
"1003684",41,2616.75683716736,2530.72175773865,11,30
"1003685",35,2633.70937054913,2450.1860183293,10,25
"1003686",33,2685.55709691865,2420.89448855093,10,23
"1003687",27,2451.9053672332,2323.60649590586,9,18
"1003688",38,2669.44695471947,2491.71993967651,11,27
"1003689",31,2354.62396032077,2390.15469389133,10,21
"1003690",34,2544.40650557153,2435.71163614839,10,24
"1003691",24,2369.30234801728,2268.33468283819,4,20
"1003692",29,2353.49558423624,2357.79423966008,8,21
"1003693",28,2132.40321025858,2340.94327947849,8,20
"1003694",30,2504.55563112695,2374.18906024059,7,23
"1003695",31,2582.51426934081,2390.15469389133,9,22
"1003696",28,2568.5430301636,2340.94327947849,9,19
"1003697",29,2358.97324963464,2357.79423966008,9,20
"1003698",34,2528.93356846857,2435.71163614839,10,24
"1003699",31,2300.40549794101,2390.15469389133,9,22
"1003745",8,1555.2193063325,1812.11073017574,2,6
"1003746",12,1719.0115442953,1968.69006049611,1,11
"1003747",7,1610.203008296,1763.32076508842,1,6
"1003748",14,1644.88365890905,2031.70713799962,2,12
"1003749",13,1632.24842566319,2001.16379457045,1,12
"1003750",9,1576.27803850556,1856.26587460569,1,8
"1003752",18,1668.29782620052,2138.79896507223,2,16
"1003753",9,1624.51221922217,1856.26587460569,0,9
"1003754",8,1644.51914432814,1812.11073017574,0,8
"1003755",7,1544.87819161923,1763.32076508842,0,7
"1003756",1,1150.67276488192,1184.66451052022,1,0
"1003759",13,1714.39443232687,2001.16379457045,2,11
"1003760",10,1640.50834838406,1896.67490607898,2,8
"1003761",11,1615.9415287469,1933.98659929558,1,10
"1003762",15,1689.7809688184,2060.56118614118,2,13
"1003763",19,1660.50749246251,2162.56636020013,4,15
"1003764",11,1674.05533716266,1933.98659929558,2,9
"1003765",16,1651.59378274374,2087.92318348224,1,15
"1003766",18,1762.30976051701,2138.79896507223,2,16
"1003767",13,1704.78268323471,2001.16379457045,1,12
"1003768",10,1726.29097995115,1896.67490607898,1,9
"1003769",16,1703.00806198894,2087.92318348224,1,15
"1003770",19,1656.65561537282,2162.56636020013,3,16
"1003771",12,1627.87928973119,1968.69006049611,1,11
"1003772",7,1616.65356014194,1763.32076508842,1,6
"1003773",7,1610.91176393372,1763.32076508842,0,7
"1003774",5,1570.12035788643,1646.12614877363,1,4
"1003775",8,1588.02382636428,1812.11073017574,2,6
"1003776",2,1279.14294090708,1364.97646362037,1,1
"1003777",52,2442.17210291609,2656.6981055205,13,39
"1003778",55,2331.3458252082,2687.33120998132,19,36
"1003780",22,2301.32626332581,2228.3491786518,8,14
"1003781",28,2412.2425624265,2340.94327947849,8,20
"1003782",35,2741.58832982261,2450.1860183293,11,24
"1003783",30,2602.70317597014,2374.18906024059,9,21
"1003784",46,2393.8729028374,2590.94954296761,13,33
"1003785",42,2495.59110687558,2543.21752514954,15,27
"1003786",43,2578.96652662051,2555.47878346624,14,29
"1003787",32,2604.41244072265,2405.71569249515,10,22
"1003788",5,1578.7823856886,1646.12614877363,0,5
"1003793",49,2531.28689088782,2624.62502504328,15,34
"20003005",45,3186.43387128054,2579.33597919865,15,30
"20003006",51,3072.64764889739,2646.17454577679,17,34
"20003007",55,3373.87316682006,2687.33120998132,20,35
"20003008",49,3013.98362530378,2624.62502504328,19,30
"20003009",52,3506.59939398533,2656.6981055205,17,35
"20003010",54,3069.45363885355,2677.2712016452,18,36
"20003011",48,2910.54347426911,2613.58673801098,17,31
"20003012",57,3324.46931507967,2707.02236739438,19,38
"20003013",55,3273.83703416461,2687.33120998132,20,35
"20003014",75,3023.36654893458,2863.21031780169,23,52
"20003015",52,3291.03247083176,2656.6981055205,18,34
"20003016",53,3360.76510014607,2667.061866114,21,32
"20003017",41,2808.85927766438,2530.72175773865,16,25
"2000855",12,1831.03960630198,1968.69006049611,1,11
"2000856",15,1813.20415837695,2060.56118614118,1,14
"2000859",16,1885.32541407951,2087.92318348224,1,15
"2000860",15,1925.24658567902,2060.56118614118,4,11
"2000861",20,1839.85587597545,2185.35845629437,3,17
"2000862",23,1911.32549178039,2248.68783741607,5,18
"2000877",22,2091.11808674225,2228.3491786518,4,18
"2000883",16,1961.73663836444,2087.92318348224,3,13
"2000884",20,1956.7759654094,2185.35845629437,5,15
"2000886",9,1808.72217379731,1856.26587460569,1,8
"2000892",13,1986.32043731387,2001.16379457045,2,11
"2000907",21,1901.8407917098,2207.26116887512,3,18
"2000908",17,1859.50053368309,2113.95669457394,3,14
"2000923",14,1915.80915255643,2031.70713799962,2,12
"2000924",21,1793.5235720677,2207.26116887512,3,18
"2000925",20,1950.15137685518,2185.35845629437,2,18
"2000926",11,1872.83356928338,1933.98659929558,1,10
"2000927",17,1829.32833217977,2113.95669457394,2,15
"2000932",15,1962.85710799761,2060.56118614118,4,11
"2000937",22,1980.97148562706,2228.3491786518,4,18
"2000938",25,2259.95133069053,2287.34065519221,7,18
"2000939",17,2047.82054089468,2113.95669457394,3,14
"2000944",27,1927.91477784173,2323.60649590586,2,25
"2000947",39,2147.52536954658,2504.98447234734,9,30
"2000948",24,1929.51305727688,2268.33468283819,7,17
"2000949",47,2403.19371748099,2602.36394728806,15,32
"2000950",26,1808.42816521812,2305.75108410937,4,22
"2000951",24,1905.28207417844,2268.33468283819,5,19
"2000956",2,1300.18081484961,1364.97646362037,0,2
"2000962",18,2184.93732239914,2138.79896507223,2,16
"2000967",23,1936.70370196604,2248.68783741607,3,20
"2000968",22,1862.13665035943,2228.3491786518,2,20
"2000969",20,1882.34071302714,2185.35845629437,2,18
"2000970",24,1837.22077804676,2268.33468283819,3,21
"2000971",27,1788.62531138796,2323.60649590586,3,24
"2000972",21,1981.16842600969,2207.26116887512,4,17
"2000973",25,1912.92233517524,2287.34065519221,2,23
"2000977",18,1892.90198525689,2138.79896507223,3,15
"2000982",16,1971.57074229864,2087.92318348224,3,13
"2000999",18,1824.60913258601,2138.79896507223,3,15
"2001010",11,1867.03475393615,1933.98659929558,2,9
"2001011",15,1978.72531097672,2060.56118614118,3,12
"2001012",12,1926.62588863135,1968.69006049611,1,11
"2001021",22,1932.53238929216,2228.3491786518,2,20
"2001034",17,1818.31327420593,2113.95669457394,2,15
"2001035",15,1973.08048490353,2060.56118614118,1,14
"2001036",19,1966.24668590229,2162.56636020013,2,17
"2001037",28,2008.64671989838,2340.94327947849,6,22
"2001038",8,1704.08108851868,1812.11073017574,0,8
"2001039",7,1634.21870336394,1763.32076508842,1,6
"2001040",6,1537.05891325745,1708.62817714657,1,5
"2001086",16,1918.90369153943,2087.92318348224,2,14
"2001087",20,1920.08619398628,2185.35845629437,2,18
"2001099",13,1907.22195579225,2001.16379457045,1,12
"2001100",18,1826.79649046997,2138.79896507223,4,14
"2001101",8,1731.2391612929,1812.11073017574,0,8
"2001102",10,1764.27935178657,1896.67490607898,0,10
"2001107",20,1802.7711246854,2185.35845629437,4,16
"2001109",12,1774.59186362922,1968.69006049611,2,10
"2001110",22,1987.77503741329,2228.3491786518,4,18
"2001112",19,2038.58924122488,2162.56636020013,1,18
"2001113",16,1873.26935012761,2087.92318348224,1,15
"2001114",12,1792.19564364168,1968.69006049611,1,11
"2001115",17,1835.72627233996,2113.95669457394,4,13
"2001118",12,1866.83491617615,1968.69006049611,1,11
"2001119",23,1904.14498857156,2248.68783741607,3,20
"2001120",20,1895.42677757028,2185.35845629437,6,14
"2001121",18,1904.38356042023,2138.79896507223,4,14
"2001122",17,2020.69974896713,2113.95669457394,3,14
"2001129",15,1802.74862510933,2060.56118614118,3,12
"2001130",33,2091.61553673422,2420.89448855093,5,28
"2001131",29,2046.87652666389,2357.79423966008,7,22
"2001132",23,1943.04925811097,2248.68783741607,5,18
"2001143",26,2066.85953928684,2305.75108410937,5,21
"2001144",24,2282.56542902973,2268.33468283819,5,19
"2001162",17,1748.63626286724,2113.95669457394,4,13
"2001163",16,1911.50756969215,2087.92318348224,1,15
"2001164",19,1926.27734251003,2162.56636020013,3,16
"2001166",21,1684.11541084739,2207.26116887512,4,17
"2001167",24,1764.25642949754,2268.33468283819,5,19
"2001186",18,1781.64389132971,2138.79896507223,2,16
"2001187",14,1785.11832420549,2031.70713799962,1,13
"2001188",15,1804.25484036846,2060.56118614118,2,13
"2001189",9,1832.73981604943,1856.26587460569,1,8
"2001190",18,1846.04651827023,2138.79896507223,1,17
"2001191",14,1920.20904931445,2031.70713799962,3,11
"2001199",15,1894.18374590031,2060.56118614118,2,13
"2001200",14,1821.70190589594,2031.70713799962,2,12
"2001202",14,1941.80852968028,2031.70713799962,0,14
"2001208",9,1855.21829699257,1856.26587460569,2,7
"2001209",13,1800.13685281988,2001.16379457045,1,12
"2001232",24,2058.84550070802,2268.33468283819,3,21
"2001233",15,1745.90126372711,2060.56118614118,2,13
"2001234",18,1831.00028919844,2138.79896507223,3,15
"2001239",14,2002.6015465889,2031.70713799962,1,13
"2001240",29,1973.99054985728,2357.79423966008,5,24
"2001241",24,2121.49832409983,2268.33468283819,4,20
"2001247",12,1711.74987339218,1968.69006049611,2,10
"2001249",5,1492.31423629774,1646.12614877363,1,4
"2001250",20,1906.34830294643,2185.35845629437,1,19
"2001251",16,1965.16370319245,2087.92318348224,1,15
"2001252",11,1877.69812189983,1933.98659929558,1,10
"2001253",16,1940.72844015682,2087.92318348224,2,14
"2001254",16,1942.0374957135,2087.92318348224,2,14
"2001255",20,1962.65901380381,2185.35845629437,2,18
"2001256",21,1866.37172596229,2207.26116887512,3,18
"2001257",13,1921.64243216003,2001.16379457045,3,10
"2001258",29,1999.83032426943,2357.79423966008,3,26
"2001273",38,2034.31240528003,2491.71993967651,7,31
"2001274",18,1963.74824071913,2138.79896507223,3,15
"2001284",14,1963.83757674651,2031.70713799962,2,12
"2001285",12,1844.36819098565,1968.69006049611,2,10
"2001286",20,2018.18095130494,2185.35845629437,2,18
"2001289",26,1811.68133015835,2305.75108410937,6,20
"2001293",14,1785.03923789584,2031.70713799962,3,11
"2001307",25,2010.27010872025,2287.34065519221,3,22
"2001309",13,1814.5322392848,2001.16379457045,3,10
"2001310",17,1956.83489617104,2113.95669457394,4,13
"2001320",19,1893.3829524567,2162.56636020013,3,16
"2001351",27,1896.8746423047,2323.60649590586,8,19
"2001354",27,1974.37900785198,2323.60649590586,4,23
"2001355",25,1903.48112731767,2287.34065519221,3,22
"2001379",13,1841.07346493372,2001.16379457045,1,12
"2001396",8,1777.11608026464,1812.11073017574,0,8
"2001397",11,1801.48022781902,1933.98659929558,1,10
"2001398",61,2434.05252251878,2744.81051624266,19,42
"2001399",57,2456.1716052801,2707.02236739438,13,44
"2001400",47,2037.47340014917,2602.36394728806,9,38
"2001401",43,2216.2642413607,2555.47878346624,11,32
"2001402",11,1687.50460105239,1933.98659929558,2,9
"2001403",28,2015.57992470422,2340.94327947849,8,20
"2001406",23,1836.91563068812,2248.68783741607,3,20
"2001407",16,1936.26575977255,2087.92318348224,4,12
"2001408",20,1781.27205268579,2185.35845629437,3,17
"2001409",20,1809.29772620175,2185.35845629437,2,18
"2001410",10,1678.09617102621,1896.67490607898,1,9
"2001411",20,1873.51207263471,2185.35845629437,2,18
"2001412",17,1953.77539188561,2113.95669457394,1,16
"2001413",17,1852.6788385735,2113.95669457394,3,14
"2001414",23,1761.89706328214,2248.68783741607,4,19
"2001415",25,1776.93756025582,2287.34065519221,4,21
"2001416",18,1812.95229972292,2138.79896507223,1,17
"2001417",13,1814.98091175983,2001.16379457045,1,12
"2001418",17,1771.36685691595,2113.95669457394,3,14
"2001419",12,1850.16451092533,1968.69006049611,2,10
"2001420",16,1815.07254733102,2087.92318348224,2,14
"2001421",15,1812.2888951688,2060.56118614118,1,14
"2001422",14,1867.80232175168,2031.70713799962,1,13
"2001423",18,1831.80939523932,2138.79896507223,2,16
"2001424",15,1813.79008273168,2060.56118614118,2,13
"2001425",9,1794.13160159059,1856.26587460569,1,8
"2001426",19,1942.85327581198,2162.56636020013,1,18
"2001427",8,1710.83846531384,1812.11073017574,1,7
"2001428",13,1866.50838045915,2001.16379457045,1,12
"2001429",10,1833.779687209,1896.67490607898,1,9
"2001430",19,2040.98673798613,2162.56636020013,2,17
"2001431",15,1961.37777154069,2060.56118614118,1,14
"2001432",19,1939.23254879587,2162.56636020013,2,17
"2001433",12,1980.47847002273,1968.69006049611,1,11
"2001434",23,1913.27409047008,2248.68783741607,3,20
"2001435",22,1825.85373854014,2228.3491786518,2,20
"2001436",10,1776.73113844324,1896.67490607898,1,9
"2001437",16,1837.86373635055,2087.92318348224,3,13
"2001438",14,1777.1777339439,2031.70713799962,1,13
"2001439",19,1905.85454682454,2162.56636020013,2,17
"2001440",14,1813.116441619,2031.70713799962,1,13
"2001441",24,1887.33042314332,2268.33468283819,3,21
"2001442",13,1878.95990029042,2001.16379457045,1,12
"2001443",18,1863.30366726107,2138.79896507223,3,15
"2001444",17,1756.67551939503,2113.95669457394,1,16
"2001459",14,1755.13541718875,2031.70713799962,2,12
"2001460",17,1942.95169415543,2113.95669457394,2,15
"2001470",25,1934.15775435383,2287.34065519221,2,23
"2001471",21,1876.53715825612,2207.26116887512,2,19
"2001472",27,1889.12571202857,2323.60649590586,3,24
"2001473",30,1894.66954708478,2374.18906024059,5,25
"2001478",26,2190.04335960192,2305.75108410937,2,24
"2001479",27,1941.09643178342,2323.60649590586,3,24
"2001480",31,2014.81642206637,2390.15469389133,7,24
"2001481",28,2082.44956430574,2340.94327947849,5,23
"2001482",25,1982.3043726294,2287.34065519221,6,19
"2001483",32,2068.77504652635,2405.71569249515,2,30
"2001484",43,1976.44464514204,2555.47878346624,5,38
"2001485",44,1910.73994329316,2567.51523707907,5,39
"2001517",32,1873.13520527403,2405.71569249515,4,28
"2001518",24,2139.33909681163,2268.33468283819,2,22
"2001519",22,1963.40331813004,2228.3491786518,2,20
"2001520",17,1820.86006614489,2113.95669457394,3,14
"2001546",13,1924.56025090571,2001.16379457045,1,12
"2001547",22,2112.86883538868,2228.3491786518,3,19
"2001548",12,1813.20974292719,1968.69006049611,1,11
"2001549",23,1781.73243457984,2248.68783741607,2,21
"2001562",33,2006.31263711406,2420.89448855093,5,28
"2001579",21,1879.50099024435,2207.26116887512,4,17
"2001580",15,1946.85743126169,2060.56118614118,2,13
"2001581",20,1941.03150503619,2185.35845629437,3,17
"2001582",18,2000.95876194884,2138.79896507223,2,16
"2001585",22,1973.2551281356,2228.3491786518,4,18
"2001588",12,1809.8999038729,1968.69006049611,0,12
"2001589",17,2340.19827495477,2113.95669457394,5,12
"2001590",28,1848.92638826454,2340.94327947849,3,25
"2001591",8,1755.0049988198,1812.11073017574,1,7
"2001749",19,2103.6480966006,2162.56636020013,9,10
"2001750",15,1908.89125996727,2060.56118614118,6,9
"2001751",21,1953.06603251395,2207.26116887512,8,13
"2001790",18,1931.39628265751,2138.79896507223,0,18
"2001791",15,1964.58933056931,2060.56118614118,1,14
"2001792",18,1752.36050882902,2138.79896507223,1,17
"2001798",13,1898.19738912239,2001.16379457045,2,11
"2001801",23,2100.37865766277,2248.68783741607,3,20
"2001802",12,1796.44532625787,1968.69006049611,2,10
"2001805",17,2098.00265278203,2113.95669457394,4,13
"2001806",14,2000.58178580796,2031.70713799962,3,11
"2001807",27,2291.67869365153,2323.60649590586,7,20
"2001808",15,2003.64797544478,2060.56118614118,5,10
"2001809",17,2005.07854233335,2113.95669457394,2,15
"2001810",23,2118.12590433902,2248.68783741607,6,17
"2001811",14,1907.66090505066,2031.70713799962,3,11
"2001812",18,2045.26008370428,2138.79896507223,5,13
"2001815",16,1825.18507177981,2087.92318348224,1,15
"2001816",15,1822.01443589833,2060.56118614118,2,13
"2001817",20,1937.85841105307,2185.35845629437,3,17
"2001818",14,1837.9989053706,2031.70713799962,1,13
"2001819",15,1773.25257007624,2060.56118614118,1,14
"2001820",16,1859.01561327986,2087.92318348224,1,15
"2001821",15,1833.51450054307,2060.56118614118,3,12
"2001822",19,1793.71351637032,2162.56636020013,3,16
"2001823",16,1861.39965225652,2087.92318348224,4,12
"2001824",18,1916.21197592557,2138.79896507223,1,17
"2001825",23,1918.27247799852,2248.68783741607,7,16
"2001826",18,1907.30966966369,2138.79896507223,1,17
"2001832",17,2113.36604706492,2113.95669457394,4,13
"2001833",16,1992.97959823886,2087.92318348224,6,10
"2001834",19,1919.84768038179,2162.56636020013,3,16
"2001835",19,1978.7057200311,2162.56636020013,3,16
"2001846",22,2081.09971247437,2228.3491786518,4,18
"2001847",19,2061.35298409999,2162.56636020013,6,13
"2001848",18,1998.69009701495,2138.79896507223,3,15
"2001849",20,1999.35427415369,2185.35845629437,3,17
"2001850",20,1851.78083648237,2185.35845629437,3,17
"2001851",21,1966.23129585499,2207.26116887512,1,20
"2001852",17,2028.17492549094,2113.95669457394,1,16
"2001853",15,1998.24197933807,2060.56118614118,0,15
"2001854",24,1968.37518673781,2268.33468283819,4,20
"2001855",11,1898.27655165233,1933.98659929558,1,10
"2001856",14,1746.57636897977,2031.70713799962,0,14
"2001857",14,1770.40923434481,2031.70713799962,2,12
"2001858",16,1849.46490180956,2087.92318348224,2,14
"2001859",29,1877.70859534023,2357.79423966008,4,25
"2001860",13,1864.48466879464,2001.16379457045,1,12
"2001861",23,2062.52351816535,2248.68783741607,6,17
"2001862",13,1844.95832634967,2001.16379457045,2,11
"2001863",13,1752.58091222434,2001.16379457045,2,11
"2001864",17,2010.18726817935,2113.95669457394,2,15
"2001865",30,2055.22174308026,2374.18906024059,3,27
"2001881",26,1716.12104912802,2305.75108410937,3,23
"2001882",10,1863.61867357124,1896.67490607898,1,9
"2001890",13,1995.06557838495,2001.16379457045,1,12
"2001892",20,1857.16317252708,2185.35845629437,3,17
"2001894",20,1792.79427042575,2185.35845629437,3,17
"2001896",16,1884.70834763844,2087.92318348224,3,13
"2001898",25,1842.54371737068,2287.34065519221,5,20
"2001899",14,1733.39622911964,2031.70713799962,3,11
"2001900",25,1892.81268112677,2287.34065519221,4,21
"2001901",25,1898.57645874561,2287.34065519221,6,19
"2001902",29,2201.94547496097,2357.79423966008,5,24
"2001903",25,1994.81459431632,2287.34065519221,4,21
"2001907",29,2314.15822051705,2357.79423966008,10,19
"2001908",30,2203.70496239966,2374.18906024059,11,19
"2001909",22,1731.26399896629,2228.3491786518,4,18
"2001910",13,1745.12320372865,2001.16379457045,1,12
"2001911",31,1972.27646347163,2390.15469389133,2,29
"2001912",24,1978.66270388225,2268.33468283819,4,20
"2001913",14,1822.45054406967,2031.70713799962,1,13
"2001914",20,1781.09715851848,2185.35845629437,2,18
"2001915",7,1645.48328829859,1763.32076508842,1,6
"2001916",15,1867.14163877214,2060.56118614118,2,13
"2001917",19,1888.57627436567,2162.56636020013,6,13
"2001918",6,1664.61596657728,1708.62817714657,1,5
"2001919",18,1942.0457130547,2138.79896507223,4,14
"2001920",19,1901.98024468136,2162.56636020013,2,17
"2001921",19,1964.35339556895,2162.56636020013,2,17
"2001922",12,1707.78674526252,1968.69006049611,2,10
"2001923",14,1892.35660800167,2031.70713799962,2,12
"2001924",13,1821.09359785257,2001.16379457045,4,9
"2001925",16,1956.40054445873,2087.92318348224,3,13
"2001926",9,1670.18128461884,1856.26587460569,2,7
"2001927",10,1798.29013316762,1896.67490607898,4,6
"2001928",9,1695.678344709,1856.26587460569,1,8
"2001929",5,1625.90989002697,1646.12614877363,1,4
"2001930",9,1712.58297346442,1856.26587460569,2,7
"2001931",22,1934.74588004594,2228.3491786518,4,18
"2001932",21,1880.17773154787,2207.26116887512,3,18
"2001933",22,1765.06557431939,2228.3491786518,5,17
"2002386",16,2029.14444465219,2087.92318348224,2,14
"2002389",23,1973.20860750776,2248.68783741607,2,21
"2002391",28,2157.88465784502,2340.94327947849,3,25
"2002399",16,1962.39082209828,2087.92318348224,0,16
"2002502",18,1878.05842790602,2138.79896507223,4,14
"2002503",17,1898.45743210111,2113.95669457394,2,15
"2002504",20,1894.88382311177,2185.35845629437,3,17
"2002505",15,1841.92290536398,2060.56118614118,2,13
"2002507",17,1821.55346646471,2113.95669457394,3,14
"2002508",17,1844.53739060084,2113.95669457394,3,14
"2002509",20,1775.2876631188,2185.35845629437,4,16
"2002510",17,1887.00121638778,2113.95669457394,2,15
"2002571",13,1904.60260309442,2001.16379457045,0,13
"2002573",15,1876.55502466975,2060.56118614118,1,14
"2002627",41,2607.7148245054,2530.72175773865,14,27
"2002629",18,1976.92854814635,2138.79896507223,2,16
"2002630",22,2046.84411374946,2228.3491786518,1,21
"2002631",33,2071.8258761166,2420.89448855093,8,25
"2002633",22,2166.88992552512,2228.3491786518,3,19
"2002634",33,2466.32673354642,2420.89448855093,8,25
"2002637",20,1995.39288494126,2185.35845629437,3,17
"2002649",36,2022.52804522446,2464.33502634194,9,27
"2002653",24,2197.01896539833,2268.33468283819,5,19
"2002665",35,1853.38486900708,2450.1860183293,2,33
"2002666",41,1798.96539403234,2530.72175773865,7,34
"2002667",33,1984.8436963635,2420.89448855093,5,28
"2002668",26,1906.913885834,2305.75108410937,5,21
"2002669",20,2144.19695174541,2185.35845629437,6,14
"2002670",22,1885.19561432772,2228.3491786518,4,18
"2002671",25,1882.70622865635,2287.34065519221,4,21
"2002672",26,1868.65538012482,2305.75108410937,3,23
"2002673",32,1992.46327013206,2405.71569249515,4,28
"2002674",34,2128.95515152928,2435.71163614839,4,30
"2002675",29,2063.43522399098,2357.79423966008,4,25
"2002676",39,2015.69794668425,2504.98447234734,7,32
"2002677",33,2010.56686601891,2420.89448855093,8,25
"2002678",25,1967.99639648119,2287.34065519221,3,22
"2002679",21,2127.31218574547,2207.26116887512,4,17
"2002680",28,2091.99908223546,2340.94327947849,6,22
"2002681",39,1919.3576799191,2504.98447234734,8,31
"2002682",26,1835.3125927161,2305.75108410937,5,21
"2002683",48,1890.20446635438,2613.58673801098,10,38
"2002684",23,1863.24918551019,2248.68783741607,5,18
"2002685",21,1831.96725615665,2207.26116887512,2,19
"2002686",28,2105.04249180392,2340.94327947849,5,23
"2002687",13,1796.68354478021,2001.16379457045,1,12
"2002688",19,1855.03907399549,2162.56636020013,4,15
"2002689",25,2020.43256739444,2287.34065519221,3,22
"2002690",21,1939.41290213315,2207.26116887512,1,20
"2002691",18,2016.76761976697,2138.79896507223,0,18
"2002692",20,2033.68860629266,2185.35845629437,2,18
"2002693",43,1890.18636187277,2555.47878346624,7,36
"2002694",30,2047.03696171437,2374.18906024059,4,26
"2002695",39,2056.9683161439,2504.98447234734,7,32
"2002696",34,2025.02602472756,2435.71163614839,6,28
"2002697",30,2133.68129238562,2374.18906024059,3,27
"2002698",32,1894.71785320603,2405.71569249515,8,24
"2002699",29,1886.57270585262,2357.79423966008,5,24
"2002700",29,2057.90551075938,2357.79423966008,6,23
"2002701",24,2018.41017912825,2268.33468283819,3,21
"2002702",31,1801.86975917123,2390.15469389133,5,26
"2002703",31,1913.43824943078,2390.15469389133,5,26
"2002704",38,1717.83129152921,2491.71993967651,5,33
"2002705",15,1906.55558432528,2060.56118614118,0,15
"2002706",22,1946.76112545371,2228.3491786518,3,19
"2002707",27,2048.26519079601,2323.60649590586,3,24
"2002708",27,1905.41950160167,2323.60649590586,1,26
"2002709",26,1780.40259021541,2305.75108410937,3,23
"2002710",18,1987.16409860357,2138.79896507223,2,16
"2002711",19,1910.33416684155,2162.56636020013,1,18
"2002712",16,1856.82852774017,2087.92318348224,2,14
"2002713",37,2029.97184556357,2478.17471526668,5,32
"2002714",42,2046.16635904854,2543.21752514954,4,38
"2002715",27,2043.7565386075,2323.60649590586,2,25
"2002716",25,2069.48989462118,2287.34065519221,2,23
"2002717",37,1896.84942534186,2478.17471526668,3,34
"2002718",29,1872.50844630433,2357.79423966008,6,23
"2002719",25,1850.61685552106,2287.34065519221,4,21
"2002720",20,1883.50232504322,2185.35845629437,2,18
"2002721",32,2119.91483634652,2405.71569249515,5,27
"2002722",23,1919.87843124231,2248.68783741607,3,20
"2002723",38,2101.10029278819,2491.71993967651,6,32
"2002724",33,2163.5508611883,2420.89448855093,2,31
"2002725",19,1907.13758838391,2162.56636020013,1,18
"2002726",19,1946.08869072372,2162.56636020013,0,19
"2002727",19,2038.74008743066,2162.56636020013,2,17
"2002728",10,1851.09288735788,1896.67490607898,1,9
"2002729",9,1818.29571623637,1856.26587460569,1,8
"2002730",15,1887.25428035609,2060.56118614118,4,11
"2002731",21,1981.41437437739,2207.26116887512,5,16
"2002732",22,1922.79737496526,2228.3491786518,3,19
"2002733",25,2008.56941165688,2287.34065519221,3,22
"2002734",28,2122.81019807742,2340.94327947849,4,24
"2002735",24,2180.43670755522,2268.33468283819,5,19
"2002736",26,2034.26395372085,2305.75108410937,5,21
"2002738",18,1967.67976018846,2138.79896507223,1,17
"2002739",20,1917.40158007727,2185.35845629437,2,18
"2002754",21,1888.76231703298,2207.26116887512,2,19
"2002756",32,2251.00166994807,2405.71569249515,5,27
"2002757",24,2109.47214349814,2268.33468283819,2,22
"2002758",17,1968.09545142439,2113.95669457394,2,15
"2002783",14,1835.77167807294,2031.70713799962,2,12
"2002788",18,1988.29782193446,2138.79896507223,1,17
"2002790",37,1964.76810595134,2478.17471526668,7,30
"2002793",24,2222.86423172141,2268.33468283819,5,19
"2002794",32,2102.30917454027,2405.71569249515,6,26
"2002798",17,1875.49413860932,2113.95669457394,3,14
"2002799",23,1865.13435713015,2248.68783741607,4,19
"2002816",14,1829.78296398164,2031.70713799962,3,11
"2002817",14,1833.80123110486,2031.70713799962,3,11
"2002838",16,1879.19381400093,2087.92318348224,4,12
"2002839",27,1969.14420332407,2323.60649590586,6,21
"2002840",29,1934.04917520526,2357.79423966008,3,26
"3000001",7,1648.94030366525,1763.32076508842,5,2
"3000002",11,1686.81207138485,1933.98659929558,5,6
"3000003",7,1496.48404967252,1763.32076508842,3,4
"3000004",7,1558.75269824223,1763.32076508842,2,5
"3000005",4,1498.98854586128,1572.73281143487,3,1
"3000006",5,1504.60111985755,1646.12614877363,3,2
"3000007",16,1817.27937966134,2087.92318348224,5,11
"3000012",9,1688.00841905809,1856.26587460569,3,6
"3000013",1,1164.93329481912,1184.66451052022,0,1
"3000023",12,1904.68073641735,1968.69006049611,4,8
"3000024",10,1831.07556566537,1896.67490607898,2,8
"3000041",11,1800.56430335217,1933.98659929558,0,11
"3000044",10,1794.35941135919,1896.67490607898,0,10
"3000061",19,1667.08864462642,2162.56636020013,3,16
"3000077",5,1543.36277399861,1646.12614877363,3,2
"3000078",2,1294.80977874145,1364.97646362037,2,0
"3000079",5,1547.76664677445,1646.12614877363,3,2
"3000080",4,1514.30108035908,1572.73281143487,4,0
"3000090",4,1499.47933619621,1572.73281143487,0,4
"3000097",2,1381.98525396608,1364.97646362037,2,0
"3000100",3,1396.00720184862,1482.92019466158,1,2
"3000101",6,1625.98359718195,1708.62817714657,2,4
"3000102",3,1469.87140671085,1482.92019466158,1,2
"3000119",9,1609.52919115261,1856.26587460569,3,6
"3000123",6,1536.61392745394,1708.62817714657,4,2
"3000124",14,1835.24162898918,2031.70713799962,2,12
"3000125",16,1792.11497564256,2087.92318348224,3,13
"3000144",6,1660.13129041649,1708.62817714657,1,5
"3000145",5,1545.95231385381,1646.12614877363,0,5
"3000146",7,1682.43501111716,1763.32076508842,1,6
"3000149",4,1485.46716180636,1572.73281143487,1,3
"3000155",2,1351.56563118118,1364.97646362037,0,2
"3000156",5,1580.09003292914,1646.12614877363,1,4
"3000160",6,1643.700726409,1708.62817714657,1,5
"3000166",10,1801.46075760098,1896.67490607898,2,8
"3000167",9,1780.10723132026,1856.26587460569,2,7
"3000168",6,1688.06355415731,1708.62817714657,0,6
"3000172",5,1579.78078324694,1646.12614877363,1,4
"3000173",8,1667.0572249881,1812.11073017574,1,7
"3000175",13,1761.04351423812,2001.16379457045,2,11
"3000176",13,1757.55894522267,2001.16379457045,3,10
"3000178",7,1687.23819641463,1763.32076508842,2,5
"3000179",12,1634.41543203073,1968.69006049611,4,8
"3000182",4,1583.4242837517,1572.73281143487,2,2
"3000183",13,1784.05431245261,2001.16379457045,4,9
"3000184",8,1681.39068136267,1812.11073017574,5,3
"3000185",8,1694.82125139837,1812.11073017574,4,4
"3000190",13,1828.00184383931,2001.16379457045,2,11
"3000196",4,1509.4015330381,1572.73281143487,1,3
"3000197",3,1471.00277640079,1482.92019466158,0,3
"3000241",7,1706.39533520304,1763.32076508842,1,6
"3000242",7,1703.8606797693,1763.32076508842,0,7
"3000246",8,1744.72875536479,1812.11073017574,1,7
"3000249",7,1695.40597585627,1763.32076508842,1,6
"3002407",11,1651.55553455968,1933.98659929558,2,9
"3002408",5,1550.12248484554,1646.12614877363,1,4
"3002409",10,1766.46358746949,1896.67490607898,3,7
"3002412",16,1989.08090947999,2087.92318348224,0,16
"3002413",11,1722.03515850311,1933.98659929558,2,9
"3002414",13,1825.717092976,2001.16379457045,0,13
"3002520",8,1715.19240656183,1812.11073017574,2,6
"3002523",10,1748.68380389843,1896.67490607898,1,9
"3002525",12,1781.52708628929,1968.69006049611,3,9
"3002526",21,1771.95556588008,2207.26116887512,3,18
"3002528",13,1823.33658223104,2001.16379457045,1,12
"3002530",21,1894.08332330245,2207.26116887512,3,18
"3002534",25,1799.15585089568,2287.34065519221,3,22
"3002535",20,1747.12529412477,2185.35845629437,4,16
"3002536",18,1905.20224644798,2138.79896507223,2,16
"3002537",17,1866.06256026293,2113.95669457394,3,14
"3002538",18,1870.46113369738,2138.79896507223,2,16
"3002539",15,1842.5365918784,2060.56118614118,1,14
"3002540",15,1793.9804291699,2060.56118614118,3,12
"3002541",16,1929.99249739833,2087.92318348224,2,14
"3002542",19,1841.72535101263,2162.56636020013,3,16
"3002543",16,1842.3980238007,2087.92318348224,0,16
"3002544",13,1786.16047815871,2001.16379457045,4,9
"3002545",15,1747.43324481979,2060.56118614118,3,12
"3002546",19,1900.53361219407,2162.56636020013,3,16
"3002547",17,1954.48041790013,2113.95669457394,3,14
"3002548",19,1910.1563312104,2162.56636020013,3,16
"3002549",17,1859.37872049828,2113.95669457394,1,16
"3002550",16,1797.54430772304,2087.92318348224,2,14
"3002551",19,1895.60949621213,2162.56636020013,3,16
"3002552",16,1855.48237814679,2087.92318348224,2,14
"3002553",23,1941.60550781591,2248.68783741607,3,20
"3002554",15,1934.24463809975,2060.56118614118,2,13
"3002555",14,1878.79235674309,2031.70713799962,2,12
"3002556",17,1838.84710742264,2113.95669457394,4,13
"3002557",17,1822.57922079578,2113.95669457394,4,13
"3002558",13,1751.70772002029,2001.16379457045,1,12
"3002559",18,1935.06496720878,2138.79896507223,3,15
"3002560",13,1715.58744357059,2001.16379457045,2,11
"3002561",11,1756.47361862566,1933.98659929558,2,9
"3002566",14,1820.29294346971,2031.70713799962,1,13
"3002567",19,1769.32637699434,2162.56636020013,2,17
"3002568",7,1660.41147836927,1763.32076508842,0,7
"3002572",6,1659.36897236299,1708.62817714657,0,6
"3002576",1,1164.93329481912,1184.66451052022,0,1
"3002616",21,1843.82872586147,2207.26116887512,3,18
"3002619",17,1814.52941772024,2113.95669457394,4,13
"3002620",8,1674.5929925653,1812.11073017574,1,7
"3002621",16,1777.49724573475,2087.92318348224,3,13
"3002622",14,1856.30802800723,2031.70713799962,1,13
"3002918",5,1527.53702138326,1646.12614877363,3,2
"3002919",6,1626.4905139732,1708.62817714657,4,2
"3002920",4,1536.30013891549,1572.73281143487,3,1
"3002921",5,1477.69274584854,1646.12614877363,3,2
"3002922",8,1658.60730047771,1812.11073017574,3,5
"3002925",6,1586.50596434624,1708.62817714657,4,2
"33003062",9,1722.92226868833,1856.26587460569,2,7
"33003063",16,1878.34392918758,2087.92318348224,6,10
"33003064",13,1746.46324147543,2001.16379457045,3,10
"33003065",13,1702.72031865378,2001.16379457045,3,10
"33003066",15,1792.17839712621,2060.56118614118,4,11
"33003067",10,1741.38216488733,1896.67490607898,1,9
"33003068",13,1840.61559304716,2001.16379457045,5,8
"33003069",16,1778.36373977401,2087.92318348224,3,13
"33003070",4,1542.07460496898,1572.73281143487,1,3
"33003071",10,1717.90913462493,1896.67490607898,2,8
"33003072",15,1751.68183038152,2060.56118614118,3,12
"33003073",12,1812.22425115369,1968.69006049611,4,8
"33003074",13,1805.4372285306,2001.16379457045,4,9
"33003075",6,1620.52311048164,1708.62817714657,2,4
"33003917",10,1763.68667409368,1896.67490607898,2,8
"33003918",11,1815.47928607375,1933.98659929558,5,6
"33003919",13,1737.56682210196,2001.16379457045,3,10
"33003920",13,1708.47538523915,2001.16379457045,3,10
"33003921",9,1700.29461846628,1856.26587460569,1,8
"33003922",10,1753.47550702068,1896.67490607898,1,9
"33003923",14,1808.84268350657,2031.70713799962,4,10
"33003924",12,1641.69080498035,1968.69006049611,2,10
"33003925",5,1579.04894527817,1646.12614877363,1,4
"33003927",6,1608.08677855089,1708.62817714657,1,5
"33003928",15,1791.02665549132,2060.56118614118,5,10
"33003929",11,1709.75439423144,1933.98659929558,2,9
"34003018",10,1692.07153934837,1896.67490607898,2,8
"34003019",16,1807.26930937438,2087.92318348224,2,14
"34003020",13,1802.9873262906,2001.16379457045,4,9
"34003021",9,1751.57416052854,1856.26587460569,3,6
"34003022",16,1835.55182331154,2087.92318348224,4,12
"34003024",8,1787.20430450499,1812.11073017574,2,6
"34003025",11,1719.51192631444,1933.98659929558,3,8
"34003026",12,1936.05165462605,1968.69006049611,3,9
"34003027",14,1794.92217452297,2031.70713799962,4,10
"34003028",17,1805.15971058777,2113.95669457394,4,13
"34003029",12,1704.50836452383,1968.69006049611,2,10
"34003030",10,1678.03442096955,1896.67490607898,1,9
"34003031",12,1727.36878639993,1968.69006049611,2,10
"34003926",13,1774.83167404396,2001.16379457045,3,10
"34003930",17,1807.94947946675,2113.95669457394,4,13
"34003931",14,1819.58109039657,2031.70713799962,4,10
"34003950",12,1816.05189188353,1968.69006049611,2,10
"34003951",12,1809.24612329143,1968.69006049611,3,9
"34003952",9,1745.50026892453,1856.26587460569,2,7
"34003953",11,1780.95574175486,1933.98659929558,2,9
"34003954",19,1859.80703226835,2162.56636020013,5,14
"34003955",8,1827.83757672792,1812.11073017574,2,6
"34003956",10,1758.68896131921,1896.67490607898,2,8
"34003957",11,1793.17035979082,1933.98659929558,2,9
"34003958",10,1828.51079742542,1896.67490607898,2,8
"34003959",16,1869.189081707,2087.92318348224,4,12
"34003960",14,1709.61183961123,2031.70713799962,2,12
"34003961",14,1733.51264193402,2031.70713799962,1,13
"34003962",11,1730.23148854292,1933.98659929558,2,9
"39003127",7,1721.79494879223,1763.32076508842,2,5
"39003128",9,1721.00567032468,1856.26587460569,3,6
"39003129",12,1799.6366886748,1968.69006049611,2,10
"39003130",11,1789.97792656304,1933.98659929558,2,9
"39003131",14,1857.35337984982,2031.70713799962,4,10
"39003132",17,1829.91993152004,2113.95669457394,3,14
"39003133",15,1774.27872108147,2060.56118614118,3,12
"39003134",12,1804.4250481927,1968.69006049611,3,9
"39003135",13,1875.6045289921,2001.16379457045,2,11
"39003908",14,1789.99654418249,2031.70713799962,2,12
"39003909",12,1823.20282698225,1968.69006049611,4,8
"39003910",14,1775.02104583068,2031.70713799962,3,11
"39003911",16,1791.41148219843,2087.92318348224,3,13
"39003912",12,1843.8076259034,1968.69006049611,3,9
"39003913",15,1829.16156376841,2060.56118614118,2,13
"39003914",14,1781.61817678216,2031.70713799962,4,10
"39003915",14,1785.75339653856,2031.70713799962,4,10
"39003916",13,1834.04946062906,2001.16379457045,3,10
"4000676",55,2563.64779838484,2687.33120998132,18,37
"4000677",48,2539.81092802607,2613.58673801098,15,33
"4000680",70,2899.03421372079,2823.11677003184,22,48
"4000681",58,2608.62407452034,2716.66249357165,12,46
"4000684",69,2912.27078175139,2814.82611826518,24,45
"4000685",70,2893.72549259479,2823.11677003184,24,46
"4000686",64,2889.37516695554,2771.87783482774,20,44
"4000687",68,3424.34161162107,2806.43931339586,25,43
"4000688",59,2901.25244579883,2726.17127719361,16,43
"4000689",59,3091.34946534848,2726.17127719361,17,42
"4000690",38,2405.70599179336,2491.71993967651,11,27
"4000691",58,2440.00312568994,2716.66249357165,22,36
"4000692",71,3230.33111718427,2831.31372136695,28,43
"4000693",59,2572.61657496568,2726.17127719361,20,39
"4000694",62,3068.05631258752,2753.94837323248,20,42
"4000695",46,3012.83366849943,2590.94954296761,13,33
"4000696",55,2776.58075890522,2687.33120998132,20,35
"4000697",66,3077.82406432717,2789.3669207067,24,42
"4000698",65,2692.84839224433,2780.67589681985,27,38
"4000699",73,2943.87241770383,2847.4358582506,27,46
"4000700",73,3007.88946994086,2847.4358582506,25,48
"4000701",84,3246.10806210673,2930.30814451558,26,58
"4000702",80,3595.26484811811,2901.2306171403,32,48
"4000703",84,3110.44604322351,2930.30814451558,30,54
"4000704",82,3155.4225278972,2915.91045786314,29,53
"4000705",84,2927.80310150279,2930.30814451558,30,54
"4000706",80,3386.59108143273,2901.2306171403,27,53
"4000707",30,2289.69503760667,2374.18906024059,10,20
"4000708",34,2205.1034770821,2435.71163614839,10,24
"4000709",39,2735.58667745719,2504.98447234734,13,26
"4000710",41,2592.46645637824,2530.72175773865,15,26
"4000711",31,2408.72445249918,2390.15469389133,10,21
"4000712",33,2647.12239152609,2420.89448855093,12,21
"4000713",47,2590.46343719188,2602.36394728806,14,33
"4000714",30,2293.62352512245,2374.18906024059,8,22
"4000715",58,3159.85918639065,2716.66249357165,18,40
"4000716",64,3116.79055761745,2771.87783482774,18,46
"4000717",84,3192.01858569313,2930.30814451558,29,55
"4000718",6,1729.4966520636,1708.62817714657,0,6
"4000719",5,1660.30108509915,1646.12614877363,1,4
"4000720",86,3037.85601077068,2944.43562859908,25,61
"4000721",82,3082.96706625589,2915.91045786314,24,58
"4000722",69,3146.74413180376,2814.82611826518,18,51
"4000723",78,2739.87567714287,2886.25582696583,24,54
"4000724",54,2310.29309583463,2677.2712016452,9,45
"4000725",66,2568.44708740102,2789.3669207067,16,50
"4000726",64,2565.04142067624,2771.87783482774,21,43
"4000727",81,2797.58755606543,2908.60658576875,22,59
"4000728",83,3344.5966532905,2923.1438046077,20,63
"4000729",66,2655.60727223459,2789.3669207067,16,50
"4000730",75,3045.68628764131,2863.21031780169,19,56
"4000731",77,2694.4943252576,2878.65357631343,20,57
"4000732",95,3034.14714051551,3004.94950458202,26,69
"4000733",89,3303.02011243717,2965.14449011489,23,66
"4000734",58,2765.66210216423,2716.66249357165,18,40
"4000735",58,2575.40191790251,2716.66249357165,14,44
"4000736",75,2994.96300401151,2863.21031780169,22,53
"4000737",68,2671.19448259762,2806.43931339586,21,47
"4000738",48,2467.09740430231,2613.58673801098,9,39
"4000739",49,2460.08005157733,2624.62502504328,12,37
"4000740",58,2670.14569385999,2716.66249357165,17,41
"4000741",43,2168.83694345879,2555.47878346624,9,34
"4000742",64,2713.33342266121,2771.87783482774,19,45
"4000743",50,2859.85957674895,2635.48551585152,12,38
"4000744",61,3046.37049619336,2744.81051624266,16,45
"4000745",55,2600.81737793293,2687.33120998132,13,42
"4000746",64,2297.2239654465,2771.87783482774,14,50
"4000747",51,2455.59720075432,2646.17454577679,17,34
"4000748",68,2645.29274189336,2806.43931339586,15,53
"4000749",40,2398.19745405046,2517.98110851286,9,31
"4000750",64,2609.38401407864,2771.87783482774,18,46
"4000751",60,2887.13940475346,2735.5526890818,13,47
"4000753",70,2137.55587683269,2823.11677003184,18,52
"4000754",66,2279.98085216871,2789.3669207067,20,46
"4000755",26,2179.60040777606,2305.75108410937,9,17
"4000756",29,2167.90440350954,2357.79423966008,10,19
"4000757",45,2085.28490364818,2579.33597919865,12,33
"4000758",37,2315.75253773597,2478.17471526668,11,26
"4000759",38,2388.64248339354,2491.71993967651,10,28
"4000760",24,2167.5375877797,2268.33468283819,7,17
"4000761",28,2037.16154578552,2340.94327947849,8,20
"4000762",20,2047.77882133916,2185.35845629437,5,15
"4000763",15,1912.36030462076,2060.56118614118,6,9
"4000764",21,2147.67941526788,2207.26116887512,7,14
"4000765",31,2226.50240230086,2390.15469389133,8,23
"4000766",19,2121.42107065164,2162.56636020013,6,13
"4000767",36,2294.91695186071,2464.33502634194,11,25
"4000768",31,2414.38317820184,2390.15469389133,10,21
"4000769",24,1920.77858180117,2268.33468283819,5,19
"4000770",20,1992.46102075913,2185.35845629437,4,16
"4000771",22,2034.4989941481,2228.3491786518,5,17
"4000772",22,1931.59738520215,2228.3491786518,7,15
"4000773",33,2031.88951642855,2420.89448855093,9,24
"4000774",35,2096.3748121294,2450.1860183293,9,26
"4000775",43,2599.08878348407,2555.47878346624,9,34
"4000776",47,2640.28116749742,2602.36394728806,12,35
"4000777",29,2289.06591764212,2357.79423966008,8,21
"4000778",47,2514.07198601368,2602.36394728806,12,35
"4000779",38,2459.95807129313,2491.71993967651,11,27
"4000780",26,2114.01331384161,2305.75108410937,10,16
"4000781",27,2175.38175388261,2323.60649590586,4,23
"4000782",26,2120.15921765788,2305.75108410937,7,19
"4000783",26,2156.27565175771,2305.75108410937,6,20
"4000784",28,2284.88780038435,2340.94327947849,10,18
"4000785",29,2054.97326210142,2357.79423966008,7,22
"4000786",36,2179.12700790272,2464.33502634194,6,30
"4000787",35,2317.91237788913,2450.1860183293,9,26
"4000788",30,2323.5461962916,2374.18906024059,13,17
"4000789",31,2253.93145784853,2390.15469389133,9,22
"4000790",55,2403.60005337511,2687.33120998132,13,42
"4000791",23,2076.62808557596,2248.68783741607,6,17
"4000792",24,2069.9908026741,2268.33468283819,4,20
"4000793",30,2230.60419942268,2374.18906024059,11,19
"4000794",25,2032.58269354045,2287.34065519221,9,16
"4000795",23,2123.48536732262,2248.68783741607,4,19
"4000797",61,2627.79603495354,2744.81051624266,16,45
"4000798",45,2558.4725765616,2579.33597919865,12,33
"4000799",83,2981.95028190121,2923.1438046077,23,60
"4000800",55,2570.98118035812,2687.33120998132,15,40
"4000801",50,2347.72390513827,2635.48551585152,20,30
"4000802",35,2312.63683245264,2450.1860183293,13,22
"4000803",30,2067.89745090546,2374.18906024059,7,23
"4000804",25,1988.7328168073,2287.34065519221,6,19
"4000807",63,2112.02372646076,2762.96971264875,16,47
"4000808",62,2170.14650409005,2753.94837323248,17,45
"4000809",27,1872.15030707431,2323.60649590586,8,19
"4000810",11,1751.53647885805,1933.98659929558,3,8
"4000811",41,2190.35121927345,2530.72175773865,13,28
"4000812",66,2179.25801805753,2789.3669207067,14,52
"4000813",69,2216.14231126023,2814.82611826518,17,52
"4000814",41,2363.82032864575,2530.72175773865,8,33
"4000815",49,2692.82493011343,2624.62502504328,14,35
"4000816",17,1925.94977236426,2113.95669457394,4,13
"4000817",17,1838.0664092281,2113.95669457394,5,12
"4000818",24,2122.92967730258,2268.33468283819,6,18
"4000819",20,2162.14957439533,2185.35845629437,3,17
"4000820",25,2033.63614081828,2287.34065519221,8,17
"4000821",32,2246.98934073276,2405.71569249515,9,23
"4000822",29,2416.18875455824,2357.79423966008,7,22
"4000823",26,2293.80005746924,2305.75108410937,5,21
"4000824",25,2048.92721861327,2287.34065519221,8,17
"4000825",23,2235.70111289033,2248.68783741607,5,18
"4000826",19,1934.15410668297,2162.56636020013,5,14
"4000827",21,2159.13874946743,2207.26116887512,5,16
"4000828",17,2007.71235432166,2113.95669457394,3,14
"4000829",16,2098.61131210134,2087.92318348224,4,12
"4000830",34,2305.0089963903,2435.71163614839,9,25
"4000831",29,2191.04389325194,2357.79423966008,8,21
"4000832",44,2147.74263109074,2567.51523707907,12,32
"4000833",48,2166.49759027298,2613.58673801098,15,33
"4000834",23,2176.07173309727,2248.68783741607,7,16
"4000835",25,2201.50535152811,2287.34065519221,5,20
"4000836",37,2117.42987684155,2478.17471526668,12,25
"4000837",26,2158.09193174694,2305.75108410937,9,17
"4000838",23,2230.54128497528,2248.68783741607,8,15
"4000839",30,2085.62094647562,2374.18906024059,13,17
"4000840",18,1924.3355800941,2138.79896507223,7,11
"4000841",17,1899.37359974345,2113.95669457394,6,11
"4000843",19,1828.26854468687,2162.56636020013,7,12
"4000844",37,2388.39140529469,2478.17471526668,8,29
"4000845",53,2287.44393167457,2667.061866114,15,38
"4000846",43,2362.05743651044,2555.47878346624,12,31
"4000847",41,2598.87484178704,2530.72175773865,13,28
"4000848",47,2532.67128952848,2602.36394728806,14,33
"4000849",44,2552.13747680466,2567.51523707907,15,29
"4000850",36,2287.27795372788,2464.33502634194,9,27
"4000851",40,2404.23235357153,2517.98110851286,9,31
"4000852",41,2429.70359899232,2530.72175773865,11,30
"4000853",35,2326.22698226955,2450.1860183293,8,27
"44003076",4,1458.02190815782,1572.73281143487,1,3
"44003077",5,1494.51521031093,1646.12614877363,2,3
"44003078",5,1512.42001933626,1646.12614877363,1,4
"44003079",3,1420.37779869852,1482.92019466158,0,3
"44003080",6,1502.30537189586,1708.62817714657,1,5
"44003081",6,1531.85514338146,1708.62817714657,1,5
"44003082",2,1331.51545503893,1364.97646362037,0,2
"44003083",9,1567.04610911596,1856.26587460569,2,7
"44003084",4,1475.32921963527,1572.73281143487,0,4
"44003085",3,1406.83968306322,1482.92019466158,0,3
"44003936",4,1458.02190815782,1572.73281143487,1,3
"44003937",7,1551.84919822023,1763.32076508842,2,5
"44003938",5,1492.20230643646,1646.12614877363,1,4
"44003939",4,1451.78371852132,1572.73281143487,0,4
"44003940",5,1485.6154530084,1646.12614877363,1,4
"44003941",4,1447.93083861015,1572.73281143487,0,4
"44003942",6,1553.67446969423,1708.62817714657,1,5
"44003943",4,1501.58233223708,1572.73281143487,0,4
"44003944",9,1600.94472785611,1856.26587460569,1,8
"44003945",7,1572.39889314209,1763.32076508842,2,5
"44003946",9,1550.99430003738,1856.26587460569,2,7
"44003947",4,1463.03696639655,1572.73281143487,0,4
"44003948",4,1463.03696639655,1572.73281143487,0,4
"5000250",20,1708.07762092195,2185.35845629437,4,16
"5000251",15,1843.81662093584,2060.56118614118,4,11
"5000254",18,1950.16341533212,2138.79896507223,4,14
"5000255",23,1995.40023583971,2248.68783741607,6,17
"5000258",17,1900.7939631807,2113.95669457394,2,15
"5000259",14,1758.18555162792,2031.70713799962,2,12
"5000262",23,1828.54960218028,2248.68783741607,6,17
"5000263",9,1691.28629886051,1856.26587460569,1,8
"5000264",8,1695.33189806287,1812.11073017574,0,8
"5000265",12,1800.31596406735,1968.69006049611,1,11
"5000266",1,1171.61160668803,1184.66451052022,0,1
"5000267",2,1317.90000378705,1364.97646362037,0,2
"5000268",10,1759.66937013235,1896.67490607898,4,6
"5000269",7,1664.41742282007,1763.32076508842,0,7
"5000270",10,1682.97023223131,1896.67490607898,3,7
"5000271",6,1588.3342954546,1708.62817714657,3,3
"5000272",16,1613.19287997019,2087.92318348224,6,10
"5000273",16,1684.89250150986,2087.92318348224,5,11
"5000274",11,1751.45777916724,1933.98659929558,3,8
"5000275",18,1819.58674778839,2138.79896507223,6,12
"5000276",18,1907.03722255197,2138.79896507223,6,12
"5000277",18,1814.23668056507,2138.79896507223,6,12
"5000278",15,1766.21182331788,2060.56118614118,5,10
"5000279",13,1676.78531664582,2001.16379457045,5,8
"5000285",13,1757.7828112313,2001.16379457045,3,10
"5000286",18,1800.11513506555,2138.79896507223,3,15
"5000287",19,1904.53364461924,2162.56636020013,4,15
"5000288",23,1891.02631957001,2248.68783741607,5,18
"5000292",15,1779.71022371862,2060.56118614118,4,11
"5000293",15,1836.69703577241,2060.56118614118,3,12
"5000294",17,1803.19294254435,2113.95669457394,4,13
"5000295",12,1834.20914202301,1968.69006049611,3,9
"5000296",9,1718.09095615796,1856.26587460569,5,4
"5000297",3,1387.88806230072,1482.92019466158,2,1
"5000298",7,1586.26987191025,1763.32076508842,2,5
"5000299",4,1477.99458165694,1572.73281143487,0,4
"5000301",9,1734.60873574253,1856.26587460569,2,7
"5000302",11,1736.3408466469,1933.98659929558,2,9
"5000303",19,1991.00304227165,2162.56636020013,6,13
"5000304",16,1804.40355933262,2087.92318348224,6,10
"5000305",18,1851.18818019771,2138.79896507223,5,13
"5000306",16,1739.79045401311,2087.92318348224,6,10
"5000307",17,1866.36678508755,2113.95669457394,3,14
"5000308",19,1892.74287741967,2162.56636020013,5,14
"5000309",12,1748.36550587057,1968.69006049611,3,9
"5000310",23,1925.15105526587,2248.68783741607,6,17
"5000311",17,1781.0208482488,2113.95669457394,5,12
"5000312",8,1639.86666370834,1812.11073017574,4,4
"5000313",20,1975.90025106303,2185.35845629437,5,15
"5000314",12,1814.23892737532,1968.69006049611,3,9
"5000315",15,1818.28945786096,2060.56118614118,5,10
"5000316",9,1734.60873574253,1856.26587460569,2,7
"5000317",12,1820.13823339072,1968.69006049611,4,8
"5000318",12,1778.55781015664,1968.69006049611,4,8
"5000319",18,1868.44231473784,2138.79896507223,3,15
"5000320",17,1838.88056409552,2113.95669457394,4,13
"5000321",16,1811.41016618436,2087.92318348224,2,14
"5000322",23,1883.2654645882,2248.68783741607,6,17
"5000323",20,1903.4142876405,2185.35845629437,3,17
"5000324",17,1767.68380859659,2113.95669457394,5,12
"5000325",14,1778.92178752467,2031.70713799962,3,11
"5000326",14,1846.87902180966,2031.70713799962,3,11
"5000327",8,1740.39427860581,1812.11073017574,1,7
"5000328",15,1726.84233308791,2060.56118614118,4,11
"5000329",14,1761.66406607992,2031.70713799962,1,13
"5000330",11,1815.2073298145,1933.98659929558,1,10
"5000331",20,1782.28933397276,2185.35845629437,5,15
"5000332",21,1873.10326631908,2207.26116887512,5,16
"5000333",23,1923.60230215291,2248.68783741607,5,18
"5000334",19,1828.15420520823,2162.56636020013,5,14
"5000335",16,1924.07793471754,2087.92318348224,5,11
"5000336",6,1597.06324745739,1708.62817714657,2,4
"5000337",2,1323.54986415138,1364.97646362037,0,2
"5000338",2,1327.45292752921,1364.97646362037,0,2
"5000339",4,1506.07354882368,1572.73281143487,2,2
"5000340",2,1359.78854841344,1364.97646362037,1,1
"5000341",2,1312.20988091708,1364.97646362037,1,1
"5000342",15,1926.3895387837,2060.56118614118,4,11
"5000343",15,1838.01918740944,2060.56118614118,3,12
"5000344",5,1498.2508867287,1646.12614877363,0,5
"5000345",4,1518.95236578798,1572.73281143487,0,4
"5000346",4,1488.03872126135,1572.73281143487,0,4
"5000347",8,1639.06244291351,1812.11073017574,3,5
"5000348",8,1645.45426706211,1812.11073017574,1,7
"5000372",8,1655.67351210688,1812.11073017574,1,7
"5000373",16,1881.08125994702,2087.92318348224,5,11
"5000374",7,1686.81046210167,1763.32076508842,2,5
"5000375",7,1686.81046210167,1763.32076508842,2,5
"5000376",4,1530.0469885413,1572.73281143487,0,4
"5000377",3,1432.71993393725,1482.92019466158,0,3
"5000378",4,1511.93311907923,1572.73281143487,0,4
"5000379",16,1882.47993021103,2087.92318348224,4,12
"5000380",18,1880.19795274953,2138.79896507223,6,12
"5000381",18,1714.71509762005,2138.79896507223,7,11
"5000382",9,1706.19956731143,1856.26587460569,2,7
"5000383",7,1660.15232510063,1763.32076508842,2,5
"5000384",9,1718.62514941283,1856.26587460569,1,8
"5000385",10,1694.59503091279,1896.67490607898,3,7
"5000386",2,1323.54986415138,1364.97646362037,0,2
"5000387",5,1541.53919627144,1646.12614877363,0,5
"5000388",2,1323.54986415138,1364.97646362037,0,2
"5000389",14,1772.6352829636,2031.70713799962,4,10
"5000390",9,1749.96874885318,1856.26587460569,3,6
"5000391",7,1639.78982975056,1763.32076508842,2,5
"5000392",11,1704.66324537423,1933.98659929558,3,8
"5000393",15,1773.29446665232,2060.56118614118,4,11
"5000394",9,1714.11283664474,1856.26587460569,3,6
"5000395",9,1712.63209800818,1856.26587460569,1,8
"5000396",10,1810.85419710645,1896.67490607898,2,8
"5000397",10,1738.12969241893,1896.67490607898,2,8
"5000398",13,1769.33736715418,2001.16379457045,4,9
"5000399",8,1695.91502994156,1812.11073017574,2,6
"5000400",20,1733.09071255465,2185.35845629437,5,15
"5000401",11,1769.77842621654,1933.98659929558,4,7
"5000402",10,1735.3261539481,1896.67490607898,3,7
"5000403",14,1811.07501754594,2031.70713799962,4,10
"5000404",12,1773.78775578843,1968.69006049611,3,9
"5000405",15,1714.40954780304,2060.56118614118,4,11
"5000406",6,1552.64467818512,1708.62817714657,1,5
"5000407",7,1572.45862528671,1763.32076508842,1,6
"5002348",21,1934.16320810081,2207.26116887512,3,18
"5002349",20,1874.50163751559,2185.35845629437,4,16
"5002363",7,1541.28913873151,1763.32076508842,2,5
"5002364",10,1677.94933941297,1896.67490607898,3,7
"506002951",35,2070.33344110862,2450.1860183293,6,29
"506002952",25,2288.96601898328,2287.34065519221,2,23
"506002953",29,2521.09289431918,2357.79423966008,6,23
"506002956",26,2330.05427035654,2305.75108410937,9,17
"506002957",28,2398.35701074311,2340.94327947849,9,19
"506002958",24,2476.57390523968,2268.33468283819,7,17
"506002959",27,2424.08593095913,2323.60649590586,8,19
"506002960",31,2319.94384894235,2390.15469389133,8,23
"506002961",32,2174.68016748165,2405.71569249515,6,26
"506002962",26,2412.70471178537,2305.75108410937,3,23
"506002963",31,2392.01046805575,2390.15469389133,5,26
"506002964",26,2230.27967945605,2305.75108410937,4,22
"506002965",21,2183.41187352151,2207.26116887512,4,17
"506002966",17,2247.5529873231,2113.95669457394,2,15
"506002967",32,2281.06059862827,2405.71569249515,9,23
"506002968",30,2374.27218775566,2374.18906024059,5,25
"506002969",30,2436.05116082488,2374.18906024059,6,24
"506002970",22,2129.60226136051,2228.3491786518,5,17
"506002971",28,2512.9698312163,2340.94327947849,5,23
"506002972",32,2213.6685061498,2405.71569249515,4,28
"506002973",28,2080.60730484425,2340.94327947849,9,19
"506002974",24,2249.25668248667,2268.33468283819,6,18
"506002975",31,2419.36678058166,2390.15469389133,8,23
"506002976",34,2480.75588370601,2435.71163614839,10,24
"506002977",20,2147.62003806688,2185.35845629437,5,15
"506002979",11,1930.60214463641,1933.98659929558,3,8
"506002980",17,2016.9266587468,2113.95669457394,1,16
"506002981",17,1982.15545409161,2113.95669457394,1,16
"506002982",22,1942.93321485153,2228.3491786518,4,18
"506002983",8,1792.3364495442,1812.11073017574,1,7
"506002984",14,1898.65102664499,2031.70713799962,3,11
"506002985",7,1720.8686367796,1763.32076508842,0,7
"506002986",14,1952.97554635031,2031.70713799962,2,12
"506002987",22,2098.91880037555,2228.3491786518,1,21
"506002988",17,1925.62375969925,2113.95669457394,2,15
"506002989",16,1781.07635407698,2087.92318348224,5,11
"506002991",22,2007.6951712102,2228.3491786518,5,17
"506002993",16,1939.29343300782,2087.92318348224,1,15
"506002994",33,2174.46583668617,2420.89448855093,8,25
"506002995",31,2394.24006521674,2390.15469389133,5,26
"506002996",30,2187.09975002799,2374.18906024059,5,25
"506002997",23,2208.44409968969,2248.68783741607,1,22
"506002998",22,2216.72185967903,2228.3491786518,5,17
"506002999",34,2297.9714097832,2435.71163614839,3,31
"506003000",33,2290.56029603027,2420.89448855093,7,26
"506003001",31,2062.13026957897,2390.15469389133,7,24
"506003002",26,2080.89445267935,2305.75108410937,5,21
"506003003",28,2250.0128928818,2340.94327947849,3,25
"506003004",30,2109.47802365565,2374.18906024059,6,24
"506003335",23,2522.79660573719,2248.68783741607,6,17
"506003336",26,2547.06553744995,2305.75108410937,3,23
"506003351",27,2339.19611909243,2323.60649590586,4,23
"506003353",31,2212.84776115662,2390.15469389133,7,24
"506003712",31,2418.09178258944,2390.15469389133,11,20
"506003797",35,2183.265937599,2450.1860183293,7,28
"506003805",28,2480.79760202968,2340.94327947849,7,21
"506003807",34,2646.93600798115,2435.71163614839,8,26
"506003808",28,2541.26407721161,2340.94327947849,6,22
"506003809",33,2697.71709834223,2420.89448855093,5,28
"506003810",27,2317.34704975229,2323.60649590586,8,19
"506003815",26,2219.30147105502,2305.75108410937,8,18
"506003816",23,2379.35210731313,2248.68783741607,5,18
"506003817",22,2409.66455431571,2228.3491786518,4,18
"506003818",29,2336.13349798621,2357.79423966008,7,22
"506003820",28,2439.21704420256,2340.94327947849,9,19
"506003821",33,2423.79244418344,2420.89448855093,7,26
"506003822",31,2083.71048537945,2390.15469389133,5,26
"506003823",13,1930.45918921967,2001.16379457045,1,12
"506003824",16,2035.24052308566,2087.92318348224,1,15
"506003825",12,1951.74710654761,1968.69006049611,1,11
"506003826",15,1910.31066859409,2060.56118614118,2,13
"506003827",21,2013.75437566374,2207.26116887512,1,20
"506003828",14,1891.30472542869,2031.70713799962,2,12
"506003829",18,2062.06840000053,2138.79896507223,1,17
"506003832",13,1803.93211420999,2001.16379457045,4,9
"506003833",12,1844.79225236071,1968.69006049611,2,10
"506003834",32,1999.65400796475,2405.71569249515,5,27
"506003835",18,2132.28941162037,2138.79896507223,0,18
"506003836",16,2176.51580937669,2087.92318348224,0,16
"506003837",15,1800.52970246458,2060.56118614118,0,15
"506003838",21,2116.13719399441,2207.26116887512,3,18
"506003839",25,2438.4804153103,2287.34065519221,1,24
"506003840",27,2192.24271996015,2323.60649590586,7,20
"506003841",27,2284.64584940682,2323.60649590586,4,23
"506003842",31,2368.38926271066,2390.15469389133,4,27
"506003844",31,2647.18829744003,2390.15469389133,3,28
"506003845",30,2320.66546281059,2374.18906024059,5,25
"506003846",22,2023.08602972958,2228.3491786518,3,19
"507003166",36,2285.34272440787,2464.33502634194,6,30
"507003167",36,2320.18619863905,2464.33502634194,5,31
"507003168",26,2296.6497604179,2305.75108410937,1,25
"507003169",23,2398.6687999709,2248.68783741607,3,20
"507003170",30,2141.89800174033,2374.18906024059,5,25
"507003171",27,2076.65642346622,2323.60649590586,7,20
"507003172",36,2164.56068722711,2464.33502634194,9,27
"507003173",20,2232.61069815299,2185.35845629437,2,18
"507003174",26,2021.68130284102,2305.75108410937,6,20
"507003175",30,1994.48421113999,2374.18906024059,4,26
"507003176",35,2106.45566577265,2450.1860183293,8,27
"507003177",44,1940.62320595621,2567.51523707907,7,37
"507003178",29,2374.04844569506,2357.79423966008,3,26
"507003179",28,2281.36740487673,2340.94327947849,2,26
"507003180",33,2223.97232467444,2420.89448855093,6,27
"507003181",24,2394.16213808521,2268.33468283819,1,23
"507003182",28,2212.111694384,2340.94327947849,4,24
"507003183",23,2154.71351859075,2248.68783741607,4,19
"507003184",23,2154.97124790067,2248.68783741607,2,21
"507003185",20,2181.52366164712,2185.35845629437,2,18
"507003186",12,1846.07228350318,1968.69006049611,1,11
"507003187",25,2310.07599784236,2287.34065519221,3,22
"507003189",16,2161.60732698355,2087.92318348224,1,15
"507003190",28,2407.76101208947,2340.94327947849,2,26
"507003191",31,2323.08878275147,2390.15469389133,3,28
"507003192",20,2193.86867268624,2185.35845629437,2,18
"507003193",27,2293.73864674979,2323.60649590586,4,23
"507003194",28,2337.05970121323,2340.94327947849,2,26
"507003195",37,2253.94007328048,2478.17471526668,6,31
"507003196",32,2208.38688828282,2405.71569249515,7,25
"507003197",23,1951.50042865903,2248.68783741607,6,17
"507003198",29,2352.51443404905,2357.79423966008,2,27
"507003199",30,2324.45203033995,2374.18906024059,2,28
"507003200",25,2212.16902608213,2287.34065519221,4,21
"507003201",30,2291.35025182349,2374.18906024059,3,27
"507003202",27,2079.13260869656,2323.60649590586,4,23
"507003203",34,2243.37454728689,2435.71163614839,4,30
"507003204",25,2074.92593600236,2287.34065519221,3,22
"507003205",32,2300.58276024744,2405.71569249515,3,29
"507003206",31,2253.88030985442,2390.15469389133,5,26
"507003207",39,2092.71718928125,2504.98447234734,6,33
"507003208",33,2435.7056058532,2420.89448855093,4,29
"507003209",9,1915.14842000393,1856.26587460569,1,8
"507003210",28,2343.70218987458,2340.94327947849,2,26
"507003211",30,2311.07760870477,2374.18906024059,5,25
"507003212",18,2148.02887714829,2138.79896507223,2,16
"507003213",27,2374.56727755805,2323.60649590586,4,23
"507003214",37,2126.35458177667,2478.17471526668,9,28
"507003215",32,2413.21261562038,2405.71569249515,6,26
"507003216",22,2254.55506901989,2228.3491786518,4,18
"507003217",26,2237.79748595525,2305.75108410937,4,22
"507003218",32,2245.99041240621,2405.71569249515,8,24
"507003219",34,2607.60261347851,2435.71163614839,3,31
"507003220",34,2323.26931607136,2435.71163614839,6,28
"507003221",29,2366.55035308798,2357.79423966008,3,26
"507003222",23,2354.49896565808,2248.68783741607,2,21
"507003223",24,2238.25519646015,2268.33468283819,1,23
"507003224",36,1970.71652387358,2464.33502634194,7,29
"507003225",30,2282.40087834397,2374.18906024059,3,27
"507003226",35,2267.16353577222,2450.1860183293,7,28
"507003227",34,2062.71396647546,2435.71163614839,8,26
"507003228",24,2254.48584860703,2268.33468283819,2,22
"507003229",29,2395.01299155851,2357.79423966008,4,25
"507003230",30,2295.41064247291,2374.18906024059,3,27
"507003231",23,2144.02357573643,2248.68783741607,1,22
"507003232",36,2112.62852782766,2464.33502634194,6,30
"507003233",23,2085.07303312374,2248.68783741607,4,19
"507003234",27,2292.14708053395,2323.60649590586,2,25
"507003235",21,2188.32445032427,2207.26116887512,2,19
"507003236",34,2187.60908282324,2435.71163614839,5,29
"507003237",29,2138.72467359931,2357.79423966008,4,25
"507003238",30,2099.70020504707,2374.18906024059,7,23
"507003524",21,2168.90794057576,2207.26116887512,2,19
"507003528",22,2197.53543610091,2228.3491786518,1,21
"507003532",26,2538.67119964136,2305.75108410937,2,24
"507003536",26,2539.45227407606,2305.75108410937,2,24
"507003539",27,2300.05959370366,2323.60649590586,3,24
"507003541",25,2332.0310414432,2287.34065519221,2,23
"507003548",19,2321.76693197134,2162.56636020013,1,18
"507003552",25,2467.1136546546,2287.34065519221,3,22
"507003556",22,2385.06699280716,2228.3491786518,1,21
"507003562",26,2426.54818441207,2305.75108410937,0,26
"507003573",18,2241.05346765554,2138.79896507223,2,16
"507003574",26,2395.41506844124,2305.75108410937,1,25
"507003577",24,2218.74752601665,2268.33468283819,4,20
"507003580",32,2236.83090125368,2405.71569249515,4,28
"507003585",16,1994.31763414216,2087.92318348224,2,14
"507003587",27,2297.84113352547,2323.60649590586,4,23
"507003590",24,2152.44049389572,2268.33468283819,3,21
"507003591",29,2340.56399888671,2357.79423966008,4,25
"507003594",21,2376.85942385511,2207.26116887512,0,21
"507003595",30,2430.13864366924,2374.18906024059,4,26
"507003596",18,2034.76105077943,2138.79896507223,4,14
"507003597",26,2332.17670183916,2305.75108410937,5,21
"507003598",20,2247.3158415147,2185.35845629437,1,19
"507003599",23,2285.4626859451,2248.68783741607,5,18
"507003600",20,2263.96864667864,2185.35845629437,3,17
"507003601",24,2307.7287052603,2268.33468283819,4,20
"507003602",22,2070.80300820732,2228.3491786518,6,16
"507003603",26,2158.79300616383,2305.75108410937,5,21
"507003607",31,2435.41967638341,2390.15469389133,3,28
"507003609",25,2290.41057174022,2287.34065519221,4,21
"507003610",24,2360.01656031012,2268.33468283819,2,22
"507003611",22,2203.02738291095,2228.3491786518,0,22
"507003613",30,2175.01740083307,2374.18906024059,3,27
"507003614",25,2194.38709091306,2287.34065519221,6,19
"507003615",32,2479.56540281435,2405.71569249515,6,26
"507003616",17,2055.86649033942,2113.95669457394,1,16
"507003617",27,2334.73215557748,2323.60649590586,5,22
"507003618",22,2296.47477366714,2228.3491786518,2,20
"507003619",41,2466.02439902337,2530.72175773865,7,34
"507003621",26,2284.40319351084,2305.75108410937,7,19
"507003794",19,2066.32346914525,2162.56636020013,3,16
"507003795",20,2110.42235460262,2185.35845629437,3,17
"507003796",32,2181.62580210569,2405.71569249515,4,28
"507003798",22,2362.72622747944,2228.3491786518,1,21
"507003799",24,2414.70784874999,2268.33468283819,2,22
"507003803",29,2327.70521014515,2357.79423966008,4,25
"507003804",31,2479.39456903629,2390.15469389133,3,28
"507003847",28,2369.98995837096,2340.94327947849,3,25
"507003848",21,2040.31445046161,2207.26116887512,3,18
"507003849",24,2254.97247601584,2268.33468283819,3,21
"507003850",19,2111.90598513274,2162.56636020013,2,17
"507003851",20,2125.30018272227,2185.35845629437,3,17
"507003852",26,2358.78679988497,2305.75108410937,3,23
"507003854",23,2387.64111405046,2248.68783741607,2,21
"507003855",32,2312.05713103519,2405.71569249515,5,27
"507003856",28,2434.35829145653,2340.94327947849,2,26
"507003857",27,2389.94776032827,2323.60649590586,3,24
"507003858",28,2329.52751736758,2340.94327947849,2,26
"507003859",34,2322.05318014317,2435.71163614839,2,32
"507003860",30,2390.90259282249,2374.18906024059,4,26
"507003861",22,2385.31548872666,2228.3491786518,1,21
"507003862",26,2145.18314407808,2305.75108410937,7,19
"507003863",30,2341.8373613021,2374.18906024059,4,26
"507003864",30,2452.01544573972,2374.18906024059,2,28
"507003865",30,2175.76688205861,2374.18906024059,7,23
"507003866",26,2349.33013329911,2305.75108410937,2,24
"507003867",26,2012.79278247643,2305.75108410937,6,20
"507003868",30,2504.54403563162,2374.18906024059,1,29
"507003869",23,2302.38504329187,2248.68783741607,1,22
"507003870",26,2244.22186640261,2305.75108410937,2,24
"507003871",24,2326.13179302294,2268.33468283819,4,20
"507003872",46,2254.86568144862,2590.94954296761,8,38
"507003873",35,2295.62034324816,2450.1860183293,4,31
"507003874",6,1792.52801117538,1708.62817714657,0,6
"507003875",10,1965.98245380872,1896.67490607898,1,9
"507003876",30,2427.51865058061,2374.18906024059,2,28
"507003877",31,2279.90279084696,2390.15469389133,2,29
"507003878",14,2035.54023798268,2031.70713799962,3,11
"507003879",24,2233.72136450563,2268.33468283819,3,21
"507003880",31,2123.05546529635,2390.15469389133,6,25
"507003881",25,2344.91222948741,2287.34065519221,4,21
"507003882",27,2258.48593485293,2323.60649590586,5,22
"507003883",28,2341.2009158869,2340.94327947849,3,25
"507003884",26,2218.17202716869,2305.75108410937,6,20
"507003885",26,2393.67755238244,2305.75108410937,1,25
"507003886",28,2381.90256764564,2340.94327947849,3,25
"507003889",23,2250.33304943903,2248.68783741607,2,21
"507003890",24,2096.0934747298,2268.33468283819,3,21
"507003891",28,2256.43762978875,2340.94327947849,4,24
"507003892",29,2167.61542377657,2357.79423966008,3,26
"507003893",31,2176.0581679906,2390.15469389133,3,28
"507003894",28,2313.65298027829,2340.94327947849,3,25
"507003895",35,2362.69105590336,2450.1860183293,6,29
"507003896",31,2186.68582238678,2390.15469389133,3,28
"507003897",25,2294.27213815596,2287.34065519221,3,22
"507003898",13,2045.9612985565,2001.16379457045,1,12
"507003899",25,2294.58263662394,2287.34065519221,4,21
"507003900",16,2090.2696703338,2087.92318348224,1,15
"507003902",27,2330.37808344669,2323.60649590586,1,26
"507003903",28,2185.90141055852,2340.94327947849,5,23
"507003904",27,2204.04451180614,2323.60649590586,3,24
"507003906",26,2123.30987405962,2305.75108410937,2,24
"507003907",34,1998.86049669518,2435.71163614839,8,26
"56002942",1,1182.48225129826,1184.66451052022,0,1
"56002943",2,1301.85735685794,1364.97646362037,1,1
"56002944",1,1156.7137837883,1184.66451052022,0,1
"56002945",1,1156.7137837883,1184.66451052022,0,1
"56002948",1,1156.7137837883,1184.66451052022,0,1
"56003790",1,1156.7137837883,1184.66451052022,0,1
"56003791",1,1159.73743327293,1184.66451052022,0,1
"593003365",20,1954.50570253014,2185.35845629437,6,14
"593003366",19,1971.16642293298,2162.56636020013,5,14
"593003367",16,1916.43443598459,2087.92318348224,5,11
"593003368",23,1851.36449286469,2248.68783741607,6,17
"593003369",20,1844.63520842433,2185.35845629437,5,15
"593003370",12,1696.67852053605,1968.69006049611,6,6
"593003371",15,1747.84458662381,2060.56118614118,3,12
"593003372",26,1912.56613005136,2305.75108410937,7,19
"593003373",14,1830.13209405027,2031.70713799962,3,11
"593003374",19,1928.49428458452,2162.56636020013,4,15
"593003375",28,1945.91917327027,2340.94327947849,8,20
"593003376",29,1927.81286990145,2357.79423966008,9,20
"593003377",19,2043.0155805117,2162.56636020013,7,12
"593003378",20,1892.29867643663,2185.35845629437,5,15
"593003379",23,2010.93786676842,2248.68783741607,5,18
"593003380",20,2059.2884698792,2185.35845629437,5,15
"593003381",17,1766.78782142659,2113.95669457394,6,11
"593003382",12,1726.32523446398,1968.69006049611,7,5
"593003383",16,1941.76513775533,2087.92318348224,7,9
"593003384",17,1911.14623715211,2113.95669457394,5,12
"593003385",18,1882.18218485879,2138.79896507223,4,14
"593003386",13,1974.92289153843,2001.16379457045,2,11
"593003387",19,1925.09231377747,2162.56636020013,4,15
"593003388",16,1984.73015628565,2087.92318348224,4,12
"593003389",20,1926.15927042483,2185.35845629437,5,15
"593003390",16,1922.28673366731,2087.92318348224,4,12
"593003391",14,1782.87616446973,2031.70713799962,6,8
"593003392",19,1957.97903524556,2162.56636020013,5,14
"593003393",21,1950.66611228733,2207.26116887512,6,15
"593003394",20,2032.30414868299,2185.35845629437,5,15
"593003395",24,1825.17232348619,2268.33468283819,7,17
"593003396",18,2040.73293736018,2138.79896507223,6,12
"593003397",15,1901.99687298154,2060.56118614118,4,11
"593003398",14,1902.01716869102,2031.70713799962,5,9
"593003399",20,2025.05076302043,2185.35845629437,6,14
"593003400",21,1911.28915262443,2207.26116887512,7,14
"593003401",21,1956.37424273068,2207.26116887512,6,15
"593003402",20,1860.08974633854,2185.35845629437,7,13
"593003403",15,1968.25160109415,2060.56118614118,6,9
"593003404",23,1949.08472913285,2248.68783741607,7,16
"593003405",21,1968.01327165594,2207.26116887512,6,15
"593003406",20,2004.24577276405,2185.35845629437,5,15
"593003407",14,2018.50686022026,2031.70713799962,2,12
"593003408",19,1874.88897491676,2162.56636020013,7,12
"593003409",18,1927.54182480637,2138.79896507223,5,13
"593003410",8,1680.20329501896,1812.11073017574,2,6
"593003411",17,1902.14215529625,2113.95669457394,4,13
"593003412",16,1908.93874793686,2087.92318348224,5,11
"593003413",15,1913.82713347096,2060.56118614118,4,11
"593003414",21,1984.04369627754,2207.26116887512,6,15
"593003415",17,2011.65772147051,2113.95669457394,4,13
"593003416",13,1926.16618552287,2001.16379457045,3,10
"593003417",17,2031.92704547092,2113.95669457394,4,13
"593003418",16,1948.75109913199,2087.92318348224,7,9
"593003419",13,1861.24506166917,2001.16379457045,5,8
"593003420",21,1890.77456919749,2207.26116887512,6,15
"593003421",13,1827.15587205114,2001.16379457045,3,10
"593003422",16,1968.96172719485,2087.92318348224,4,12
"593003423",23,2180.47797487798,2248.68783741607,6,17
"593003424",25,2252.04005540505,2287.34065519221,4,21
"593003425",20,2091.97767083822,2185.35845629437,3,17
"593003426",18,2088.81201888341,2138.79896507223,4,14
"593003427",9,1855.46335685265,1856.26587460569,2,7
"593003428",20,2074.72972986446,2185.35845629437,4,16
"593003429",29,2129.71159122256,2357.79423966008,8,21
"593003430",30,2097.34349440352,2374.18906024059,7,23
"593003431",21,2100.92553265615,2207.26116887512,6,15
"593003432",14,1968.28127110789,2031.70713799962,2,12
"593003433",22,2006.58480554739,2228.3491786518,5,17
"593003434",26,2116.92361948801,2305.75108410937,5,21
"593003435",23,2026.79507216377,2248.68783741607,4,19
"593003436",18,1881.33767244681,2138.79896507223,6,12
"593003437",22,1980.01812895676,2228.3491786518,5,17
"593003438",22,1923.78219002354,2228.3491786518,5,17
"593003439",35,2123.75807428965,2450.1860183293,7,28
"593003440",32,2004.55114323329,2405.71569249515,9,23
"593003441",25,1992.84889180591,2287.34065519221,6,19
"593003442",26,1978.58536461773,2305.75108410937,6,20
"593003443",22,2005.87412949788,2228.3491786518,6,16
"593003444",28,1940.15349414701,2340.94327947849,10,18
"593003447",27,2107.12347308913,2323.60649590586,4,23
"593003448",28,2162.36448526436,2340.94327947849,5,23
"593003449",23,2122.86150168166,2248.68783741607,3,20
"593003454",30,2036.08365591561,2374.18906024059,7,23
"593003455",20,2078.06474941983,2185.35845629437,3,17
"593003456",18,2008.83736179179,2138.79896507223,4,14
"593003457",32,2295.61724420315,2405.71569249515,5,27
"593003458",17,2051.66686779621,2113.95669457394,5,12
"593003459",30,2054.22358922157,2374.18906024059,6,24
"593003460",30,2054.26516720326,2374.18906024059,7,23
"593003461",26,1901.07707284457,2305.75108410937,8,18
"593003462",26,1909.92301589458,2305.75108410937,9,17
"593003463",34,1818.00728063152,2435.71163614839,11,23
"593003464",20,2322.42329817357,2185.35845629437,5,15
"593003465",26,2399.67473669187,2305.75108410937,5,21
"593003466",25,2379.32240215645,2287.34065519221,5,20
"593003467",24,2200.6256910553,2268.33468283819,5,19
"593003468",26,2410.03914146205,2305.75108410937,5,21
"593003469",24,2368.50743520057,2268.33468283819,5,19
"593003470",23,2342.46060325812,2248.68783741607,5,18
"593003471",24,2362.75302679693,2268.33468283819,6,18
"593003472",24,2177.74356711663,2268.33468283819,6,18
"593003473",29,2255.92055499593,2357.79423966008,7,22
"593003474",27,2336.36688528396,2323.60649590586,4,23
"593003475",24,2287.5396594662,2268.33468283819,7,17
"593003476",35,2272.52697307677,2450.1860183293,9,26
"593003478",17,2195.56130526506,2113.95669457394,5,12
"593003479",25,2344.78857464763,2287.34065519221,5,20
"593003482",21,2200.61578442097,2207.26116887512,5,16
"593003483",24,2190.70886776336,2268.33468283819,4,20
"593003484",23,2315.7250775478,2248.68783741607,5,18
"593003485",26,2006.09578561557,2305.75108410937,5,21
"593003486",31,2182.62148095103,2390.15469389133,6,25
"593003487",21,2183.81915131172,2207.26116887512,4,17
"593003488",18,2087.17041311781,2138.79896507223,4,14
"593003489",22,1975.78700716612,2228.3491786518,5,17
"593003490",23,2356.2202873172,2248.68783741607,4,19
"593003491",25,2096.64646977233,2287.34065519221,6,19
"593003492",20,2147.40802427085,2185.35845629437,3,17
"593003493",25,2252.8324067259,2287.34065519221,5,20
"593003494",26,2378.578779238,2305.75108410937,4,22
"593003495",31,2067.55704149013,2390.15469389133,5,26
"593003496",20,1974.97864782384,2185.35845629437,3,17
"593003497",31,2079.82339106697,2390.15469389133,8,23
"593003498",20,2113.85374101018,2185.35845629437,4,16
"593003503",26,2083.18680515718,2305.75108410937,3,23
"593003505",18,2011.84452526117,2138.79896507223,4,14
"593003507",24,1848.29258578519,2268.33468283819,3,21
"593003508",20,2025.44783682453,2185.35845629437,2,18
"593003509",27,2105.43434402849,2323.60649590586,4,23
"593003510",23,2076.38854547199,2248.68783741607,5,18
"593003511",18,2210.91876246443,2138.79896507223,1,17
"593003512",24,2041.50484510737,2268.33468283819,1,23
"593003513",24,2001.0206907369,2268.33468283819,3,21
"593003514",27,2148.7447300171,2323.60649590586,2,25
"593003515",31,2102.61310331786,2390.15469389133,5,26
"593003516",18,1998.75496423534,2138.79896507223,2,16
"593003517",29,1977.59337786455,2357.79423966008,4,25
"593003518",22,2033.68277921438,2228.3491786518,5,17
"593003519",18,2040.22361884483,2138.79896507223,3,15
"593003520",29,2046.28935560687,2357.79423966008,6,23
"593003521",26,2015.8829883678,2305.75108410937,4,22
"593003522",27,2087.52016150841,2323.60649590586,5,22
"593003523",8,1838.70513763569,1812.11073017574,1,7
"6001975",17,2001.36086036578,2113.95669457394,2,15
"6001976",24,1802.96623234961,2268.33468283819,6,18
"6001977",23,1902.2932444483,2248.68783741607,5,18
"6001989",47,2852.68887595557,2602.36394728806,13,34
"6001990",29,1936.9961186651,2357.79423966008,7,22
"6001991",19,1870.15589904927,2162.56636020013,3,16
"6001992",18,1878.75710482881,2138.79896507223,3,15
"6001993",22,1810.07658696177,2228.3491786518,7,15
"6002003",34,2713.46129935516,2435.71163614839,11,23
"6002004",28,2394.78837786341,2340.94327947849,9,19
"6002005",18,1883.07137803971,2138.79896507223,2,16
"6002006",16,1895.95560239438,2087.92318348224,1,15
"6002007",21,1818.31154530601,2207.26116887512,1,20
"6002008",14,1834.84423930567,2031.70713799962,0,14
"6002009",17,1831.0288578377,2113.95669457394,5,12
"6002018",22,1840.23314231375,2228.3491786518,3,19
"6002019",13,1838.99234886704,2001.16379457045,1,12
"6002020",15,1814.92048439437,2060.56118614118,2,13
"6002021",18,1926.69368262306,2138.79896507223,2,16
"6002026",55,2821.19529623536,2687.33120998132,18,37
"6002027",30,2000.61969866546,2374.18906024059,8,22
"6002028",21,1952.8067403201,2207.26116887512,3,18
"6002037",24,1932.84859248287,2268.33468283819,3,21
"6002038",29,2084.37230200014,2357.79423966008,6,23
"6002039",28,1955.67762896076,2340.94327947849,6,22
"6002040",36,1936.96054755293,2464.33502634194,5,31
"6002050",13,1781.18338422993,2001.16379457045,2,11
"6002051",21,1994.97911804572,2207.26116887512,2,19
"6002052",28,2068.47807089617,2340.94327947849,3,25
"6002060",20,1937.867788008,2185.35845629437,2,18
"6002061",17,1898.49724420652,2113.95669457394,1,16
"6002062",21,1955.30959597604,2207.26116887512,2,19
"6002063",16,1765.97945688127,2087.92318348224,2,14
"6002064",27,2122.38419324058,2323.60649590586,3,24
"6002065",19,1961.18342770214,2162.56636020013,2,17
"6002081",23,2165.50968577799,2248.68783741607,5,18
"6002082",25,2125.19439425321,2287.34065519221,5,20
"6002083",16,1859.17701892101,2087.92318348224,3,13
"6002084",14,1971.22141337172,2031.70713799962,3,11
"6002085",13,1887.12902070589,2001.16379457045,2,11
"6002086",25,2075.80196950135,2287.34065519221,4,21
"6002087",21,2153.05980905512,2207.26116887512,5,16
"6002088",27,1787.35353147356,2323.60649590586,5,22
"6002089",24,1931.50159349318,2268.33468283819,4,20
"6002090",23,1923.19933758181,2248.68783741607,5,18
"6002091",26,2088.02601189076,2305.75108410937,4,22
"6002092",26,2056.13986882353,2305.75108410937,2,24
"6002093",20,1940.04174943936,2185.35845629437,1,19
"6002094",24,1885.88649956786,2268.33468283819,3,21
"6002095",24,1939.30752261965,2268.33468283819,2,22
"6002096",32,1866.79586251484,2405.71569249515,7,25
"6002097",14,1709.54166749842,2031.70713799962,4,10
"6002104",27,2016.80170626197,2323.60649590586,6,21
"6002105",25,1943.38905573809,2287.34065519221,3,22
"6002108",56,2991.59232727856,2697.24673169728,17,39
"6002109",43,2669.50392544914,2555.47878346624,13,30
"6002110",28,2284.00437385592,2340.94327947849,8,20
"6002111",16,1895.65342295404,2087.92318348224,3,13
"6002112",10,1785.69701763073,1896.67490607898,3,7
"6002113",9,1766.77992197458,1856.26587460569,1,8
"6002114",9,1766.04678856544,1856.26587460569,1,8
"6002115",46,2291.84576738749,2590.94954296761,16,30
"6002116",44,2402.20589517423,2567.51523707907,10,34
"6002117",44,2182.6181230593,2567.51523707907,11,33
"6002118",47,2398.49793399337,2602.36394728806,11,36
"6002119",30,2117.3523341228,2374.18906024059,6,24
"6002120",37,2332.24647669882,2478.17471526668,9,28
"6002121",26,2087.03952003088,2305.75108410937,5,21
"6002122",38,2217.73685816991,2491.71993967651,10,28
"6002123",27,1940.81968473439,2323.60649590586,4,23
"6002124",36,2179.11214301789,2464.33502634194,8,28
"6002125",33,2152.35370131183,2420.89448855093,9,24
"6002126",39,2165.07425453522,2504.98447234734,10,29
"6002127",39,2191.31310423231,2504.98447234734,9,30
"6002128",23,1964.89439454148,2248.68783741607,10,13
"6002129",23,1953.27951320893,2248.68783741607,9,14
"6002130",49,2172.80906413359,2624.62502504328,14,35
"6002131",35,2211.20953315874,2450.1860183293,7,28
"6002132",33,2072.32027702168,2420.89448855093,7,26
"6002133",36,2281.06286620508,2464.33502634194,10,26
"6002134",36,2469.91689083339,2464.33502634194,10,26
"6002135",41,2070.99691447052,2530.72175773865,10,31
"6002136",18,1962.14149829889,2138.79896507223,6,12
"6002137",21,1923.52882384808,2207.26116887512,8,13
"6002138",43,2119.84471310921,2555.47878346624,12,31
"6002139",38,2196.31681913203,2491.71993967651,9,29
"6002140",27,2052.9898845028,2323.60649590586,6,21
"6002141",28,1907.09824027751,2340.94327947849,5,23
"6002142",29,2165.65536898878,2357.79423966008,7,22
"6002143",40,2191.13490547604,2517.98110851286,9,31
"6002144",23,2098.0718238782,2248.68783741607,6,17
"6002145",17,1991.1977084492,2113.95669457394,4,13
"6002146",20,2076.62426769069,2185.35845629437,5,15
"6002147",32,2083.54460925803,2405.71569249515,9,23
"6002148",31,1998.72324039834,2390.15469389133,9,22
"6002153",18,1981.68480045638,2138.79896507223,2,16
"6002154",27,2283.43841136089,2323.60649590586,8,19
"6002155",27,2435.42731660048,2323.60649590586,9,18
"6002156",23,2266.04105784511,2248.68783741607,7,16
"6002157",32,2428.12081616203,2405.71569249515,10,22
"6002158",17,2134.67258974497,2113.95669457394,3,14
"6002159",23,2273.34094328893,2248.68783741607,7,16
"6002160",25,2357.99417544363,2287.34065519221,5,20
"6002161",21,2198.72825628272,2207.26116887512,5,16
"6002162",24,2411.967008118,2268.33468283819,6,18
"6002163",15,1951.05179012715,2060.56118614118,3,12
"6002164",16,2080.45066107061,2087.92318348224,8,8
"6002166",39,2737.1676939518,2504.98447234734,13,26
"6002167",42,2878.38800316372,2543.21752514954,14,28
"6002170",44,2778.21017100121,2567.51523707907,19,25
"6002171",39,2960.78891439163,2504.98447234734,15,24
"6002172",32,2549.7633027793,2405.71569249515,10,22
"6002173",52,2596.57000031355,2656.6981055205,13,39
"6002174",73,2983.60543981729,2847.4358582506,26,47
"6002175",67,2917.45309688778,2797.95380131742,18,49
"6002176",63,2614.8074190648,2762.96971264875,15,48
"6002184",47,3146.34451538994,2602.36394728806,18,29
"6002185",39,2390.85528274344,2504.98447234734,10,29
"6002193",57,2945.70896603227,2707.02236739438,21,36
"6002199",7,1673.61910632172,1763.32076508842,0,7
"6002205",17,1850.25777736197,2113.95669457394,3,14
"6002212",18,1843.89889940247,2138.79896507223,3,15
"6002219",12,1885.01772774955,1968.69006049611,1,11
"6002220",12,1863.57313155998,1968.69006049611,1,11
"6002221",17,1948.77582120877,2113.95669457394,1,16
"6002222",11,1830.88282644667,1933.98659929558,2,9
"6002226",12,2028.08655119742,1968.69006049611,3,9
"6002227",32,1982.10788994451,2405.71569249515,9,23
"6002228",39,2528.30059711525,2504.98447234734,10,29
"6002243",48,2550.15593736395,2613.58673801098,14,34
"6002244",8,1797.81285557063,1812.11073017574,3,5
"6002245",10,1733.74099579695,1896.67490607898,2,8
"6002246",22,2093.02658882752,2228.3491786518,6,16
"6002247",14,1837.1503904403,2031.70713799962,4,10
"6002248",14,1886.75750456129,2031.70713799962,1,13
"6002249",15,1989.26016140191,2060.56118614118,2,13
"6002250",18,1922.09721458682,2138.79896507223,5,13
"6002251",18,1810.97579790441,2138.79896507223,4,14
"6002252",20,1831.38235896411,2185.35845629437,3,17
"6002253",19,1870.7385399627,2162.56636020013,4,15
"6002254",13,1845.34137357297,2001.16379457045,1,12
"6002255",14,1904.5286766936,2031.70713799962,4,10
"6002256",13,1839.40091594389,2001.16379457045,5,8
"6002257",25,1944.44005571929,2287.34065519221,5,20
"6002258",26,1907.60868106342,2305.75108410937,8,18
"6002259",12,1823.29930857497,1968.69006049611,2,10
"6002260",18,1932.76094875099,2138.79896507223,3,15
"6002261",19,1988.34480466087,2162.56636020013,4,15
"6002262",21,1948.62699717656,2207.26116887512,5,16
"6002263",13,1927.45378113742,2001.16379457045,1,12
"6002268",26,1895.21728676926,2305.75108410937,3,23
"6002269",22,2047.79071044133,2228.3491786518,7,15
"6002270",21,2080.71107292064,2207.26116887512,3,18
"6002271",9,1715.54049876722,1856.26587460569,1,8
"6002272",11,1897.99143282426,1933.98659929558,2,9
"6002273",12,1764.98938693543,1968.69006049611,3,9
"6002274",15,1837.31897809631,2060.56118614118,1,14
"6002275",16,1948.34822435005,2087.92318348224,2,14
"6002276",23,1876.01787911469,2248.68783741607,5,18
"6002277",22,1969.68889642599,2228.3491786518,4,18
"6002278",19,1812.6035470859,2162.56636020013,5,14
"6002279",4,1538.15149286756,1572.73281143487,0,4
"6002280",16,1941.93648621315,2087.92318348224,3,13
"6002281",18,1944.74244396044,2138.79896507223,4,14
"6002282",30,2429.08998757056,2374.18906024059,5,25
"6002283",14,1857.22413192524,2031.70713799962,3,11
"6002284",16,1835.86991395012,2087.92318348224,4,12
"6002285",7,1577.1080630278,1763.32076508842,3,4
"6002286",9,1834.41330388698,1856.26587460569,1,8
"6002287",19,1907.37580018965,2162.56636020013,4,15
"6002288",16,1859.21684258952,2087.92318348224,4,12
"6002289",28,1907.23075720115,2340.94327947849,6,22
"6002290",29,1755.72828660866,2357.79423966008,10,19
"6002291",11,1836.92342685476,1933.98659929558,2,9
"6002292",19,2020.65524164974,2162.56636020013,3,16
"6002293",17,2023.99817707107,2113.95669457394,5,12
"6002294",21,2136.94691293409,2207.26116887512,6,15
"6002295",25,2108.37602792429,2287.34065519221,7,18
"6002296",15,1968.82364875731,2060.56118614118,4,11
"6002297",33,2320.16255458774,2420.89448855093,15,18
"6002298",42,2079.72855797805,2543.21752514954,13,29
"6002299",48,2307.899504225,2613.58673801098,17,31
"6002300",37,2340.51013632308,2478.17471526668,11,26
"6002301",30,2336.9273689064,2374.18906024059,11,19
"6002302",25,2083.67584946905,2287.34065519221,5,20
"6002309",25,1949.11440517527,2287.34065519221,5,20
"6002316",23,1942.16486895344,2248.68783741607,3,20
"6002317",20,1939.76171169407,2185.35845629437,4,16
"6002318",13,1953.95001483419,2001.16379457045,3,10
"6002322",25,1938.34584180803,2287.34065519221,6,19
"6002324",18,1970.97951920603,2138.79896507223,3,15
"6002325",23,1796.49402905986,2248.68783741607,2,21
"6002330",27,1851.36910454707,2323.60649590586,4,23
"6002332",5,1486.83696297037,1646.12614877363,2,3
"6002333",22,2149.89162416333,2228.3491786518,5,17
"6002334",14,1605.84274167446,2031.70713799962,3,11
"6002337",17,1925.13656416816,2113.95669457394,5,12
"6002338",14,1783.66561708418,2031.70713799962,2,12
"6002339",19,1954.77168269881,2162.56636020013,3,16
"6002340",13,1990.67044781035,2001.16379457045,5,8
"6002341",27,1990.10126983209,2323.60649590586,9,18
"6002343",17,1897.91844396235,2113.95669457394,3,14
"6002344",14,1795.11164058225,2031.70713799962,2,12
"6002861",12,1806.95150388499,1968.69006049611,2,10
"6002862",8,1651.50590183165,1812.11073017574,1,7
"6002863",20,2059.78921541698,2185.35845629437,4,16
"6002864",11,1810.47536803259,1933.98659929558,0,11
"6002865",18,1866.88744429966,2138.79896507223,4,14
"6002866",22,1908.86937220737,2228.3491786518,3,19
"6002872",21,2029.12851834892,2207.26116887512,3,18
"6002875",18,2040.06822340987,2138.79896507223,2,16
"6002876",16,1822.59121218833,2087.92318348224,2,14
"6002877",18,1907.24920652652,2138.79896507223,2,16
"6002878",18,1968.05833781666,2138.79896507223,3,15
"6002879",22,2041.93469138442,2228.3491786518,3,19
"6002880",20,1917.30437226199,2185.35845629437,3,17
"6002881",14,1861.85668945918,2031.70713799962,2,12
"6002926",22,1772.20839559281,2228.3491786518,3,19
"6003293",70,2918.78717208163,2823.11677003184,21,49
"6003294",70,3115.43881745555,2823.11677003184,28,42
"6003295",84,2799.76773261228,2930.30814451558,27,57
"6003296",60,2893.36377696181,2735.5526890818,21,39
"6003297",75,2888.06481422048,2863.21031780169,30,45
"6003298",71,3060.52792516322,2831.31372136695,23,48
"6003299",64,3249.13551973269,2771.87783482774,23,41
"6003300",78,2528.08511955187,2886.25582696583,32,46
"6003301",72,3111.42396472102,2839.4193288992,24,48
"6003302",62,2539.76997415888,2753.94837323248,22,40
"6003303",56,2907.9457421116,2697.24673169728,24,32
"6003304",64,2904.44738577421,2771.87783482774,21,43
"62003087",41,3162.65964659282,2530.72175773865,12,29
"62003088",55,3398.62278128121,2687.33120998132,15,40
"62003089",61,3340.71366147487,2744.81051624266,23,38
"62003090",58,3047.36713602901,2716.66249357165,21,37
"62003091",42,2399.42768527461,2543.21752514954,12,30
"62003092",52,3146.47521026412,2656.6981055205,18,34
"62003093",63,3298.10018881915,2762.96971264875,22,41
"62003094",49,3302.07800021586,2624.62502504328,16,33
"62003095",66,3142.98667248394,2789.3669207067,20,46
"62003096",50,3264.39560947592,2635.48551585152,16,34
"62003097",74,3138.5894533598,2855.36548874306,21,53
"62003098",55,3314.44967786566,2687.33120998132,18,37
"62003099",49,2739.13653448956,2624.62502504328,17,32
"62003100",52,2418.30014910322,2656.6981055205,15,37
"62003101",76,3272.51914287636,2870.97236507783,19,57
"62003102",71,3791.77566800573,2831.31372136695,22,49
"62003103",73,3464.91448429906,2847.4358582506,26,47
"62003104",69,3407.373999001,2814.82611826518,22,47
"62003105",55,3062.8909448369,2687.33120998132,17,38
"62003106",68,3507.6944587954,2806.43931339586,27,41
"62003107",94,3863.85999956917,2998.45695239283,33,61
"62003108",69,3777.13886470376,2814.82611826518,22,47
"62003109",67,3418.21544966122,2797.95380131742,23,44
"62003110",64,3128.54424564261,2771.87783482774,22,42
"62003111",78,3499.68186971742,2886.25582696583,27,51
"62003112",67,3925.12180377677,2797.95380131742,22,45
"62003113",64,3421.93376971864,2771.87783482774,21,43
"62003114",87,3515.41121148105,2951.40156710974,27,60
"62003115",75,3625.94567055407,2863.21031780169,26,49
"62003116",63,2577.99030932869,2762.96971264875,24,39
"62003117",77,3022.22353107277,2878.65357631343,19,58
"62003118",78,2875.59630547123,2886.25582696583,20,58
"62003119",86,2892.79417978097,2944.43562859908,27,59
"62003120",87,2482.98148532328,2951.40156710974,19,68
"62003121",92,2894.31072389609,2985.30521778333,26,66
"62003122",107,2770.39566965428,3078.90571391637,30,77
"62003123",78,3067.03170897387,2886.25582696583,23,55
"62003713",52,3231.897034063,2656.6981055205,14,38
"62003714",68,3413.31761823897,2806.43931339586,28,40
"62003715",49,3093.18723285609,2624.62502504328,16,33
"62003716",51,3378.91200933241,2646.17454577679,11,40
"62003717",67,3597.49050901521,2797.95380131742,26,41
"62003718",62,2970.79077239399,2753.94837323248,23,39
"62003719",51,3426.54234327512,2646.17454577679,16,35
"62003720",66,3746.73272694453,2789.3669207067,23,43
"62003721",72,3700.64803880276,2839.4193288992,32,40
"62003722",83,3559.47967250204,2923.1438046077,25,58
"62003723",77,3537.64420129082,2878.65357631343,23,54
"62003724",89,3414.56275453569,2965.14449011489,28,61
"62003725",60,3035.23577605767,2735.5526890818,20,40
"62003726",71,3315.13527169727,2831.31372136695,24,47
"62003727",39,2723.50896024832,2504.98447234734,13,26
"62003728",60,3281.75965987126,2735.5526890818,19,41
"62003729",70,3922.59764225662,2823.11677003184,28,42
"62003730",76,3627.61681564261,2870.97236507783,30,46
"62003731",85,3419.11015166899,2937.40494579778,29,56
"62003732",66,3680.93325822343,2789.3669207067,23,43
"62003733",68,3379.38014761508,2806.43931339586,25,43
"62003737",70,2762.50887530977,2823.11677003184,14,56
"64003158",15,1612.46949054116,2060.56118614118,1,14
"64003159",13,1646.09245133077,2001.16379457045,1,12
"64003161",16,1680.71558337867,2087.92318348224,1,15
"64003162",12,1622.86579939363,1968.69006049611,2,10
"64003163",9,1583.30795742301,1856.26587460569,1,8
"64003164",14,1689.23204501024,2031.70713799962,2,12
"64003165",9,1602.8791847333,1856.26587460569,0,9
"64003734",9,1646.32613486643,1856.26587460569,1,8
"64003935",11,1604.62524452931,1933.98659929558,1,10
"676003239",56,2983.73759118757,2697.24673169728,15,41
"676003240",55,3188.81932661707,2687.33120998132,15,40
"676003241",40,2815.55021796223,2517.98110851286,14,26
"676003242",48,3158.97022423315,2613.58673801098,16,32
"676003243",71,3470.02663146456,2831.31372136695,24,47
"676003244",60,3085.75926464176,2735.5526890818,23,37
"676003245",59,2944.25699000377,2726.17127719361,19,40
"676003247",56,2850.90643556081,2697.24673169728,18,38
"676003248",46,3216.7636683262,2590.94954296761,15,31
"676003249",43,2824.34089459172,2555.47878346624,16,27
"676003250",63,3361.65191275439,2762.96971264875,23,40
"676003251",53,3165.9761115819,2667.061866114,18,35
"676003252",65,3341.45446953053,2780.67589681985,24,41
"676003741",40,3069.1878995653,2517.98110851286,14,26
"676003742",45,2923.103640933,2579.33597919865,18,27
"682002937",58,3431.01511712019,2716.66249357165,24,34
"682002938",46,2929.100365396,2590.94954296761,16,30
"682002939",40,2374.68252642176,2517.98110851286,16,24
"682002940",57,2989.72558095157,2707.02236739438,18,39
"683003147",44,2899.3406969222,2567.51523707907,19,25
"683003148",43,2902.42428008852,2555.47878346624,19,24
"683003149",41,2622.52100003419,2530.72175773865,18,23
"683003150",58,2810.75656061479,2716.66249357165,26,32
"683003151",38,2908.33176899607,2491.71993967651,16,22
"683003152",42,2941.0946289182,2543.21752514954,19,23
"683003153",37,2901.14901447225,2478.17471526668,17,20
"683003932",32,2433.8846819142,2405.71569249515,15,17
"683003933",32,2708.14445629617,2405.71569249515,16,16
"683003934",36,2672.02793554668,2464.33502634194,13,23
"689003033",46,2559.12612193816,2590.94954296761,18,28
"689003034",41,2302.3575663452,2530.72175773865,17,24
"689003035",44,2488.65510878841,2567.51523707907,15,29
"689003036",53,2597.40166921821,2667.061866114,15,38
"689003037",50,2770.93589631744,2635.48551585152,17,33
"689003038",40,2408.28617810913,2517.98110851286,17,23
"689003039",45,2558.44485147592,2579.33597919865,15,30
"689003040",59,3439.5331299413,2726.17127719361,15,44
"689003041",69,2618.36734365132,2814.82611826518,22,47
"689003042",38,2828.82163504309,2491.71993967651,10,28
"689003043",67,2871.98369713821,2797.95380131742,25,42
"689003044",55,2774.42758425061,2687.33120998132,21,34
"689003045",32,2802.77276524658,2405.71569249515,11,21
"689003046",43,2816.51225581927,2555.47878346624,12,31
"689003047",38,2993.54297293342,2491.71993967651,13,25
"689003048",52,3097.61180835452,2656.6981055205,15,37
"689003049",50,3151.22166680285,2635.48551585152,17,33
"689003050",47,3042.07458478169,2602.36394728806,18,29
"689003051",65,2836.50877010905,2780.67589681985,26,39
"689003052",43,3268.71360712966,2555.47878346624,17,26
"689003053",68,2953.57174013543,2806.43931339586,26,42
"689003054",51,2931.46542620706,2646.17454577679,19,32
"689003055",50,3291.314641069,2635.48551585152,20,30
"689003056",40,3548.41874429056,2517.98110851286,15,25
"689003057",48,3264.35938035187,2613.58673801098,16,32
"689003058",45,3084.0725459376,2579.33597919865,17,28
"689003059",47,3176.16334470704,2602.36394728806,14,33
"689003060",54,3205.0895167884,2677.2712016452,21,33
"689003061",33,2560.10329655599,2420.89448855093,10,23
"689003735",42,2472.89338260497,2543.21752514954,18,24
"689003736",46,2666.29671807279,2590.94954296761,16,30
"689003738",34,3127.06219595489,2435.71163614839,12,22
"689003739",49,3145.18456893607,2624.62502504328,14,35
"689003740",55,3039.00016674443,2687.33120998132,23,32
"7000408",10,1560.05632903307,1896.67490607898,1,9
"7000409",3,1406.99805338328,1482.92019466158,0,3
"7000410",3,1416.46020967524,1482.92019466158,0,3
"7000412",9,1676.37320624112,1856.26587460569,1,8
"7000413",6,1559.81633274625,1708.62817714657,1,5
"7000414",3,1393.46849933746,1482.92019466158,0,3
"7000415",11,1728.36594293287,1933.98659929558,2,9
"7000416",9,1687.60783319822,1856.26587460569,0,9
"7000417",10,1670.42029844608,1896.67490607898,0,10
"7000418",4,1517.90441175392,1572.73281143487,1,3
"7000419",6,1585.6979191218,1708.62817714657,1,5
"7000420",2,1317.02858264606,1364.97646362037,0,2
"7000421",1,1150.39487184796,1184.66451052022,0,1
"7000422",4,1513.84116223386,1572.73281143487,1,3
"7000423",2,1332.37374290201,1364.97646362037,1,1
"7000424",5,1475.30135656731,1646.12614877363,2,3
"7000425",6,1671.89842622277,1708.62817714657,1,5
"7000426",4,1465.15064699177,1572.73281143487,0,4
"7000427",10,1719.48532489007,1896.67490607898,0,10
"7000429",9,1640.257576195,1856.26587460569,1,8
"7000430",9,1616.24571554909,1856.26587460569,0,9
"7000431",9,1688.91676702688,1856.26587460569,1,8
"7000432",11,1745.4679642787,1933.98659929558,0,11
"7000433",11,1618.95689870285,1933.98659929558,2,9
"7000434",17,1689.56841431337,2113.95669457394,3,14
"7000435",7,1574.89829892637,1763.32076508842,0,7
"7000436",14,1628.56043894315,2031.70713799962,1,13
"7000437",10,1679.46053033338,1896.67490607898,1,9
"7000438",6,1574.37159080095,1708.62817714657,0,6
"7000439",7,1619.68379031854,1763.32076508842,0,7
"7000440",6,1558.82559489236,1708.62817714657,0,6
"7000441",5,1573.93869483475,1646.12614877363,0,5
"7000442",7,1565.29739185982,1763.32076508842,1,6
"7000443",4,1476.53645308229,1572.73281143487,1,3
"7000444",9,1674.4968092478,1856.26587460569,1,8
"7000445",8,1619.50951018614,1812.11073017574,2,6
"7000446",8,1624.72569235644,1812.11073017574,2,6
"7000447",8,1543.72699186296,1812.11073017574,1,7
"7000448",10,1655.10812588954,1896.67490607898,1,9
"7000449",10,1584.91931563222,1896.67490607898,1,9
"7000450",10,1667.91602676641,1896.67490607898,2,8
"7000451",8,1679.28395112751,1812.11073017574,0,8
"7000452",9,1615.52108624219,1856.26587460569,2,7
"7000453",6,1595.62794296153,1708.62817714657,3,3
"7000456",6,1608.80564085617,1708.62817714657,0,6
"7000457",6,1662.57251128446,1708.62817714657,0,6
"7000458",4,1546.42529441697,1572.73281143487,1,3
"7000459",4,1470.61401680656,1572.73281143487,2,2
"7000460",9,1628.01018379427,1856.26587460569,1,8
"7000461",7,1679.51339566554,1763.32076508842,0,7
"7000462",6,1621.10498827205,1708.62817714657,1,5
"7000463",4,1548.77371748562,1572.73281143487,0,4
"7000464",3,1465.31196335162,1482.92019466158,1,2
"7000465",5,1507.9206547468,1646.12614877363,0,5
"7000466",7,1635.91210147362,1763.32076508842,1,6
"7000467",5,1594.04954646098,1646.12614877363,0,5
"7000468",3,1415.64735506394,1482.92019466158,0,3
"7000470",11,1690.49668871387,1933.98659929558,2,9
"7000471",5,1532.10070748217,1646.12614877363,0,5
"7000472",16,1689.90132550959,2087.92318348224,1,15
"7000473",8,1657.09305791436,1812.11073017574,1,7
"7000474",7,1621.67752590386,1763.32076508842,0,7
"7000475",6,1534.97274378436,1708.62817714657,0,6
"7000476",6,1586.78474888834,1708.62817714657,0,6
"7000479",11,1602.00385410958,1933.98659929558,2,9
"7000480",12,1739.76152659617,1968.69006049611,2,10
"7000481",5,1531.40519102698,1646.12614877363,2,3
"7000482",5,1558.46689914608,1646.12614877363,2,3
"7000483",8,1550.86452570752,1812.11073017574,3,5
"7000484",8,1595.24533864928,1812.11073017574,2,6
"7000485",7,1597.62462777022,1763.32076508842,1,6
"7000486",13,1681.39904180396,2001.16379457045,4,9
"7000487",5,1493.91140485895,1646.12614877363,1,4
"7000488",7,1505.22680649907,1763.32076508842,1,6
"7000489",7,1608.95974822642,1763.32076508842,0,7
"7000490",8,1600.68346718542,1812.11073017574,0,8
"7000491",4,1454.67395374325,1572.73281143487,1,3
"7000492",4,1438.69823695747,1572.73281143487,2,2
"7000493",4,1464.67260245347,1572.73281143487,1,3
"7000494",6,1521.62154924816,1708.62817714657,2,4
"7000495",8,1606.32518058813,1812.11073017574,2,6
"7000496",8,1720.04188617842,1812.11073017574,2,6
"7000497",1,1152.96854186554,1184.66451052022,0,1
"7000498",1,1152.96854186554,1184.66451052022,0,1
"7000499",5,1513.40128313707,1646.12614877363,0,5
"7000500",5,1513.40128313707,1646.12614877363,0,5
"7000501",5,1505.35934935989,1646.12614877363,0,5
"7000502",3,1398.81499134469,1482.92019466158,1,2
"7000503",3,1402.99471060815,1482.92019466158,0,3
"7000504",4,1495.82387422336,1572.73281143487,1,3
"7000505",3,1414.51452124508,1482.92019466158,0,3
"7000506",4,1450.55997849077,1572.73281143487,1,3
"7000507",3,1414.51452124508,1482.92019466158,0,3
"7000508",3,1414.51452124508,1482.92019466158,0,3
"7000509",6,1569.63643711877,1708.62817714657,1,5
"7000510",4,1494.90777499937,1572.73281143487,0,4
"7000511",4,1458.82475945823,1572.73281143487,1,3
"7000512",7,1539.67683972461,1763.32076508842,1,6
"7000513",4,1538.80880093802,1572.73281143487,1,3
"7000514",5,1535.79221002487,1646.12614877363,1,4
"7000516",8,1731.0663734918,1812.11073017574,2,6
"7000517",9,1790.2124758956,1856.26587460569,1,8
"7000518",7,1593.73865572535,1763.32076508842,1,6
"7000519",10,1654.90034711069,1896.67490607898,2,8
"7000520",9,1709.97210495274,1856.26587460569,3,6
"7000521",7,1597.81123286215,1763.32076508842,2,5
"7000522",6,1575.96147792361,1708.62817714657,1,5
"7000523",6,1544.65649664664,1708.62817714657,0,6
"7000524",5,1531.44316582577,1646.12614877363,0,5
"7000525",10,1713.71603110686,1896.67490607898,2,8
"7000526",7,1541.45989014972,1763.32076508842,2,5
"7000527",7,1633.71661302473,1763.32076508842,1,6
"7000528",7,1562.88614836352,1763.32076508842,1,6
"7000529",11,1664.92579074297,1933.98659929558,1,10
"7000530",5,1540.72732112379,1646.12614877363,1,4
"7000531",7,1637.293196351,1763.32076508842,2,5
"7000532",5,1473.38005126996,1646.12614877363,1,4
"7000533",5,1499.21151301478,1646.12614877363,1,4
"7000534",9,1680.41221318419,1856.26587460569,1,8
"7000535",5,1492.0068047636,1646.12614877363,1,4
"7000536",5,1522.46388878526,1646.12614877363,1,4
"7000537",7,1596.15278610614,1763.32076508842,1,6
"7000538",4,1466.77264867687,1572.73281143487,1,3
"7000539",6,1551.61177753892,1708.62817714657,1,5
"7000540",6,1577.26997966436,1708.62817714657,2,4
"7000541",5,1492.0068047636,1646.12614877363,1,4
"7000542",6,1594.96968542456,1708.62817714657,1,5
"7000543",5,1645.48094477482,1646.12614877363,2,3
"7000544",5,1496.04361217223,1646.12614877363,1,4
"7000545",6,1593.30741288523,1708.62817714657,0,6
"7000546",8,1606.76673572386,1812.11073017574,1,7
"7000547",6,1560.58427448569,1708.62817714657,1,5
"7000548",6,1567.59853728975,1708.62817714657,1,5
"7000549",10,1660.84399614864,1896.67490607898,1,9
"7000550",6,1584.13379031777,1708.62817714657,2,4
"7000551",6,1524.77912035017,1708.62817714657,1,5
"7000552",8,1586.00099831606,1812.11073017574,1,7
"7000553",8,1623.66526819005,1812.11073017574,4,4
"7000554",9,1633.86153585872,1856.26587460569,2,7
"7000555",8,1595.32046925062,1812.11073017574,2,6
"7000556",6,1545.16272194931,1708.62817714657,1,5
"7000557",7,1523.02401176987,1763.32076508842,3,4
"7000558",4,1444.79684493553,1572.73281143487,1,3
"7000559",6,1564.24118580589,1708.62817714657,1,5
"7000560",10,1627.26436260041,1896.67490607898,1,9
"7000561",7,1613.59179133349,1763.32076508842,2,5
"7000562",7,1622.38287382539,1763.32076508842,2,5
"7000563",5,1507.37943513393,1646.12614877363,1,4
"7000564",5,1507.37943513393,1646.12614877363,1,4
"7000565",15,1784.52724187043,2060.56118614118,3,12
"7000566",18,1824.58225876138,2138.79896507223,3,15
"7000567",15,1844.40131883018,2060.56118614118,1,14
"7000568",15,1827.66957404727,2060.56118614118,3,12
"7000569",12,1762.33183879573,1968.69006049611,3,9
"7000570",15,1782.2627264945,2060.56118614118,2,13
"7000571",15,1787.68194228481,2060.56118614118,4,11
"7000572",15,1877.98541994177,2060.56118614118,2,13
"7000573",19,1932.17786511664,2162.56636020013,3,16
"7000574",10,1742.15706664576,1896.67490607898,2,8
"7000575",15,1768.4596026812,2060.56118614118,1,14
"7000576",19,1897.95630034305,2162.56636020013,2,17
"7000577",15,1834.83535304927,2060.56118614118,1,14
"7000578",25,1744.36367226428,2287.34065519221,4,21
"7000579",15,1753.45325863539,2060.56118614118,3,12
"7000580",10,1703.33589621189,1896.67490607898,3,7
"7000581",14,1759.13973377392,2031.70713799962,2,12
"7000582",9,1725.46014412731,1856.26587460569,1,8
"7000583",16,1921.85930377512,2087.92318348224,2,14
"7000584",18,1775.54601639102,2138.79896507223,2,16
"7000587",1,1190.61798322693,1184.66451052022,0,1
"7000588",6,1575.45712780882,1708.62817714657,1,5
"7000589",3,1446.54366037126,1482.92019466158,0,3
"7000592",6,1613.98564117795,1708.62817714657,2,4
"7000593",4,1488.26337712723,1572.73281143487,0,4
"7000594",7,1607.95038318391,1763.32076508842,2,5
"7000595",5,1591.79401613319,1646.12614877363,1,4
"7000596",5,1506.94725596362,1646.12614877363,1,4
"7000597",13,1695.5992551315,2001.16379457045,1,12
"7000598",5,1567.14310750819,1646.12614877363,1,4
"7000599",6,1567.29490802072,1708.62817714657,0,6
"7000600",4,1479.02302087455,1572.73281143487,0,4
"7000601",5,1596.51340682959,1646.12614877363,0,5
"7000602",7,1603.77405959133,1763.32076508842,1,6
"7000603",4,1485.74361728606,1572.73281143487,1,3
"7000604",12,1741.04972883229,1968.69006049611,0,12
"7000605",10,1602.57374587671,1896.67490607898,1,9
"7000606",7,1660.63623676414,1763.32076508842,0,7
"7000607",10,1739.76966630018,1896.67490607898,0,10
"7000608",9,1637.06770232272,1856.26587460569,1,8
"7000609",13,1748.00123612931,2001.16379457045,1,12
"7000610",10,1726.29289537392,1896.67490607898,2,8
"7000611",12,1798.7837976307,1968.69006049611,2,10
"7000612",9,1676.72396006446,1856.26587460569,2,7
"7000613",3,1447.71539452128,1482.92019466158,0,3
"7000614",5,1526.18158632822,1646.12614877363,1,4
"7000615",11,1752.64705580797,1933.98659929558,1,10
"7000616",11,1664.24603688766,1933.98659929558,1,10
"7000617",4,1459.2645515752,1572.73281143487,1,3
"7000618",2,1308.5559367426,1364.97646362037,0,2
"7000619",4,1503.93545007341,1572.73281143487,0,4
"7000620",5,1569.57453930668,1646.12614877363,0,5
"7000621",4,1485.99455133838,1572.73281143487,0,4
"7000622",3,1421.03618234532,1482.92019466158,0,3
"7000623",3,1434.50771780513,1482.92019466158,0,3
"7000624",2,1306.33006493936,1364.97646362037,0,2
"7000625",5,1534.55068109414,1646.12614877363,0,5
"7000626",2,1330.16905362641,1364.97646362037,0,2
"7000627",3,1421.03618234532,1482.92019466158,0,3
"7000628",3,1421.03618234532,1482.92019466158,0,3
"7000629",6,1560.59489598902,1708.62817714657,0,6
"7000630",3,1421.03618234532,1482.92019466158,0,3
"7000631",4,1501.7599981793,1572.73281143487,1,3
"7000632",4,1461.15204635162,1572.73281143487,0,4
"7000633",1,1195.9515544427,1184.66451052022,0,1
"7000634",1,1168.82968057459,1184.66451052022,0,1
"7000635",5,1522.01498056957,1646.12614877363,1,4
"7000636",8,1585.51729351264,1812.11073017574,2,6
"7000637",7,1605.52685703791,1763.32076508842,2,5
"7000638",5,1568.65648309091,1646.12614877363,2,3
"7000639",4,1504.25520108427,1572.73281143487,0,4
"7000640",7,1638.0048185175,1763.32076508842,1,6
"7000641",5,1573.04600758867,1646.12614877363,0,5
"7000642",6,1636.28872909944,1708.62817714657,0,6
"7000643",5,1517.14977507467,1646.12614877363,0,5
"7000644",10,1640.89377418538,1896.67490607898,1,9
"7000645",7,1597.6115492334,1763.32076508842,2,5
"7000646",4,1487.19679591011,1572.73281143487,1,3
"7000647",7,1670.78841689554,1763.32076508842,1,6
"7000648",4,1449.97950909676,1572.73281143487,1,3
"7002373",5,1563.67160026071,1646.12614877363,0,5
"7002374",3,1460.7326554039,1482.92019466158,0,3
"7002375",12,1730.58155341774,1968.69006049611,3,9
"7002376",8,1598.38665361643,1812.11073017574,3,5
"7002377",5,1558.14948150325,1646.12614877363,0,5
"7002378",4,1501.05259631998,1572.73281143487,0,4
"7002843",10,1727.84563624545,1896.67490607898,0,10
"7002844",9,1679.60529142801,1856.26587460569,2,7
"7002845",10,1652.00297662979,1896.67490607898,1,9
"7002846",7,1629.20923421443,1763.32076508842,0,7
"7002848",12,1682.00056641988,1968.69006049611,1,11
"7002849",9,1696.2154435265,1856.26587460569,0,9
"7002850",4,1506.58391500451,1572.73281143487,1,3
"7002851",5,1573.93869483475,1646.12614877363,0,5
"7002852",9,1690.59507088347,1856.26587460569,1,8
"7002853",4,1524.13625270263,1572.73281143487,0,4
"7002854",8,1762.48883919923,1812.11073017574,0,8
"7002855",3,1399.3763106936,1482.92019466158,1,2
"7002856",6,1577.48805030043,1708.62817714657,1,5
"7002857",5,1594.56923323894,1646.12614877363,0,5
"7002858",8,1573.46992970906,1812.11073017574,2,6
"7002859",3,1393.86981137524,1482.92019466158,1,2
"7002860",12,1729.93513196272,1968.69006049611,1,11
"8000651",10,1869.2344317717,1896.67490607898,3,7
"8000655",10,1993.81212105823,1896.67490607898,3,7
"8000656",15,2086.2685640875,2060.56118614118,6,9
"8000657",15,2127.59925853353,2060.56118614118,4,11
"8000658",18,2180.24412469852,2138.79896507223,5,13
"8000659",7,1752.52955421955,1763.32076508842,3,4
"8000660",18,2071.13026801919,2138.79896507223,5,13
"8000661",41,2835.42245216588,2530.72175773865,15,26
"8000662",45,3023.08066549827,2579.33597919865,17,28
"8000663",44,2819.35713053369,2567.51523707907,16,28
"8000665",16,2066.49058005838,2087.92318348224,6,10
"8000666",10,1998.66672568015,1896.67490607898,2,8
"8000672",16,2157.31031804159,2087.92318348224,4,12
"8000673",7,1839.47106134302,1763.32076508842,3,4
"8000674",11,1975.94794842675,1933.98659929558,3,8
"855003140",38,2036.54208586597,2491.71993967651,11,27
"855003141",28,2064.61886505229,2340.94327947849,9,19
"855003142",35,2322.39377920679,2450.1860183293,9,26
"855003143",34,2170.76586571764,2435.71163614839,8,26
"855003144",27,2160.30466517275,2323.60649590586,9,18
"855003145",34,2159.27010726472,2435.71163614839,11,23
"855003146",25,2051.31737843425,2287.34065519221,7,18
"912340005",2,1313.98244587047,1364.97646362037,0,2
"912340006",3,1493.18769523061,1482.92019466158,1,2
"912340007",3,1477.54143400874,1482.92019466158,0,3
"912340008",4,1451.4587455041,1572.73281143487,0,4
"912340009",2,1298.92922272858,1364.97646362037,0,2
"912340011",50,2932.10197179415,2635.48551585152,14,36
"912340012",56,2848.01662809067,2697.24673169728,14,42
"912340013",69,2650.99132320088,2814.82611826518,22,47
"912340014",52,2614.92968774006,2656.6981055205,16,36
"912340015",54,2395.43325614538,2677.2712016452,12,42
"912340016",53,2582.0730744245,2667.061866114,12,41
"912340017",62,2553.71857275,2753.94837323248,18,44
"912340018",61,2905.73227074961,2744.81051624266,14,47
"912340019",60,2865.49023702681,2735.5526890818,12,48
"912340020",71,3292.9417631475,2831.31372136695,14,57
"912340021",67,2952.16140685992,2797.95380131742,11,56
"912340022",68,3059.97010096747,2806.43931339586,18,50
"912340023",48,2491.66001326952,2613.58673801098,12,36
"912340024",51,2757.65530867574,2646.17454577679,14,37
"912340025",68,3107.09915508311,2806.43931339586,22,46
"912340026",60,2535.04171937852,2735.5526890818,18,42
"912340027",68,3227.72760464829,2806.43931339586,21,47
"912340028",67,2658.96158722093,2797.95380131742,16,51
"912340029",61,2725.74206113376,2744.81051624266,19,42
"912340030",62,3101.64475292247,2753.94837323248,14,48
"912340031",38,2506.59936868271,2491.71993967651,14,24
"912340032",53,2522.82188007654,2667.061866114,18,35
"912340033",61,2897.54401382107,2744.81051624266,17,44
"912340034",70,2993.28760636045,2823.11677003184,20,50
"912340035",46,2715.59937170891,2590.94954296761,13,33
"912340036",41,2472.22229565137,2530.72175773865,13,28
"912340037",10,1680.06348492739,1896.67490607898,1,9
"912340038",6,1579.59105610343,1708.62817714657,1,5
"912340039",12,1707.57329914375,1968.69006049611,3,9
"912340040",8,1666.97152722898,1812.11073017574,1,7
"912340041",11,1656.0965169961,1933.98659929558,1,10
"912340042",10,1567.84100311504,1896.67490607898,1,9
"912340043",10,1597.55905482046,1896.67490607898,3,7
"912340044",12,1583.96089552399,1968.69006049611,2,10
"912340045",9,1604.21828538887,1856.26587460569,3,6
"912340046",11,1602.92411174406,1933.98659929558,2,9
"912340047",13,1687.54365582336,2001.16379457045,3,10
"912340048",6,1587.73016789638,1708.62817714657,1,5
"912340141",21,1825.32394406999,2207.26116887512,3,18
"912340142",15,1906.8203270189,2060.56118614118,3,12
"912340143",21,1942.10336139985,2207.26116887512,4,17
"912340144",18,1890.34704166978,2138.79896507223,3,15
"912340145",9,1733.87999464619,1856.26587460569,1,8
"912340146",12,1784.76106475317,1968.69006049611,2,10
"912340147",13,1867.59638646329,2001.16379457045,2,11
"912340148",19,1878.46434793378,2162.56636020013,3,16
"912340149",9,1802.62431481518,1856.26587460569,0,9
"912340150",14,1840.93924137576,2031.70713799962,0,14
"912340151",16,1845.65372271346,2087.92318348224,0,16
"912340152",14,1925.68682843803,2031.70713799962,0,14
"912340153",8,1742.66039865906,1812.11073017574,0,8
"912340154",12,1844.86627673585,1968.69006049611,0,12
"912340155",9,1846.14999176736,1856.26587460569,1,8
"912340156",8,1782.00375202826,1812.11073017574,1,7
"912340157",12,1942.45175281215,1968.69006049611,0,12
"912340158",6,1749.18458190747,1708.62817714657,0,6
"912340159",24,2026.67855729314,2268.33468283819,4,20
"912340160",24,2069.12561107862,2268.33468283819,2,22
"912340161",13,1869.26978318004,2001.16379457045,1,12
"912340162",14,1890.47366141589,2031.70713799962,1,13
"912340163",12,1940.34331250953,1968.69006049611,0,12
"912340164",14,1907.2386064364,2031.70713799962,2,12
"912340165",16,1816.21630287354,2087.92318348224,2,14
"912340166",9,1873.94914726746,1856.26587460569,0,9
"912340167",12,1773.05924920267,1968.69006049611,2,10
"912340168",15,1884.26285733976,2060.56118614118,2,13
"912340169",14,1768.16700026518,2031.70713799962,3,11
"912340170",10,1846.07493145717,1896.67490607898,2,8
"912340171",18,1812.82440935528,2138.79896507223,3,15
"912340172",16,1878.69025342251,2087.92318348224,2,14
"912340173",17,1878.55279675962,2113.95669457394,1,16
"912340174",19,1806.73884663949,2162.56636020013,1,18
"912340175",16,1810.47105960747,2087.92318348224,2,14
"912340176",12,1869.02438236252,1968.69006049611,1,11
"912340177",21,1764.28409235289,2207.26116887512,2,19
"912340178",13,1801.57150612665,2001.16379457045,1,12
"912340179",19,1841.56848305617,2162.56636020013,2,17
"912340180",23,1771.77254409436,2248.68783741607,3,20
"912340181",23,1892.47540744231,2248.68783741607,3,20
"912340182",20,1901.84024636285,2185.35845629437,3,17
"912340183",15,1921.87681700528,2060.56118614118,2,13
"912340184",15,1744.22670670268,2060.56118614118,2,13
"912340185",8,1739.4513652012,1812.11073017574,2,6
"912340186",17,1952.27708930195,2113.95669457394,3,14
"912340187",9,1735.93139516297,1856.26587460569,1,8
"912340188",15,1950.24363098537,2060.56118614118,1,14
"912340189",12,1784.00414160379,1968.69006049611,1,11
"912340190",11,1863.00511974263,1933.98659929558,2,9
"912340192",10,1814.66079491404,1896.67490607898,0,10
"912340193",12,1878.92275888868,1968.69006049611,1,11
"912340194",12,1989.00596803293,1968.69006049611,2,10
"912340195",6,1694.38532590119,1708.62817714657,0,6
"912340196",9,1843.02472673876,1856.26587460569,1,8
"912340197",9,1843.89219950787,1856.26587460569,1,8
"912340198",7,1757.26003301524,1763.32076508842,0,7
"912340199",10,1920.09747218503,1896.67490607898,0,10
"912340200",9,1824.08391937313,1856.26587460569,0,9
"912340201",15,1928.85568058539,2060.56118614118,1,14
"912340202",13,1902.67954361827,2001.16379457045,1,12
"912340203",11,1828.91897364488,1933.98659929558,1,10
"912340204",12,1870.16579787699,1968.69006049611,1,11
"912340205",7,1733.80238732165,1763.32076508842,0,7
"912340206",9,1835.32865741721,1856.26587460569,1,8
"912340207",14,1888.5020815943,2031.70713799962,0,14
"912340209",11,1932.74377451127,1933.98659929558,0,11
"912340210",11,1941.43581295459,1933.98659929558,1,10
"912340211",13,1886.5314693242,2001.16379457045,1,12
"912340212",12,1906.6185643751,1968.69006049611,1,11
"912340213",14,1742.29667668273,2031.70713799962,2,12
"912340214",15,1817.01745889681,2060.56118614118,3,12
"912340216",15,1814.50711345124,2060.56118614118,0,15
"912340217",12,1926.09806777226,1968.69006049611,1,11
"912340218",15,1916.51161941142,2060.56118614118,1,14
"912340219",12,1917.00124687218,1968.69006049611,0,12
"912340220",11,1804.47501941617,1933.98659929558,0,11
"912340221",13,1871.69355185985,2001.16379457045,0,13
"912340222",16,1996.26636366555,2087.92318348224,2,14
"912340223",15,1826.70682325157,2060.56118614118,2,13
"912340224",15,1831.54080453912,2060.56118614118,1,14
"912340226",13,1941.98532037673,2001.16379457045,1,12
"912340227",24,1848.99759337784,2268.33468283819,3,21
"912340234",23,2022.11359573139,2248.68783741607,4,19
"912340235",30,1862.65476502249,2374.18906024059,5,25
"912340236",27,1755.09925889562,2323.60649590586,8,19
"912340237",21,1777.3364724523,2207.26116887512,4,17
"912340239",37,2110.23589529148,2478.17471526668,6,31
"912340240",23,1818.39133586597,2248.68783741607,9,14
"912340242",32,2201.44507388167,2405.71569249515,6,26
"912340248",26,2029.5876235311,2305.75108410937,5,21
"912340251",28,1905.53045832758,2340.94327947849,3,25
"912340252",40,1857.00562522304,2517.98110851286,6,34
"912340253",15,1979.01733589656,2060.56118614118,1,14
"912340254",45,1961.95938413184,2579.33597919865,7,38
"912340257",21,2010.68609424169,2207.26116887512,2,19
"912340259",15,2113.02758950159,2060.56118614118,3,12
"912340260",32,1933.23751168581,2405.71569249515,3,29
"912340262",11,1787.13757867595,1933.98659929558,0,11
"912340263",24,2099.84523112048,2268.33468283819,5,19
"912340264",26,2147.53047605973,2305.75108410937,6,20
"912340265",32,2113.26700913249,2405.71569249515,7,25
"912340266",39,2159.56979117493,2504.98447234734,6,33
"912340270",16,1994.75967856403,2087.92318348224,4,12
"912340272",16,1968.86923939447,2087.92318348224,5,11
"912340273",27,2105.91624430044,2323.60649590586,5,22
"912340274",7,1701.34452905211,1763.32076508842,2,5
"912340275",23,1793.87206566106,2248.68783741607,2,21
"912340277",19,1711.42792401543,2162.56636020013,2,17
"912340278",29,1890.58576377332,2357.79423966008,4,25
"912340279",27,1859.42288039627,2323.60649590586,2,25
"912340280",7,1599.95242110329,1763.32076508842,2,5
"912340281",5,1585.60340914,1646.12614877363,0,5
"912340282",15,1916.354633838,2060.56118614118,3,12
"912340283",17,1928.99631521686,2113.95669457394,2,15
"912340284",18,2041.92346959756,2138.79896507223,4,14
"912340285",15,1884.79744597475,2060.56118614118,2,13
"912340286",22,1923.82833265129,2228.3491786518,4,18
"912340287",23,1915.75994968958,2248.68783741607,4,19
"912340294",8,1719.06033502245,1812.11073017574,2,6
"912340295",33,2428.35255830081,2420.89448855093,8,25
"912340296",21,2020.44899042521,2207.26116887512,2,19
"912340297",34,2020.64539392517,2435.71163614839,7,27
"912340298",30,2063.80156123929,2374.18906024059,3,27
"912340301",29,2123.49981477976,2357.79423966008,7,22
"912340302",15,1951.66998574365,2060.56118614118,1,14
"912340303",17,2012.62637756199,2113.95669457394,2,15
"912340306",22,1959.02583066931,2228.3491786518,2,20
"912340307",23,2020.67409976444,2248.68783741607,4,19
"912340308",33,2216.71361557438,2420.89448855093,4,29
"912340309",34,2054.13088934951,2435.71163614839,9,25
"912340311",36,2057.96680010977,2464.33502634194,5,31
"912340317",48,2108.22719397792,2613.58673801098,14,34
"912340319",10,1710.32072345563,1896.67490607898,0,10
"912340320",10,1711.24675445478,1896.67490607898,2,8
"912340321",9,1707.14348975715,1856.26587460569,3,6
"912340322",8,1675.02325642023,1812.11073017574,1,7
"912340323",17,1840.50584491156,2113.95669457394,5,12
"912340324",13,1758.17646458671,2001.16379457045,4,9
"912340325",22,1737.82504545654,2228.3491786518,5,17
"912340326",22,1897.71494822448,2228.3491786518,5,17
"912340327",24,1912.02951216511,2268.33468283819,5,19
"912340328",15,1928.66121107045,2060.56118614118,0,15
"912340329",18,1944.26430281959,2138.79896507223,4,14
"912340330",19,1966.85956889762,2162.56636020013,3,16
"912340331",17,1925.34645298715,2113.95669457394,3,14
"912340332",14,1824.87805315859,2031.70713799962,3,11
"912340333",21,1787.43584107962,2207.26116887512,4,17
"912340334",7,1587.56137605625,1763.32076508842,2,5
"912340335",11,1787.69443425683,1933.98659929558,2,9
"912340336",10,1629.45746437422,1896.67490607898,3,7
"912340337",9,1632.95151758806,1856.26587460569,3,6
"912340338",16,1761.26933457314,2087.92318348224,4,12
"912340339",12,1701.35022831547,1968.69006049611,3,9
"912340340",11,1664.84653494004,1933.98659929558,1,10
"912340341",9,1685.91666722484,1856.26587460569,2,7
"912340342",13,1877.87142387585,2001.16379457045,3,10
"912340343",6,1595.89383468912,1708.62817714657,2,4
"912340344",9,1714.65380777849,1856.26587460569,2,7
"912340346",18,1827.5470675197,2138.79896507223,3,15
"912340348",11,1867.04875314168,1933.98659929558,0,11
"912340349",22,1885.65813780414,2228.3491786518,1,21
"912340350",25,2027.71623916159,2287.34065519221,6,19
"912340352",20,1971.16744344312,2185.35845629437,2,18
"912340357",62,3186.87571646257,2753.94837323248,21,41
"912340358",12,1971.07329018087,1968.69006049611,3,9
"912340359",18,1885.65451102733,2138.79896507223,7,11
"912340360",63,3625.66367476748,2762.96971264875,18,45
"912340361",71,4031.95112010353,2831.31372136695,18,53
"912340362",72,4077.0576508013,2839.4193288992,20,52
"912340363",70,3646.21079538464,2823.11677003184,23,47
"912340364",79,3426.40555053256,2893.78092561085,21,58
"912340365",59,2867.81287915113,2726.17127719361,17,42
"912340366",73,3653.53639099383,2847.4358582506,17,56
"912340367",74,3752.08649443434,2855.36548874306,22,52
"912340368",65,4048.88703926457,2780.67589681985,22,43
"912340369",58,3224.31946009604,2716.66249357165,18,40
"912340370",60,3767.9851895487,2735.5526890818,19,41
"912340371",59,3674.83032032128,2726.17127719361,15,44
"912340372",49,3133.17928236673,2624.62502504328,13,36
"912340373",53,3126.39421808452,2667.061866114,17,36
"912340374",48,3278.1023338595,2613.58673801098,15,33
"912340375",60,3496.08960527304,2735.5526890818,14,46
"912340376",56,3570.66773023006,2697.24673169728,15,41
"912340377",67,3629.05005014836,2797.95380131742,17,50
"912340378",52,3376.98045586694,2656.6981055205,17,35
"912340379",60,3293.66763374506,2735.5526890818,19,41
"912340380",52,2660.14208440473,2656.6981055205,15,37
"912340381",55,3356.10431995345,2687.33120998132,17,38
"912340382",68,2980.32871640775,2806.43931339586,22,46
"912340383",60,3006.30553104952,2735.5526890818,20,40
"912340384",50,3427.12645842556,2635.48551585152,15,35
"912340385",51,2856.22991429943,2646.17454577679,17,34
"912340386",50,2931.24949456725,2635.48551585152,20,30
"912340387",53,3282.94749699513,2667.061866114,15,38
"912340388",35,2811.61806796691,2450.1860183293,9,26
"912340389",38,2948.86270498676,2491.71993967651,7,31
"912340390",48,2731.36210208467,2613.58673801098,14,34
"912340391",70,2828.0519886131,2823.11677003184,26,44
"912340392",38,2768.7581134196,2491.71993967651,13,25
"912340393",74,2723.634941324,2855.36548874306,27,47
"912340394",42,2531.94947128776,2543.21752514954,12,30
"912340395",36,2277.78992996653,2464.33502634194,14,22
"912340396",39,2482.78203567207,2504.98447234734,14,25
"912340397",44,2249.76379994606,2567.51523707907,17,27
"912340398",39,2431.92159541843,2504.98447234734,14,25
"912340399",40,2427.70445876776,2517.98110851286,12,28
"912340400",38,2400.19301854738,2491.71993967651,12,26
"912340401",32,2302.75222374324,2405.71569249515,7,25
"912340402",39,2343.52099046568,2504.98447234734,11,28
"912340403",39,2239.07405176646,2504.98447234734,10,29
"912340404",32,2280.84242597641,2405.71569249515,7,25
"912340405",44,2415.03864460382,2567.51523707907,14,30
"912340406",31,2309.36887325443,2390.15469389133,10,21
"912340407",35,2373.50020975631,2450.1860183293,9,26
"912340409",1,1161.63288973642,1184.66451052022,0,1
"912340410",1,1154.06889749332,1184.66451052022,0,1
"912340411",1,1160.86995737529,1184.66451052022,0,1
"912340414",11,1705.80164985261,1933.98659929558,2,9
"912340416",7,1730.17370173468,1763.32076508842,2,5
"912340417",11,1686.71623951546,1933.98659929558,3,8
"912340418",10,1704.93255775508,1896.67490607898,1,9
"912340419",8,1686.95427563801,1812.11073017574,2,6
"912340420",9,1730.41365002821,1856.26587460569,2,7
"912340421",11,1782.51389327259,1933.98659929558,3,8
"912340422",11,1725.78682382785,1933.98659929558,2,9
"912340423",9,1810.91271758143,1856.26587460569,2,7
"912340424",9,1697.67064192674,1856.26587460569,2,7
"912340425",16,1736.7947380928,2087.92318348224,3,13
"912340426",12,1752.73437097386,1968.69006049611,2,10
"912340427",12,1764.32301899627,1968.69006049611,3,9
"912340428",12,1744.75564795501,1968.69006049611,3,9
"912340429",8,1743.70924831032,1812.11073017574,2,6
"912340430",7,1718.89531710672,1763.32076508842,1,6
"912340431",8,1650.74096578444,1812.11073017574,1,7
"912340433",12,1718.80289857458,1968.69006049611,3,9
"912340434",9,1691.59916910678,1856.26587460569,2,7
"912340435",9,1719.05102606938,1856.26587460569,1,8
"912340436",7,1719.84950160004,1763.32076508842,1,6
"912340437",8,1718.30783313402,1812.11073017574,2,6
"912340438",8,1761.41503299249,1812.11073017574,3,5
"912340439",9,1727.20958079904,1856.26587460569,2,7
"912340440",11,1746.74173684875,1933.98659929558,2,9
"912340441",6,1683.625396235,1708.62817714657,2,4
"912340442",9,1830.41406242445,1856.26587460569,2,7
"912340443",15,1874.72065364815,2060.56118614118,4,11
"912340444",9,1589.97061118671,1856.26587460569,1,8
"912340445",8,1727.7210803621,1812.11073017574,2,6
"912340446",30,1832.02261702475,2374.18906024059,9,21
"912340447",23,2062.10780443523,2248.68783741607,4,19
"912340448",23,2215.30712422774,2248.68783741607,9,14
"912340449",15,1880.1406093563,2060.56118614118,5,10
"912340450",24,1974.47735070721,2268.33468283819,8,16
"912340451",21,1972.9280206329,2207.26116887512,4,17
"912340452",17,1858.84308890855,2113.95669457394,3,14
"912340453",36,2425.12918632232,2464.33502634194,13,23
"912340454",23,2216.23288403896,2248.68783741607,6,17
"912340455",19,2283.59009098444,2162.56636020013,6,13
"912340456",21,2174.19193705999,2207.26116887512,5,16
"912340457",32,2489.40420577444,2405.71569249515,9,23
"912340458",21,2238.67961562608,2207.26116887512,5,16
"912340459",23,2277.15823240307,2248.68783741607,4,19
"912340460",26,2496.6290648432,2305.75108410937,8,18
"912340461",36,2746.0614170236,2464.33502634194,12,24
"912340462",37,2511.10982569682,2478.17471526668,8,29
"912340463",38,2569.38829814381,2491.71993967651,11,27
"912340464",42,2738.26182441274,2543.21752514954,12,30
"912340465",41,2593.70304707576,2530.72175773865,11,30
"912340466",39,2710.69503786644,2504.98447234734,11,28
"912340467",40,2605.30888330527,2517.98110851286,10,30
"912340468",22,2076.05664091681,2228.3491786518,6,16
"912340469",14,2081.24774691512,2031.70713799962,6,8
"912340470",30,1959.04127263452,2374.18906024059,10,20
"912340471",40,2184.29499537728,2517.98110851286,18,22
"912340472",37,2067.32333531399,2478.17471526668,15,22
"912340473",20,2142.79829887084,2185.35845629437,6,14
"912340474",26,2078.68557809798,2305.75108410937,9,17
"912340475",20,2190.5975733168,2185.35845629437,7,13
"912340476",34,2258.09311327002,2435.71163614839,13,21
"912340477",22,2218.01048653239,2228.3491786518,9,13
"912340478",27,2351.43610101232,2323.60649590586,10,17
"912340479",20,2131.7765641967,2185.35845629437,6,14
"912340480",32,1815.36119520146,2405.71569249515,10,22
"912340481",24,2004.04622573549,2268.33468283819,6,18
"912340482",29,2200.60501151356,2357.79423966008,9,20
"912340483",34,2039.08918222719,2435.71163614839,13,21
"912340484",26,2227.92572227166,2305.75108410937,9,17
"912340485",20,1964.84736447526,2185.35845629437,5,15
"912340486",23,1919.34042632512,2248.68783741607,6,17
"912340487",20,2001.69035592024,2185.35845629437,4,16
"912340488",24,2241.77917710527,2268.33468283819,9,15
"912340489",25,2041.00919594456,2287.34065519221,4,21
"912340490",26,2125.12312129815,2305.75108410937,6,20
"912340491",46,2463.29369170898,2590.94954296761,14,32
"912340492",18,1988.64277066419,2138.79896507223,4,14
"912340493",27,2352.44479016101,2323.60649590586,10,17
"912340494",17,1994.30443640084,2113.95669457394,4,13
"912340495",16,2013.80698823116,2087.92318348224,3,13
"912340496",13,1917.34841147185,2001.16379457045,2,11
"912340497",12,1901.98152313257,1968.69006049611,3,9
"912340498",17,2019.68224903286,2113.95669457394,5,12
"912340499",19,1981.28895106237,2162.56636020013,4,15
"912340500",28,2143.97077698084,2340.94327947849,9,19
"912340501",23,2057.14616055418,2248.68783741607,8,15
"912340502",14,1941.48327398945,2031.70713799962,3,11
"912340503",12,1848.80163682084,1968.69006049611,5,7
"912340504",21,1973.69019599379,2207.26116887512,6,15
"912340505",16,2002.14245554384,2087.92318348224,7,9
"912340506",18,2004.7794828361,2138.79896507223,5,13
"912340507",23,2007.34444692638,2248.68783741607,4,19
"912340508",33,2103.07688456759,2420.89448855093,8,25
"912340509",29,2150.67125020763,2357.79423966008,10,19
"912340510",41,2160.16948833876,2530.72175773865,14,27
"912340512",26,2248.99583565738,2305.75108410937,8,18
"912340513",34,2172.01936008275,2435.71163614839,11,23
"912340514",46,2806.22920700047,2590.94954296761,12,34
"912340515",38,2561.5969095303,2491.71993967651,13,25
"912340517",21,1824.8943520024,2207.26116887512,4,17
"912340518",19,2132.57170274093,2162.56636020013,4,15
"912340519",31,2305.03139005401,2390.15469389133,8,23
"912340520",19,2076.36850644849,2162.56636020013,4,15
"912340521",25,2143.20521972257,2287.34065519221,6,19
"912340522",18,1988.56396541454,2138.79896507223,5,13
"912340523",20,2085.88707935874,2185.35845629437,5,15
"912340524",23,2348.93316198099,2248.68783741607,6,17
"912340525",24,2276.97710917656,2268.33468283819,7,17
"912340526",23,2287.77281630816,2248.68783741607,7,16
"912340527",36,2102.48396537589,2464.33502634194,18,18
"912340528",28,1908.4702801265,2340.94327947849,8,20
"912340529",37,2290.84455734373,2478.17471526668,11,26
"912340530",25,2058.35185191913,2287.34065519221,10,15
"912340531",18,2029.82888561563,2138.79896507223,4,14
"912340532",32,2275.63034578579,2405.71569249515,12,20
"912340533",24,2147.22663157189,2268.33468283819,8,16
"912340534",30,1993.16945223071,2374.18906024059,8,22
"912340535",19,1894.24322358315,2162.56636020013,5,14
"912340536",30,2240.67893666584,2374.18906024059,8,22
"912340537",22,2114.68527356539,2228.3491786518,7,15
"912340538",30,2175.52956064503,2374.18906024059,8,22
"912340539",15,1896.83422393559,2060.56118614118,2,13
"912340540",19,1956.65600589912,2162.56636020013,4,15
"912340541",29,2074.47208609664,2357.79423966008,8,21
"912340542",33,1966.48710823586,2420.89448855093,7,26
"912340543",26,2069.44911257083,2305.75108410937,6,20
"912340544",45,2475.53534394504,2579.33597919865,16,29
"912340545",30,2416.11933440478,2374.18906024059,9,21
"912340546",33,2270.67159643543,2420.89448855093,10,23
"912340547",37,2180.83727786267,2478.17471526668,13,24
"912340548",36,2402.51724632292,2464.33502634194,14,22
"912340549",45,2860.65801085406,2579.33597919865,14,31
"912340550",59,3019.27492494428,2726.17127719361,19,40
"912340551",27,2096.54875062976,2323.60649590586,8,19
"912340552",26,1928.21869801626,2305.75108410937,7,19
"912340553",20,1954.11912009703,2185.35845629437,4,16
"912340554",22,2096.49045279693,2228.3491786518,4,18
"912340555",28,2147.61741315674,2340.94327947849,7,21
"912340556",22,1981.45620724594,2228.3491786518,5,17
"912340557",14,1983.53046111723,2031.70713799962,2,12
"912340559",62,2831.84427210331,2753.94837323248,18,44
"912340560",49,2858.0590047097,2624.62502504328,14,35
"912340561",37,2710.30689145561,2478.17471526668,15,22
"912340562",48,2916.43253103175,2613.58673801098,15,33
"912340563",53,2971.7014284461,2667.061866114,18,35
"912340564",39,3134.47088984791,2504.98447234734,12,27
"912340565",37,2882.67241612225,2478.17471526668,11,26
"912340566",36,2627.62704411608,2464.33502634194,11,25
"912340567",47,2650.74174137495,2602.36394728806,15,32
"912340568",40,2653.30279535214,2517.98110851286,14,26
"912340569",46,2979.00526733735,2590.94954296761,13,33
"912340570",43,2796.83620038998,2555.47878346624,14,29
"912340571",43,2802.6166382915,2555.47878346624,21,22
"912340572",42,2689.78616471995,2543.21752514954,11,31
"912340573",42,2675.73692250057,2543.21752514954,15,27
"912340574",55,3289.19522061038,2687.33120998132,16,39
"912340575",66,3431.22291425801,2789.3669207067,19,47
"912340576",54,3209.09506405521,2677.2712016452,15,39
"912340577",47,2945.42855631998,2602.36394728806,18,29
"912340578",46,2833.64661423545,2590.94954296761,16,30
"912340579",45,2593.51695344208,2579.33597919865,17,28
"912340580",46,2674.6938966832,2590.94954296761,18,28
"912340581",46,2485.57717405768,2590.94954296761,11,35
"912340582",50,2872.89576906685,2635.48551585152,14,36
"912340583",64,3205.865196032,2771.87783482774,18,46
"912340584",50,2813.69104425749,2635.48551585152,14,36
"912340586",49,2996.28484147481,2624.62502504328,17,32
"912340587",42,3024.01485274332,2543.21752514954,14,28
"912340588",36,2934.46498014518,2464.33502634194,14,22
"912340589",44,3001.02810840713,2567.51523707907,14,30
"912340590",51,2814.15082010317,2646.17454577679,16,35
"912340591",49,2598.97784235531,2624.62502504328,18,31
"912340592",24,2382.64002277439,2268.33468283819,7,17
"912340593",29,2187.26733753965,2357.79423966008,10,19
"912340594",44,2772.85369004244,2567.51523707907,12,32
"912340595",40,2523.00071169451,2517.98110851286,14,26
"912340596",43,2678.25432709502,2555.47878346624,13,30
"912340597",40,2553.2317434462,2517.98110851286,14,26
"912340598",43,2653.45874579663,2555.47878346624,10,33
"912340599",37,2543.39908065105,2478.17471526668,12,25
"912340600",27,2365.8251181656,2323.60649590586,9,18
"912340601",25,2291.83647249174,2287.34065519221,8,17
"912340602",42,2561.9265777159,2543.21752514954,11,31
"912340603",53,2509.48672882942,2667.061866114,13,40
"912340604",54,3296.64103752886,2677.2712016452,17,37
"912340605",58,3264.00426214647,2716.66249357165,18,40
"912340606",40,2570.98966518028,2517.98110851286,9,31
"912340607",41,2680.8696602621,2530.72175773865,8,33
"912340608",39,2416.09215523374,2504.98447234734,5,34
"912340609",34,2567.20361285423,2435.71163614839,11,23
"912340610",44,2707.51866080062,2567.51523707907,13,31
"912340611",59,2764.24241374284,2726.17127719361,14,45
"912340612",25,2005.11101041364,2287.34065519221,7,18
"912341092",59,2925.69606626136,2726.17127719361,22,37
"912341093",42,2854.47694959447,2543.21752514954,13,29
"912341094",45,2934.45513212231,2579.33597919865,16,29
"912341095",33,2416.28936476019,2420.89448855093,11,22
"912341096",55,2473.06052472538,2687.33120998132,18,37
"912341097",45,2231.37054391298,2579.33597919865,19,26
"912341098",50,2261.23356205726,2635.48551585152,20,30
"912341099",24,2305.67780413245,2268.33468283819,9,15
"912341100",35,2567.49628096161,2450.1860183293,15,20
"912341101",39,2420.48914379081,2504.98447234734,16,23
"912341102",45,2484.29202693763,2579.33597919865,21,24
"912341103",38,2318.93297626932,2491.71993967651,16,22
"912341104",35,2262.29585793982,2450.1860183293,14,21
"912341105",38,2350.0619351895,2491.71993967651,13,25
"912341106",37,2055.10445600281,2478.17471526668,13,24
"912341107",43,2515.99441819906,2555.47878346624,16,27
"912341108",37,2648.62625633212,2478.17471526668,14,23
"912341109",30,2500.24307286512,2374.18906024059,11,19
"912341110",46,3053.40056220982,2590.94954296761,17,29
"912341111",48,2905.79495554922,2613.58673801098,23,25
"912341112",44,2710.88179501782,2567.51523707907,19,25
"912341113",38,2430.00863335628,2491.71993967651,13,25
"912341114",45,2926.72389685594,2579.33597919865,21,24
"912341115",47,2934.17919774365,2602.36394728806,18,29
"912341116",37,2481.47429967967,2478.17471526668,15,22
"912341117",32,2692.78253710602,2405.71569249515,9,23
"912341118",32,2786.63876211147,2405.71569249515,9,23
"912341119",33,2643.60512065581,2420.89448855093,11,22
"912341120",34,2862.58236874931,2435.71163614839,10,24
"912341121",43,2782.69733230256,2555.47878346624,13,30
"912341122",37,2592.80492571387,2478.17471526668,11,26
"912341123",46,2783.83979619276,2590.94954296761,14,32
"912341124",36,2643.13945540658,2464.33502634194,10,26
"912341125",42,3018.28314786179,2543.21752514954,16,26
"912341126",51,3002.39459741348,2646.17454577679,21,30
"912341127",40,2739.10401909481,2517.98110851286,14,26
"912341128",41,2985.3452443476,2530.72175773865,15,26
"912341129",42,2813.36203835357,2543.21752514954,15,27
"912341130",47,2649.02322950373,2602.36394728806,18,29
"912341131",37,2861.63642434223,2478.17471526668,11,26
"912341132",38,3034.98576588468,2491.71993967651,12,26
"912341133",54,2782.35317887281,2677.2712016452,16,38
"912341134",26,2402.99145148289,2305.75108410937,9,17
"912341135",42,2921.60464407696,2543.21752514954,13,29
"912341136",37,2620.44443920591,2478.17471526668,11,26
"912341137",46,2746.56189770503,2590.94954296761,15,31
"912341138",20,2257.20065820038,2185.35845629437,8,12
"912341139",45,2489.09875747994,2579.33597919865,21,24
"912341140",66,2524.94436016084,2789.3669207067,28,38
"912341141",35,2505.91758203869,2450.1860183293,14,21
"912341142",35,2687.23347673467,2450.1860183293,16,19
"912341143",28,2543.92365479558,2340.94327947849,8,20
"912341144",64,3712.95069432992,2771.87783482774,23,41
"912341145",27,2664.06857108066,2323.60649590586,11,16
"912341146",52,3121.25524176477,2656.6981055205,19,33
"912341147",27,2349.37770945132,2323.60649590586,11,16
"912341148",41,2713.09614408252,2530.72175773865,20,21
"912341149",30,2579.13238619242,2374.18906024059,9,21
"912341150",30,2822.70400370475,2374.18906024059,9,21
"912341151",44,2947.5752966492,2567.51523707907,19,25
"912341152",24,2285.85955892495,2268.33468283819,9,15
"912341153",34,2805.98577236971,2435.71163614839,14,20
"912341154",49,3108.04860455672,2624.62502504328,17,32
"912341155",51,2751.3445121313,2646.17454577679,18,33
"912341156",33,2650.52006099959,2420.89448855093,9,24
"912341157",31,2641.02965817948,2390.15469389133,9,22
"912341158",48,2841.87598309031,2613.58673801098,17,31
"912341159",42,2822.34845937124,2543.21752514954,10,32
"912341160",45,2885.75999895836,2579.33597919865,15,30
"912341161",41,2705.99167774177,2530.72175773865,13,28
"912341162",21,2257.86596354604,2207.26116887512,7,14
"912341163",39,2811.98414257287,2504.98447234734,11,28
"912341164",34,3013.79675948283,2435.71163614839,9,25
"912341165",34,3195.82252538745,2435.71163614839,11,23
"912341166",49,3135.63359508462,2624.62502504328,13,36
"912341167",47,3012.50158069315,2602.36394728806,13,34
"912341168",39,2763.48359526633,2504.98447234734,10,29
"912341169",42,2694.32340658272,2543.21752514954,17,25
"912341170",44,3171.76943668405,2567.51523707907,19,25
"912341171",33,2518.28663372824,2420.89448855093,10,23
"912341172",38,2393.75879644032,2491.71993967651,14,24
"912341173",41,3235.2833927913,2530.72175773865,16,25
"912341174",33,2754.47876776469,2420.89448855093,9,24
"912341175",38,3183.40276563478,2491.71993967651,13,25
"912341176",34,3033.29239604745,2435.71163614839,12,22
"912341177",51,3448.06130834894,2646.17454577679,15,36
"912341178",40,2626.12363174421,2517.98110851286,16,24
"912341179",45,2662.25724373745,2579.33597919865,15,30
"912341180",40,3078.79479034817,2517.98110851286,14,26
"912341181",45,2730.88793696934,2579.33597919865,16,29
"912341182",36,2654.01824878806,2464.33502634194,9,27
"912341183",42,2650.89362833509,2543.21752514954,14,28
"912341184",39,2721.8419063696,2504.98447234734,8,31
"912341185",39,2714.86578242049,2504.98447234734,16,23
"912341186",36,2916.49579753822,2464.33502634194,12,24
"912341187",40,3048.815685737,2517.98110851286,11,29
"912341188",42,2750.48877775406,2543.21752514954,13,29
"912341189",31,2437.9142002013,2390.15469389133,12,19
"912341190",40,2590.81556695044,2517.98110851286,14,26
"912341191",52,2848.05904756536,2656.6981055205,18,34
"912341192",51,2890.5968758732,2646.17454577679,18,33
"912341193",49,2677.48038290288,2624.62502504328,18,31
"912341194",52,2759.84418961328,2656.6981055205,19,33
"912341195",62,2694.82354454786,2753.94837323248,20,42
"912341196",44,2983.41470946188,2567.51523707907,13,31
"912341197",40,2776.81470353255,2517.98110851286,10,30
"912341198",51,2546.56549410719,2646.17454577679,12,39
"912341199",39,2577.92046533842,2504.98447234734,9,30
"912341200",36,2617.08991898664,2464.33502634194,10,26
"912341201",34,2656.19187522439,2435.71163614839,10,24
"912341202",52,2645.18577359766,2656.6981055205,15,37
"912341203",47,2881.12492189262,2602.36394728806,15,32
"912341204",37,2479.00214926737,2478.17471526668,14,23
"912341205",29,2572.92642323033,2357.79423966008,12,17
"912341206",46,2931.13857373139,2590.94954296761,16,30
"912341207",27,2612.40683486266,2323.60649590586,7,20
"912341208",26,2358.15115017886,2305.75108410937,7,19
"912341209",33,2383.0002957664,2420.89448855093,12,21
"912341210",41,2457.8359752828,2530.72175773865,18,23
"912341211",34,2524.67566274055,2435.71163614839,11,23
"912341212",51,2400.31352555419,2646.17454577679,15,36
"912341213",32,2483.67356437252,2405.71569249515,8,24
"912341214",50,2252.40022966784,2635.48551585152,17,33
"912341215",60,2714.48831930067,2735.5526890818,21,39
"912341216",33,2353.14410580653,2420.89448855093,9,24
"912341217",55,2879.93947148223,2687.33120998132,21,34
"912341218",33,2463.14206526144,2420.89448855093,9,24
"912341219",54,2669.12184171343,2677.2712016452,12,42
"912341220",39,2291.29803885775,2504.98447234734,12,27
"912341221",43,2694.5413576136,2555.47878346624,14,29
"912341222",28,2625.40340962,2340.94327947849,9,19
"912341223",56,2989.10881007792,2697.24673169728,18,38
"912341766",8,1573.61894001444,1812.11073017574,4,4
"912341767",3,1390.6648756711,1482.92019466158,2,1
"912341768",7,1537.97816792772,1763.32076508842,4,3
"912341769",12,1580.92360834382,1968.69006049611,5,7
"912341770",13,1614.24219721374,2001.16379457045,5,8
"912341771",13,1580.18152697916,2001.16379457045,5,8
"912341772",13,1547.55195219968,2001.16379457045,4,9
"912341773",9,1526.05284725711,1856.26587460569,4,5
"912341774",8,1553.73155484248,1812.11073017574,4,4
"912341775",7,1548.45995145616,1763.32076508842,4,3
"912341776",6,1555.583725084,1708.62817714657,2,4
"912341777",7,1538.31120074341,1763.32076508842,3,4
"912341778",6,1549.48662443818,1708.62817714657,4,2
"912341779",13,1564.56374384341,2001.16379457045,6,7
"912341780",3,1410.14021311871,1482.92019466158,2,1
"912341781",1,1165.39530323111,1184.66451052022,1,0
"912341782",10,1552.22310491033,1896.67490607898,7,3
"912341783",11,1528.25077239813,1933.98659929558,3,8
"912341784",12,1534.19918963973,1968.69006049611,4,8
"912341785",11,1536.12777913815,1933.98659929558,4,7
"912341786",10,1575.89572986534,1896.67490607898,5,5
"912341787",8,1563.94566083173,1812.11073017574,4,4
"912341788",6,1574.50897801463,1708.62817714657,3,3
"912341789",19,2231.45282813122,2162.56636020013,7,12
"912341790",23,2225.7191254457,2248.68783741607,9,14
"912341791",20,2227.70246673114,2185.35845629437,8,12
"912341792",20,2123.36230202301,2185.35845629437,5,15
"912341793",18,2078.25456939756,2138.79896507223,6,12
"912341794",19,2289.13838160164,2162.56636020013,5,14
"912341795",28,2026.55419920298,2340.94327947849,13,15
"912341796",24,2105.00825262416,2268.33468283819,9,15
"912341797",17,2145.6567264487,2113.95669457394,7,10
"912341798",16,2054.27615095915,2087.92318348224,5,11
"912341799",28,2226.88415655901,2340.94327947849,9,19
"912341800",30,2298.39975926892,2374.18906024059,10,20
"912341801",21,2067.25068400585,2207.26116887512,7,14
"912341802",19,2101.13633001868,2162.56636020013,7,12
"912341803",20,2204.23327836481,2185.35845629437,7,13
"912341804",19,2155.2786313595,2162.56636020013,7,12
"912341805",23,2231.07801743427,2248.68783741607,7,16
"912341807",20,2177.01492391362,2185.35845629437,7,13
"912341808",20,2115.10935687376,2185.35845629437,8,12
"912341809",23,2156.77755702099,2248.68783741607,8,15
"912341810",25,2269.40851161476,2287.34065519221,8,17
"912341811",17,2080.43514943584,2113.95669457394,6,11
"912341812",16,1980.92881693641,2087.92318348224,7,9
"912341813",18,2023.43906850181,2138.79896507223,8,10
"912341814",15,2036.30982696892,2060.56118614118,4,11
"912341815",10,1909.78061126068,1896.67490607898,5,5
"912341816",13,2039.82701191999,2001.16379457045,5,8
"912341817",32,2426.55468401347,2405.71569249515,12,20
"912341818",34,2656.46429820997,2435.71163614839,11,23
"912341819",26,2305.58141840183,2305.75108410937,9,17
"912341820",7,1749.18631664973,1763.32076508842,1,6
"912341821",9,1871.33368831675,1856.26587460569,2,7
"912341822",27,2464.01422029593,2323.60649590586,9,18
"912341823",32,2331.16691653602,2405.71569249515,16,16
"912341824",13,2013.07566039885,2001.16379457045,5,8
"912341825",37,2462.12653892342,2478.17471526668,16,21
"912341826",39,2526.11192114161,2504.98447234734,17,22
"912341827",27,2487.2057374806,2323.60649590586,11,16
"912341829",21,2104.92384262318,2207.26116887512,6,15
"912341831",9,1686.59577078556,1856.26587460569,3,6
"912341832",8,1673.00264419576,1812.11073017574,3,5
"912341834",18,2105.57814383552,2138.79896507223,6,12
"912341835",14,2045.85627307851,2031.70713799962,4,10
"912341836",24,2119.16065347771,2268.33468283819,7,17
"912341837",67,2946.28378153997,2797.95380131742,19,48
"912341838",46,2816.28493034113,2590.94954296761,10,36
"912341839",43,2780.9964211796,2555.47878346624,15,28
"912341840",35,2519.10636612885,2450.1860183293,6,29
"912341841",54,2523.1050085058,2677.2712016452,16,38
"912341842",62,2834.63212205603,2753.94837323248,16,46
"912341843",74,2944.13306155151,2855.36548874306,19,55
"912341844",56,2754.85876043582,2697.24673169728,12,44
"912341845",57,2650.27522338632,2707.02236739438,14,43
"912341846",24,2244.21816568809,2268.33468283819,4,20
"912341847",5,1464.20987762912,1646.12614877363,0,5
"912341848",3,1397.49924965128,1482.92019466158,2,1
"912341849",1,1144.88248711016,1184.66451052022,0,1
"912341850",3,1411.44156231589,1482.92019466158,2,1
"912341851",5,1452.43103912864,1646.12614877363,1,4
"912341852",2,1293.88207205852,1364.97646362037,1,1
"912341853",2,1293.88207205852,1364.97646362037,1,1
"912341854",3,1393.51328932651,1482.92019466158,2,1
"912341855",6,1480.99251604653,1708.62817714657,1,5
"912341856",6,1471.42519853783,1708.62817714657,2,4
"912341857",1,1144.88248711016,1184.66451052022,0,1
"912341859",1,1158.60801709197,1184.66451052022,0,1
"912341861",1,1155.9980439258,1184.66451052022,1,0
"912341862",2,1311.96835167921,1364.97646362037,0,2
"912341863",5,1474.12893135944,1646.12614877363,0,5
"912341864",5,1496.90659660527,1646.12614877363,1,4
"912341865",3,1408.63184050767,1482.92019466158,0,3
"912341866",5,1485.98843050989,1646.12614877363,0,5
"912341867",5,1499.96935254504,1646.12614877363,1,4
"912341868",3,1397.85255232655,1482.92019466158,0,3
"912341870",3,1397.85255232655,1482.92019466158,0,3
"912341871",6,1507.8240199674,1708.62817714657,0,6
"912341872",7,1519.56983628627,1763.32076508842,0,7
"912341873",6,1499.65007764171,1708.62817714657,0,6
"912341874",5,1474.12893135944,1646.12614877363,0,5
"912341875",5,1500.10151804847,1646.12614877363,0,5
"912341876",4,1472.39845866795,1572.73281143487,0,4
"912341877",3,1410.60640726522,1482.92019466158,0,3
"912341878",5,1500.10151804847,1646.12614877363,0,5
"912341879",4,1446.90551959121,1572.73281143487,0,4
"912341880",4,1446.90551959121,1572.73281143487,0,4
"912341881",4,1472.39845866795,1572.73281143487,0,4
"912341882",3,1408.82629492408,1482.92019466158,0,3
"912341894",2,1330.31640868508,1364.97646362037,0,2
"912341895",2,1330.31640868508,1364.97646362037,0,2
"912341896",3,1397.78998879966,1482.92019466158,1,2
"912341897",1,1182.48225129826,1184.66451052022,0,1
"912341898",2,1330.31640868508,1364.97646362037,0,2
"912341899",3,1402.91749785247,1482.92019466158,1,2
"912341900",2,1323.85543898582,1364.97646362037,0,2
"912341901",3,1402.91749785247,1482.92019466158,1,2
"912341902",4,1473.44424725622,1572.73281143487,0,4
"912341904",4,1438.17451061118,1572.73281143487,1,3
"912341905",5,1483.37341376246,1646.12614877363,1,4
"912341906",5,1483.37341376246,1646.12614877363,1,4
"912341907",3,1402.91749785247,1482.92019466158,1,2
"912341908",3,1402.91749785247,1482.92019466158,1,2
"912341909",4,1452.92559134163,1572.73281143487,0,4
"912341910",3,1390.19418663479,1482.92019466158,0,3
"912341911",2,1323.85543898582,1364.97646362037,0,2
"912341912",4,1502.1806293436,1572.73281143487,0,4
"912341913",3,1390.19418663479,1482.92019466158,0,3
"912341914",3,1417.30695415022,1482.92019466158,0,3
"912341915",14,1793.2774220242,2031.70713799962,3,11
"912341916",15,1795.95703836421,2060.56118614118,3,12
"912341917",19,1915.432202123,2162.56636020013,8,11
"912341918",25,1833.6308892782,2287.34065519221,5,20
"912341919",19,1910.53907949718,2162.56636020013,1,18
"912341920",27,2088.22550198482,2323.60649590586,6,21
"912341921",18,1731.61470251026,2138.79896507223,2,16
"912341922",24,2114.55694380935,2268.33468283819,6,18
"912341924",8,1674.40963525539,1812.11073017574,2,6
"912341925",12,1870.13260336327,1968.69006049611,1,11
"912341926",4,1525.25259044087,1572.73281143487,1,3
"912341927",4,1577.77517486875,1572.73281143487,0,4
"912341928",10,1769.93562791469,1896.67490607898,3,7
"912341929",9,1748.58682785648,1856.26587460569,0,9
"912341930",13,1899.48064703227,2001.16379457045,1,12
"912341931",14,1744.67382892167,2031.70713799962,3,11
"912341932",10,1687.6840874439,1896.67490607898,0,10
"912341933",9,1713.27359702012,1856.26587460569,0,9
"912341934",15,1951.21098807471,2060.56118614118,2,13
"912341935",19,1862.347780261,2162.56636020013,2,17
"912341936",12,1867.28368099654,1968.69006049611,2,10
"912341937",10,1750.11373830247,1896.67490607898,1,9
"912341939",15,1905.26042547688,2060.56118614118,3,12
"912341940",20,2008.21381854396,2185.35845629437,2,18
"912341941",7,1676.41078182698,1763.32076508842,1,6
"912341942",7,1679.79338817955,1763.32076508842,1,6
"912341943",12,1957.78901656371,1968.69006049611,2,10
"912341944",7,1642.2914428574,1763.32076508842,2,5
"912341945",4,1487.84425599883,1572.73281143487,1,3
"912341946",6,1666.65794465648,1708.62817714657,0,6
"912341947",10,1903.52730716145,1896.67490607898,1,9
"912341949",5,1572.14756091602,1646.12614877363,1,4
"912341951",8,1709.13581459768,1812.11073017574,1,7
"912341953",10,1696.83916597452,1896.67490607898,2,8
"912341954",7,1748.15087455944,1763.32076508842,1,6
"912341955",13,1873.23979861864,2001.16379457045,3,10
"912341956",4,1531.01582989643,1572.73281143487,0,4
"912341957",5,1582.57876249347,1646.12614877363,0,5
"912341958",3,1417.47543729498,1482.92019466158,1,2
"912341959",10,1777.9430857157,1896.67490607898,1,9
"912341960",13,1882.02439402766,2001.16379457045,3,10
"912341961",11,1795.31881457698,1933.98659929558,2,9
"912341962",3,1417.6193059716,1482.92019466158,1,2
"912341963",15,1897.33677828165,2060.56118614118,4,11
"912341964",19,1768.31847505513,2162.56636020013,2,17
"912341965",22,1903.68989776374,2228.3491786518,5,17
"912341966",82,3600.85150646315,2915.91045786314,27,55
"912341969",83,3430.94307312814,2923.1438046077,32,51
"912341970",82,3395.73871469178,2915.91045786314,34,48
"912342031",93,3721.52488064326,2991.90921350397,34,59
"912342032",95,4147.44718069041,3004.94950458202,30,65
"912342033",103,3171.1019728312,3055.02181112984,34,69
"912342034",94,3340.35012994538,2998.45695239283,25,69
"912342035",79,3200.71607099394,2893.78092561085,23,56
"912342036",5,1639.67142778817,1646.12614877363,1,4
"912342037",7,1718.87915027124,1763.32076508842,2,5
"912342038",9,1746.63318341775,1856.26587460569,3,6
"912342039",14,1725.58924869611,2031.70713799962,2,12
"912342040",5,1650.28324376403,1646.12614877363,2,3
"912342041",7,1648.04156657858,1763.32076508842,1,6
"912342042",8,1681.68538373895,1812.11073017574,2,6
"912342043",9,1791.52474356062,1856.26587460569,3,6
"912342044",8,1720.97044176801,1812.11073017574,2,6
"912342045",12,1728.97846987363,1968.69006049611,2,10
"912342046",11,1788.36347516435,1933.98659929558,3,8
"912342047",13,1708.79788548251,2001.16379457045,3,10
"912342048",9,1790.25750920519,1856.26587460569,2,7
"912342049",13,1763.15425512483,2001.16379457045,2,11
"912342052",8,1729.24356694734,1812.11073017574,3,5
"912342053",8,1673.87306441173,1812.11073017574,2,6
"912342054",12,1722.74497413903,1968.69006049611,3,9
"912342055",4,1580.54100279482,1572.73281143487,1,3
"912342056",7,1714.28387365326,1763.32076508842,1,6
"912342057",10,1709.9246479493,1896.67490607898,1,9
"912342058",6,1690.56026161822,1708.62817714657,1,5
"912342059",11,1818.9897421094,1933.98659929558,4,7
"912342060",9,1784.86659496996,1856.26587460569,2,7
"912342061",10,1761.90444680457,1896.67490607898,1,9
"912342062",7,1754.21067883004,1763.32076508842,2,5
"912342063",8,1713.94686932252,1812.11073017574,2,6
"912342064",7,1773.8108238514,1763.32076508842,2,5
"912342065",8,1722.36287940526,1812.11073017574,2,6
"912342067",7,1706.8543148224,1763.32076508842,1,6
"912342068",9,1721.72237536079,1856.26587460569,1,8
"912342069",6,1711.13454391822,1708.62817714657,2,4
"912342070",7,1773.8108238514,1763.32076508842,2,5
"912342071",8,1595.91113010873,1812.11073017574,0,8
"912342073",5,1661.99189573918,1646.12614877363,1,4
"912342074",12,1754.69241067879,1968.69006049611,1,11
"912342075",7,1750.65845899416,1763.32076508842,1,6
"912342076",7,1732.35778555894,1763.32076508842,2,5
"912342077",6,1697.91889604399,1708.62817714657,1,5
"912342078",7,1730.15703503821,1763.32076508842,1,6
"912342080",5,1661.99189573918,1646.12614877363,1,4
"912342081",6,1731.01314025839,1708.62817714657,1,5
"912342082",3,1513.28544623258,1482.92019466158,1,2
"912342083",5,1639.67142778817,1646.12614877363,1,4
"912342086",9,1747.11156138337,1856.26587460569,2,7
"912342087",10,1697.84248955754,1896.67490607898,2,8
"912342088",12,1778.28407752287,1968.69006049611,3,9
"912342089",7,1663.98133219531,1763.32076508842,2,5
"912342091",5,1507.87575777615,1646.12614877363,0,5
"912342092",4,1472.52198581632,1572.73281143487,0,4
"912342093",4,1467.06560015539,1572.73281143487,0,4
"912342094",1,1167.4550817084,1184.66451052022,0,1
"912342095",2,1330.07806212425,1364.97646362037,0,2
"912342096",17,2062.2055054862,2113.95669457394,6,11
"912342097",21,2039.98683733556,2207.26116887512,8,13
"912342098",19,2083.79934582099,2162.56636020013,7,12
"912342100",19,2079.61289644049,2162.56636020013,10,9
"912342102",17,2046.59344937254,2113.95669457394,6,11
"912342103",15,2006.38161853686,2060.56118614118,6,9
"912342104",17,2033.51249953523,2113.95669457394,7,10
"912342105",17,2076.69179259852,2113.95669457394,6,11
"912342106",20,2053.68782929017,2185.35845629437,7,13
"912342107",12,1870.68951757901,1968.69006049611,5,7
"912342108",16,1937.94340513654,2087.92318348224,7,9
"912342109",19,2104.05379575352,2162.56636020013,8,11
"912342110",20,2206.94284547881,2185.35845629437,11,9
"912342111",16,2053.27292056954,2087.92318348224,6,10
"912342112",15,2021.12081637867,2060.56118614118,5,10
"912342113",13,1970.66693772055,2001.16379457045,5,8
"912342114",14,2048.28284091168,2031.70713799962,6,8
"912342115",16,2083.19968232911,2087.92318348224,7,9
"912342116",17,2078.77785614461,2113.95669457394,7,10
"912342117",14,1941.54963142592,2031.70713799962,7,7
"912342118",48,2806.70792528252,2613.58673801098,20,28
"912342119",46,3014.87792110845,2590.94954296761,15,31
"912342120",39,3218.29064386754,2504.98447234734,17,22
"912342121",48,3054.5136087829,2613.58673801098,18,30
"912342122",47,2805.24727290248,2602.36394728806,14,33
"912342123",35,2520.57912755176,2450.1860183293,13,22
"912342124",37,2669.04409254575,2478.17471526668,11,26
"912342125",35,2733.1240659398,2450.1860183293,15,20
"912342126",40,2834.3255684587,2517.98110851286,13,27
"912342127",86,2815.63842123819,2944.43562859908,28,58
"912342128",30,2467.14556271203,2374.18906024059,7,23
"912342129",61,2909.78569114129,2744.81051624266,21,40
"912342130",69,3072.13405273227,2814.82611826518,24,45
"912342131",51,3224.83017182624,2646.17454577679,18,33
"912342132",84,3279.08060795417,2930.30814451558,31,53
"912342133",67,2708.98315795863,2797.95380131742,27,40
"912342134",75,2770.26089935338,2863.21031780169,24,51
"912342135",71,3464.52271001761,2831.31372136695,21,50
"912342136",78,2898.68807391555,2886.25582696583,28,50
"912342137",51,2893.56759024455,2646.17454577679,15,36
"912342138",77,2418.58163493152,2878.65357631343,30,47
"912342139",84,3397.02638992971,2930.30814451558,28,56
"912342140",62,3072.11411121625,2753.94837323248,22,40
"912342141",51,3463.4116073286,2646.17454577679,15,36
"912342142",92,2807.00983913405,2985.30521778333,35,57
"912342143",64,3110.98931161693,2771.87783482774,25,39
"912342144",60,2965.63816622814,2735.5526890818,15,45
"912342145",47,2775.6065757292,2602.36394728806,11,36
"912342146",64,2725.85167862339,2771.87783482774,21,43
"912342147",68,2944.91599023071,2806.43931339586,30,38
"912342148",70,2765.69269899204,2823.11677003184,23,47
"912342149",84,2820.14304572179,2930.30814451558,29,55
"912342150",63,3319.1386612351,2762.96971264875,21,42
"912342151",76,3019.19671808082,2870.97236507783,28,48
"912342152",55,2661.87122297453,2687.33120998132,14,41
"912342153",78,2873.54538448918,2886.25582696583,32,46
"912342154",81,3012.65036623054,2908.60658576875,32,49
"912342155",42,2671.77126592435,2543.21752514954,14,28
"912342156",46,2826.70784637885,2590.94954296761,17,29
"912342158",32,2601.32210668484,2405.71569249515,10,22
"912342159",34,2662.81319703415,2435.71163614839,10,24
"912342160",34,2526.28402199417,2435.71163614839,6,28
"912342163",35,2442.30858892449,2450.1860183293,11,24
"912342165",72,2934.20166148527,2839.4193288992,29,43
"912342166",61,2911.33995379787,2744.81051624266,25,36
"912342167",40,2775.82717954034,2517.98110851286,13,27
"912342168",43,2966.6555221646,2555.47878346624,16,27
"912342169",26,1848.16278551482,2305.75108410937,9,17
"912342170",33,1974.20651793862,2420.89448855093,8,25
"912342171",17,2113.16718549899,2113.95669457394,2,15
"912342172",20,2050.2394075135,2185.35845629437,5,15
"912342173",33,2001.61736379218,2420.89448855093,7,26
"912342174",26,2238.35482261744,2305.75108410937,7,19
"912342175",21,2046.70327183971,2207.26116887512,7,14
"912342176",24,2075.38934505737,2268.33468283819,8,16
"912342177",15,1952.73254804815,2060.56118614118,3,12
"912342178",24,2204.49207607626,2268.33468283819,8,16
"912342179",21,2059.19543585931,2207.26116887512,6,15
"912342180",20,2043.30934462678,2185.35845629437,7,13
"912342181",22,2104.32617472117,2228.3491786518,5,17
"912342182",22,2129.79255930231,2228.3491786518,6,16
"912342183",16,1887.13222390454,2087.92318348224,5,11
"912342184",25,1952.07574353009,2287.34065519221,6,19
"912342185",32,2313.36716835099,2405.71569249515,15,17
"912342186",35,2379.53814155972,2450.1860183293,18,17
"912342187",44,2501.69390580397,2567.51523707907,20,24
"912342189",47,2579.68767960984,2602.36394728806,24,23
"912342190",50,2674.98438654757,2635.48551585152,21,29
"912342191",42,2592.30629838573,2543.21752514954,18,24
"912342192",9,1556.02123500883,1856.26587460569,4,5
"912342196",16,1931.68538171971,2087.92318348224,4,12
"912342198",9,1694.71199171191,1856.26587460569,3,6
"912342200",9,1549.94770286788,1856.26587460569,3,6
"912342201",9,1578.10314757058,1856.26587460569,2,7
"912342202",1,1168.07761147649,1184.66451052022,0,1
"912342203",1,1168.07761147649,1184.66451052022,0,1
"912342205",14,1855.69870945678,2031.70713799962,1,13
"912342206",18,2034.05244507717,2138.79896507223,3,15
"912342207",23,2114.85709591928,2248.68783741607,4,19
"912342208",19,2117.58855583623,2162.56636020013,3,16
"912342209",26,2116.19738133714,2305.75108410937,3,23
"912342210",28,1978.32685504097,2340.94327947849,5,23
"912342211",23,2040.7845334197,2248.68783741607,4,19
"912342212",8,1813.86056630716,1812.11073017574,1,7
"912342213",17,1868.80931203729,2113.95669457394,3,14
"912342214",25,2092.1733314486,2287.34065519221,4,21
"912342215",15,1890.80548176529,2060.56118614118,2,13
"912342216",23,2202.9777669388,2248.68783741607,2,21
"912342217",24,2060.36557295821,2268.33468283819,4,20
"912342218",23,2074.46959962841,2248.68783741607,2,21
"912342219",21,1999.12807270644,2207.26116887512,5,16
"912342220",32,1943.43421822372,2405.71569249515,6,26
"912342221",21,1920.91063934401,2207.26116887512,3,18
"912342222",29,2069.19781397395,2357.79423966008,4,25
"912342223",25,1976.06093577534,2287.34065519221,3,22
"912342224",13,2033.28123826112,2001.16379457045,1,12
"912342225",25,2512.93445320963,2287.34065519221,9,16
"912342226",26,2557.14420726313,2305.75108410937,5,21
"912342227",29,2868.19059658293,2357.79423966008,12,17
"912342228",37,2659.22348757959,2478.17471526668,14,23
"912342229",35,2877.02985981395,2450.1860183293,12,23
"912342230",55,2587.90789213264,2687.33120998132,19,36
"912342231",47,2592.71954037892,2602.36394728806,14,33
"912342232",61,2448.95356643763,2744.81051624266,24,37
"912342233",54,2724.19251581619,2677.2712016452,17,37
"912342234",58,2859.14410495357,2716.66249357165,19,39
"912342235",73,3182.16921140946,2847.4358582506,26,47
"912342236",81,3604.19715500771,2908.60658576875,29,52
"912342237",64,2739.191318437,2771.87783482774,21,43
"912342238",47,2926.5923591942,2602.36394728806,13,34
"912342239",32,2301.18102371835,2405.71569249515,12,20
"912342240",42,2664.97410383492,2543.21752514954,13,29
"912342241",45,2738.32909854193,2579.33597919865,14,31
"912342242",49,2627.26808334856,2624.62502504328,13,36
"912342243",55,2662.87471742274,2687.33120998132,19,36
"912342244",33,2358.23347452341,2420.89448855093,10,23
"912342245",22,2228.60118199768,2228.3491786518,9,13
"912342266",50,2824.22706545345,2635.48551585152,16,34
"912342267",64,2884.13895101668,2771.87783482774,19,45
"912342268",66,2639.40685538068,2789.3669207067,22,44
"912342269",67,2449.65029057406,2797.95380131742,24,43
"912342270",67,2715.40034412955,2797.95380131742,22,45
"912342271",80,2669.67726387194,2901.2306171403,24,56
"912342272",45,2735.70218398002,2579.33597919865,11,34
"912342273",58,3089.3292625713,2716.66249357165,15,43
"912342274",51,2658.31987544818,2646.17454577679,15,36
"912342275",42,2503.06827289946,2543.21752514954,12,30
"912342276",50,2495.61609895408,2635.48551585152,18,32
"912342277",51,2858.96425019844,2646.17454577679,16,35
"912342278",53,2545.06417862025,2667.061866114,14,39
"912342279",70,2501.7894757163,2823.11677003184,25,45
"912342280",60,2650.31797205356,2735.5526890818,17,43
"912342282",65,2684.40948820801,2780.67589681985,15,50
"912342283",61,2487.58415784474,2744.81051624266,21,40
"912342284",55,2575.04866501215,2687.33120998132,24,31
"912342285",78,3094.53203217812,2886.25582696583,28,50
"912342347",6,1578.84396857652,1708.62817714657,2,4
"912342348",11,1689.07610127249,1933.98659929558,2,9
"912342351",3,1418.25622314303,1482.92019466158,0,3
"912342373",59,2807.03189288952,2726.17127719361,16,43
"912342374",39,2936.10806335165,2504.98447234734,13,26
"912342375",76,2797.41227487209,2870.97236507783,24,52
"912342376",71,3147.7475785919,2831.31372136695,25,46
"912342377",70,2906.29642942863,2823.11677003184,27,43
"912342378",64,2639.16518578287,2771.87783482774,24,40
"912342379",86,3762.76970781243,2944.43562859908,24,62
"912342380",66,3250.66953727525,2789.3669207067,20,46
"912342381",92,3445.46449725876,2985.30521778333,23,69
"912342382",86,3423.80901976429,2944.43562859908,28,58
"912342383",92,3118.07154528884,2985.30521778333,27,65
"912342384",75,3701.39499063427,2863.21031780169,23,52
"912342385",71,3416.98113443248,2831.31372136695,24,47
"912342386",54,2575.48211119204,2677.2712016452,19,35
"912342387",72,2631.43751185552,2839.4193288992,16,56
"912342388",71,3101.60771467059,2831.31372136695,21,50
"912342389",21,1933.86405930493,2207.26116887512,5,16
"912342390",18,1831.73708801281,2138.79896507223,2,16
"912342391",24,1854.65584561347,2268.33468283819,5,19
"912342392",18,1836.14435290411,2138.79896507223,3,15
"912342393",18,1855.68244665087,2138.79896507223,5,13
"912342394",12,1799.58981232797,1968.69006049611,1,11
"912342395",20,1851.48890107744,2185.35845629437,4,16
"912342396",14,1834.7257566083,2031.70713799962,1,13
"912342397",15,1838.92458040483,2060.56118614118,3,12
"912342398",11,1740.66208310559,1933.98659929558,2,9
"912342399",9,1817.11305093594,1856.26587460569,0,9
"912342400",15,1750.00682258722,2060.56118614118,3,12
"912342401",21,1958.2256373694,2207.26116887512,4,17
"912342402",17,1755.83061400624,2113.95669457394,3,14
"912342403",17,1762.78821546923,2113.95669457394,3,14
"912342404",22,1781.6384802293,2228.3491786518,4,18
"912342405",23,1820.49853378034,2248.68783741607,5,18
"912342406",24,1969.66772875591,2268.33468283819,4,20
"912342407",27,2025.82211690903,2323.60649590586,6,21
"912342408",20,1830.56017933654,2185.35845629437,4,16
"912342409",24,2002.268381405,2268.33468283819,5,19
"912342410",25,1930.60451989418,2287.34065519221,7,18
"912342411",27,1942.35588607869,2323.60649590586,7,20
"912342412",21,1829.0226714378,2207.26116887512,5,16
"912342413",20,1850.05393453668,2185.35845629437,4,16
"912342414",25,1899.68247298659,2287.34065519221,6,19
"912342415",17,1824.80771748785,2113.95669457394,3,14
"912342416",23,1983.96925210745,2248.68783741607,5,18
"912342417",25,2030.06862125819,2287.34065519221,7,18
"912342418",19,1939.37046855065,2162.56636020013,4,15
"912342419",18,1965.30693266329,2138.79896507223,5,13
"912342420",20,1945.31233309366,2185.35845629437,5,15
"912342421",28,2086.46198434137,2340.94327947849,7,21
"912342422",16,1799.16514565261,2087.92318348224,2,14
"912342423",20,1983.78420548505,2185.35845629437,5,15
"912342424",22,1846.8904766727,2228.3491786518,5,17
"912342425",17,1925.5257728567,2113.95669457394,2,15
"912342426",7,1639.61600716125,1763.32076508842,1,6
"912342427",15,1801.99916169337,2060.56118614118,2,13
"912342428",17,1916.43957828427,2113.95669457394,6,11
"912342429",44,2667.55471516445,2567.51523707907,18,26
"912342430",19,1985.78064296939,2162.56636020013,6,13
"912342431",41,2447.59867876357,2530.72175773865,12,29
"912342432",26,2100.34160803483,2305.75108410937,12,14
"912342433",47,2441.80152827742,2602.36394728806,17,30
"912342434",44,2200.23143964179,2567.51523707907,15,29
"912342435",31,2425.06984661968,2390.15469389133,12,19
"912342436",31,2008.13858229173,2390.15469389133,8,23
"912342437",43,2551.38016045366,2555.47878346624,12,31
"912342438",50,2462.80158545484,2635.48551585152,16,34
"912342439",35,2607.78519850152,2450.1860183293,9,26
"912342440",33,2642.32359902417,2420.89448855093,13,20
"912342441",33,2488.54076699282,2420.89448855093,8,25
"912342442",39,2556.87630403378,2504.98447234734,9,30
"912342443",25,1727.08166546304,2287.34065519221,10,15
"912342444",26,2043.40419579754,2305.75108410937,8,18
"912342445",28,2167.91797492834,2340.94327947849,11,17
"912342446",29,2239.44393424282,2357.79423966008,11,18
"912342447",24,2090.14219500015,2268.33468283819,6,18
"912342448",24,2114.29156812142,2268.33468283819,8,16
"912342449",26,2172.13661215283,2305.75108410937,10,16
"912342450",39,2332.42248085442,2504.98447234734,13,26
"912342451",27,2021.27520589777,2323.60649590586,15,12
"912342452",26,2179.92868843399,2305.75108410937,11,15
"912342453",40,2502.79713024597,2517.98110851286,15,25
"912342454",36,2443.67531350771,2464.33502634194,10,26
"912342455",28,2338.59368165946,2340.94327947849,10,18
"912342456",35,2419.47130935928,2450.1860183293,14,21
"912342457",26,2328.78585892445,2305.75108410937,9,17
"912342458",31,2543.71465036061,2390.15469389133,8,23
"912342459",21,2056.48130028511,2207.26116887512,9,12
"912342460",33,2423.43223385932,2420.89448855093,10,23
"912342461",34,2665.48265296029,2435.71163614839,11,23
"912342462",39,2531.35372707793,2504.98447234734,11,28
"912342463",30,2557.26608695548,2374.18906024059,9,21
"912342464",42,2693.5278355133,2543.21752514954,12,30
"912342465",37,2498.93846478871,2478.17471526668,11,26
"912342466",26,2338.07230799791,2305.75108410937,6,20
"912342467",24,2158.52772117141,2268.33468283819,9,15
"912342468",24,2192.98951528375,2268.33468283819,8,16
"912342469",17,1836.02891248563,2113.95669457394,6,11
"912342470",37,2397.02198985057,2478.17471526668,17,20
"912342471",15,2030.17723127228,2060.56118614118,7,8
"912342472",30,2200.05127031752,2374.18906024059,10,20
"912342473",14,1937.6368143134,2031.70713799962,2,12
"912342474",21,1955.50103188103,2207.26116887512,4,17
"912342475",25,2020.82731928507,2287.34065519221,9,16
"912342476",28,2176.57837066802,2340.94327947849,12,16
"912342477",28,2145.25247513237,2340.94327947849,8,20
"912342478",40,2330.42935377241,2517.98110851286,16,24
"912342479",31,2264.43367186888,2390.15469389133,9,22
"912342480",47,2392.53470919254,2602.36394728806,19,28
"912342481",43,2724.66425626408,2555.47878346624,17,26
"912342482",51,3095.20036722946,2646.17454577679,19,32
"912342483",39,2373.3651190866,2504.98447234734,12,27
"912342484",30,2217.81189979877,2374.18906024059,10,20
"912342485",42,2497.93325455314,2543.21752514954,17,25
"912342486",52,2537.15702933952,2656.6981055205,19,33
"912342487",12,1815.91333512811,1968.69006049611,3,9
"912342488",16,1891.7762631015,2087.92318348224,3,13
"912342489",29,2310.12766456613,2357.79423966008,13,16
"912342490",47,1936.32316494478,2602.36394728806,14,33
"912342491",31,2252.20015465238,2390.15469389133,8,23
"912342492",40,2496.61147553811,2517.98110851286,12,28
"912342493",29,2236.66317561988,2357.79423966008,15,14
"912342494",44,2399.90746907102,2567.51523707907,18,26
"912342506",67,3176.11731019742,2797.95380131742,20,47
"912342515",6,1647.16299119034,1708.62817714657,0,6
"912342519",29,1878.9092484964,2357.79423966008,3,26
"912342523",14,1951.48387527372,2031.70713799962,2,12
"912342524",12,1851.31649109824,1968.69006049611,2,10
"912342525",14,1836.88264038538,2031.70713799962,3,11
"912342526",11,1818.69018442012,1933.98659929558,1,10
"912342527",12,1707.49846315821,1968.69006049611,3,9
"912342528",13,1818.72870605631,2001.16379457045,1,12
"912342529",10,1852.61870277094,1896.67490607898,1,9
"912342530",10,1713.88257114385,1896.67490607898,3,7
"912342531",14,1891.01708398895,2031.70713799962,4,10
"912342532",24,1919.57406853183,2268.33468283819,8,16
"912342533",14,1845.82697196152,2031.70713799962,4,10
"912342534",17,1775.69508583527,2113.95669457394,6,11
"912342535",14,1757.45798106608,2031.70713799962,4,10
"912342536",8,1686.76754508992,1812.11073017574,1,7
"912342537",11,1807.81757753212,1933.98659929558,0,11
"912342538",6,1585.2170995005,1708.62817714657,1,5
"912342539",6,1620.26504962772,1708.62817714657,2,4
"912342540",11,1888.34060331439,1933.98659929558,1,10
"912342541",10,1751.0272576434,1896.67490607898,1,9
"912342542",10,1760.26437086885,1896.67490607898,3,7
"912342543",9,1637.5897091898,1856.26587460569,2,7
"912342544",13,1899.24202893476,2001.16379457045,2,11
"912342545",10,1765.94491193936,1896.67490607898,1,9
"912342546",12,1773.91626540608,1968.69006049611,2,10
"912342547",16,1884.80283916789,2087.92318348224,3,13
"912342548",22,2014.14917229043,2228.3491786518,3,19
"912342549",10,1709.78094651644,1896.67490607898,2,8
"912342550",14,1720.2801574116,2031.70713799962,2,12
"912342551",14,1739.8366297294,2031.70713799962,3,11
"912342552",9,1706.95733809973,1856.26587460569,2,7
"912342553",10,1744.95939419527,1896.67490607898,2,8
"912342554",14,1768.54953625384,2031.70713799962,3,11
"912342555",13,1836.82778334119,2001.16379457045,3,10
"912342556",12,1861.18315893631,1968.69006049611,1,11
"912342557",9,1674.70893003608,1856.26587460569,2,7
"912342558",14,1729.14593946272,2031.70713799962,3,11
"912342559",12,1812.09724474739,1968.69006049611,1,11
"912342560",20,1901.37779753691,2185.35845629437,4,16
"912342561",17,1881.92983878882,2113.95669457394,3,14
"912342562",20,1905.28039185808,2185.35845629437,4,16
"912342563",21,1818.81926535661,2207.26116887512,3,18
"912342564",9,1810.27418601448,1856.26587460569,1,8
"912342565",11,1803.02577540856,1933.98659929558,3,8
"912342566",12,1895.43223805098,1968.69006049611,2,10
"912342567",15,1845.52624537954,2060.56118614118,2,13
"912342568",19,1934.20503719272,2162.56636020013,2,17
"912342569",15,1911.50001434337,2060.56118614118,2,13
"912342570",16,1889.39125638463,2087.92318348224,2,14
"912342571",11,1863.02663964663,1933.98659929558,2,9
"912342572",13,1891.30367728308,2001.16379457045,2,11
"912342573",5,1585.05294235755,1646.12614877363,1,4
"912342574",13,1854.02048702713,2001.16379457045,2,11
"912342575",9,1729.36985506854,1856.26587460569,2,7
"912342576",12,1887.44113864219,1968.69006049611,2,10
"912342577",8,1726.8198468546,1812.11073017574,2,6
"912342578",9,1717.31513931031,1856.26587460569,2,7
"912342579",10,1656.58708870895,1896.67490607898,2,8
"912342581",9,1784.83300402065,1856.26587460569,2,7
"912342582",10,1711.34717631837,1896.67490607898,2,8
"912342583",15,1809.21565111201,2060.56118614118,2,13
"912342584",13,1812.55353484594,2001.16379457045,2,11
"912342585",17,1879.71696024842,2113.95669457394,3,14
"912342586",12,1770.95110635805,1968.69006049611,3,9
"912342587",14,1795.15163754975,2031.70713799962,2,12
"912342588",10,1685.68287588634,1896.67490607898,1,9
"912342589",12,1741.07290658066,1968.69006049611,3,9
"912342590",10,1681.67866088578,1896.67490607898,1,9
"912342591",12,1707.79396066172,1968.69006049611,1,11
"912342592",13,1677.84237620196,2001.16379457045,1,12
"912342593",12,1686.20813612354,1968.69006049611,3,9
"912342594",12,1674.65684401899,1968.69006049611,3,9
"912342595",18,1837.30897552705,2138.79896507223,4,14
"912342596",14,1816.76386892108,2031.70713799962,2,12
"912342597",14,1736.9680344934,2031.70713799962,2,12
"912342598",7,1600.32356454023,1763.32076508842,2,5
"912342599",7,1668.01857070674,1763.32076508842,2,5
"912342600",11,1794.05491642301,1933.98659929558,3,8
"912342601",7,1616.66130786931,1763.32076508842,2,5
"912342602",13,1863.36779691121,2001.16379457045,3,10
"912342604",6,1523.52371273226,1708.62817714657,0,6
"912342605",3,1371.19846475946,1482.92019466158,0,3
"912342606",2,1292.20239526938,1364.97646362037,0,2
"912342607",6,1532.21988524023,1708.62817714657,0,6
"912342608",7,1636.3611562762,1763.32076508842,0,7
"912342609",1,1163.18018429858,1184.66451052022,0,1
"912342610",3,1421.48546233202,1482.92019466158,0,3
"912342611",2,1317.90000378705,1364.97646362037,0,2
"912342612",5,1508.44642513268,1646.12614877363,1,4
"912342613",4,1441.40043447121,1572.73281143487,0,4
"912342614",2,1344.17434608905,1364.97646362037,1,1
"912342615",6,1493.31378840691,1708.62817714657,0,6
"912342616",3,1378.2817810895,1482.92019466158,0,3
"912342617",3,1378.2817810895,1482.92019466158,0,3
"912342618",2,1299.36117613236,1364.97646362037,0,2
"912342619",4,1427.17362901662,1572.73281143487,1,3
"912342620",7,1600.71723076945,1763.32076508842,1,6
"912342621",3,1398.46704240366,1482.92019466158,0,3
"912342622",4,1435.20162187902,1572.73281143487,1,3
"912342623",6,1500.46513435592,1708.62817714657,1,5
"912342624",4,1435.20162187902,1572.73281143487,1,3
"912342625",2,1296.88149172313,1364.97646362037,1,1
"912342626",3,1410.96086758528,1482.92019466158,0,3
"912342627",3,1411.8369411355,1482.92019466158,0,3
"912342628",3,1506.41259970584,1482.92019466158,1,2
"912342629",3,1375.65148559748,1482.92019466158,1,2
"912342630",2,1309.04308098029,1364.97646362037,0,2
"912342631",4,1558.12226371908,1572.73281143487,0,4
"912342632",4,1543.64651641515,1572.73281143487,0,4
"912342633",3,1398.46704240366,1482.92019466158,0,3
"912342634",3,1398.37280420125,1482.92019466158,1,2
"912342635",1,1164.93329481912,1184.66451052022,0,1
"912342636",2,1299.36117613236,1364.97646362037,0,2
"912342637",1,1164.93329481912,1184.66451052022,0,1
"912342638",5,1508.1305478442,1646.12614877363,2,3
"912342639",3,1421.03618234532,1482.92019466158,0,3
"912342640",1,1163.18018429858,1184.66451052022,0,1
"912342641",2,1308.5559367426,1364.97646362037,0,2
"912342642",1,1163.18018429858,1184.66451052022,0,1
"912342643",6,1481.64147083099,1708.62817714657,1,5
"912342644",10,1585.49135214038,1896.67490607898,1,9
"912342645",3,1386.18979973379,1482.92019466158,0,3
"912342646",6,1560.94288302361,1708.62817714657,1,5
"912342647",3,1388.55174551761,1482.92019466158,0,3
"912342648",6,1550.29769984887,1708.62817714657,1,5
"912342649",2,1311.01603171319,1364.97646362037,0,2
"912342650",4,1473.17651068573,1572.73281143487,1,3
"912342651",5,1475.24548603528,1646.12614877363,1,4
"912342652",3,1420.95120560654,1482.92019466158,0,3
"912342653",1,1163.18018429858,1184.66451052022,0,1
"912342654",6,1529.6786170377,1708.62817714657,2,4
"912342655",3,1376.16360791144,1482.92019466158,1,2
"912342656",3,1397.94662014163,1482.92019466158,0,3
"912342657",3,1398.46704240366,1482.92019466158,0,3
"912342658",4,1460.21081006343,1572.73281143487,0,4
"912342659",3,1467.04108472535,1482.92019466158,0,3
"912342660",1,1163.18018429858,1184.66451052022,0,1
"912342661",1,1164.93329481912,1184.66451052022,0,1
"912342662",4,1451.33240081987,1572.73281143487,0,4
"912342663",8,1544.90664202961,1812.11073017574,0,8
"912342664",1,1163.18018429858,1184.66451052022,0,1
"912342667",4,1443.48236804568,1572.73281143487,0,4
"912342668",5,1475.14653083238,1646.12614877363,0,5
"912342669",6,1496.8675107309,1708.62817714657,0,6
"912342670",7,1626.20541073211,1763.32076508842,0,7
"912342671",1,1163.18018429858,1184.66451052022,0,1
"912342672",2,1299.36117613236,1364.97646362037,0,2
"912342673",3,1410.96086758528,1482.92019466158,0,3
"912342674",1,1163.18018429858,1184.66451052022,0,1
"912342675",2,1317.90000378705,1364.97646362037,0,2
"912342676",2,1317.90000378705,1364.97646362037,0,2
"912342677",4,1434.66752929629,1572.73281143487,1,3
"912342678",2,1298.83611287102,1364.97646362037,1,1
"912342679",3,1391.91231504286,1482.92019466158,0,3
"912342680",2,1312.73729452909,1364.97646362037,0,2
"912342681",3,1411.8369411355,1482.92019466158,0,3
"912342682",6,1511.59528389064,1708.62817714657,0,6
"912342683",2,1302.44124535866,1364.97646362037,1,1
"912342684",1,1163.18018429858,1184.66451052022,0,1
"912342685",5,1619.54248532664,1646.12614877363,0,5
"912342686",7,1510.91058399752,1763.32076508842,1,6
"912342687",3,1398.46704240366,1482.92019466158,0,3
"912342688",4,1434.66752929629,1572.73281143487,1,3
"912342689",3,1388.12374275658,1482.92019466158,0,3
"912342690",5,1467.99029692763,1646.12614877363,1,4
"912342691",4,1424.58662704613,1572.73281143487,1,3
"912342692",4,1424.58662704613,1572.73281143487,1,3
"912342693",2,1299.36117613236,1364.97646362037,0,2
"912342694",2,1299.36117613236,1364.97646362037,0,2
"912342695",2,1308.5559367426,1364.97646362037,0,2
"912342696",3,1391.97670769364,1482.92019466158,0,3
"912342697",4,1467.91609672831,1572.73281143487,1,3
"912342698",5,1496.46144230582,1646.12614877363,0,5
"912342699",4,1442.1308611058,1572.73281143487,0,4
"912342700",3,1389.32027697716,1482.92019466158,1,2
"912342701",4,1471.95147369425,1572.73281143487,0,4
"912342702",3,1380.87296117015,1482.92019466158,0,3
"912342703",7,1506.93506069291,1763.32076508842,1,6
"912342704",9,1642.35719862841,1856.26587460569,0,9
"912342705",3,1424.72253076412,1482.92019466158,0,3
"912342706",3,1434.50771780513,1482.92019466158,0,3
"912342707",10,1669.87028435385,1896.67490607898,0,10
"912342708",5,1507.19105305892,1646.12614877363,1,4
"912342709",4,1454.07145536332,1572.73281143487,1,3
"912342710",7,1574.95505129602,1763.32076508842,2,5
"912342711",7,1566.97261679821,1763.32076508842,2,5
"912342712",7,1572.13541627987,1763.32076508842,2,5
"912342713",9,1650.51172557049,1856.26587460569,3,6
"912342714",7,1572.13541627987,1763.32076508842,2,5
"912342715",9,1603.268573922,1856.26587460569,2,7
"912342716",7,1548.16765979621,1763.32076508842,2,5
"912342717",6,1551.61177753892,1708.62817714657,1,5
"912342718",9,1609.96789855734,1856.26587460569,1,8
"912342719",4,1474.29020834376,1572.73281143487,1,3
"912342720",7,1530.00139899317,1763.32076508842,2,5
"912342721",9,1664.99644191013,1856.26587460569,2,7
"912342722",8,1576.8227379754,1812.11073017574,2,6
"912342723",7,1591.93914846934,1763.32076508842,1,6
"912342724",9,1665.92364447053,1856.26587460569,1,8
"912342725",8,1653.85134883573,1812.11073017574,0,8
"912342726",18,1655.23816269851,2138.79896507223,3,15
"912342727",4,1498.51174748452,1572.73281143487,0,4
"912342728",8,1618.63510388428,1812.11073017574,0,8
"912342729",16,1639.95746628766,2087.92318348224,3,13
"912342730",11,1642.42767424238,1933.98659929558,1,10
"912342731",16,1662.47817198564,2087.92318348224,1,15
"912342732",14,1687.61631493267,2031.70713799962,1,13
"912342733",17,1623.43077458516,2113.95669457394,1,16
"912342734",15,1675.03354051604,2060.56118614118,1,14
"912342735",18,1702.66075168451,2138.79896507223,1,17
"912342736",13,1714.29001185122,2001.16379457045,2,11
"912342737",17,1686.18646586858,2113.95669457394,3,14
"912342738",19,1692.54123341764,2162.56636020013,2,17
"912342739",14,1694.93153032323,2031.70713799962,2,12
"912342740",19,1737.9886970181,2162.56636020013,2,17
"912342741",14,1745.0370083405,2031.70713799962,3,11
"912342742",16,1696.38931436309,2087.92318348224,4,12
"912342743",12,1684.56817422404,1968.69006049611,2,10
"912342744",18,1670.90802405255,2138.79896507223,3,15
"912342745",12,1630.88914798423,1968.69006049611,1,11
"912342746",12,1674.93355141371,1968.69006049611,2,10
"912342747",16,1664.09602452131,2087.92318348224,2,14
"912342748",16,1664.15175329998,2087.92318348224,1,15
"912342751",16,1665.8972445288,2087.92318348224,2,14
"912342752",16,1620.93648271318,2087.92318348224,2,14
"912342753",25,1541.86342781881,2287.34065519221,2,23
"912342754",14,1699.93459360016,2031.70713799962,2,12
"912342755",17,1630.49313498941,2113.95669457394,1,16
"912342756",8,1621.49211331083,1812.11073017574,1,7
"912342757",15,1664.51988519037,2060.56118614118,2,13
"912342758",16,1648.61650651194,2087.92318348224,2,14
"912342759",16,1556.06760784022,2087.92318348224,4,12
"912342760",18,1639.36804171915,2138.79896507223,4,14
"912342761",9,1611.9781057386,1856.26587460569,2,7
"912342762",11,1646.53082896485,1933.98659929558,3,8
"912342763",13,1652.68630862783,2001.16379457045,1,12
"912342764",9,1607.8912654206,1856.26587460569,2,7
"912342765",12,1716.47465828888,1968.69006049611,2,10
"912342767",7,1579.90950465341,1763.32076508842,1,6
"912342768",10,1627.22913711633,1896.67490607898,2,8
"912342769",13,1622.87137136451,2001.16379457045,2,11
"912342770",12,1618.43907647987,1968.69006049611,3,9
"912342771",4,1468.3394883492,1572.73281143487,0,4
"912342772",10,1678.92113154578,1896.67490607898,1,9
"912342773",8,1576.92347437567,1812.11073017574,3,5
"912342774",8,1643.36171207838,1812.11073017574,0,8
"912342775",5,1544.76904914685,1646.12614877363,0,5
"912342776",10,1588.64445228441,1896.67490607898,1,9
"912342777",3,1423.75648366107,1482.92019466158,0,3
"912342778",20,1716.32275023127,2185.35845629437,1,19
"912342779",9,1620.80887444277,1856.26587460569,1,8
"912342780",18,1636.61240402116,2138.79896507223,1,17
"912342781",8,1604.28578981537,1812.11073017574,0,8
"912342782",9,1700.35622310773,1856.26587460569,0,9
"912342783",7,1636.26542963616,1763.32076508842,0,7
"912342784",15,1621.8162762039,2060.56118614118,1,14
"912342785",9,1597.51812820321,1856.26587460569,1,8
"912342788",13,1674.8328869021,2001.16379457045,2,11
"912342789",16,1654.84620585937,2087.92318348224,2,14
"912342790",22,1565.62343209623,2228.3491786518,3,19
"912342792",9,1608.95019491362,1856.26587460569,1,8
"912342793",13,1704.3072117476,2001.16379457045,1,12
"912342794",7,1587.09951419924,1763.32076508842,1,6
"912342795",10,1617.51629748013,1896.67490607898,2,8
"912342796",7,1579.60828287975,1763.32076508842,1,6
"912342797",9,1629.39658933428,1856.26587460569,0,9
"912342798",5,1543.51246392521,1646.12614877363,0,5
"912342799",2,1329.5677261165,1364.97646362037,0,2
"912342800",6,1538.52978999552,1708.62817714657,0,6
"912342801",5,1502.05888280404,1646.12614877363,0,5
"912342802",8,1611.90877496261,1812.11073017574,1,7
"912342803",12,1659.44409444445,1968.69006049611,1,11
"912342804",12,1631.22510918913,1968.69006049611,1,11
"912342805",7,1571.14557918543,1763.32076508842,1,6
"912342806",15,1732.04609207269,2060.56118614118,3,12
"912342807",13,1651.72095391782,2001.16379457045,1,12
"912342808",8,1589.19184698803,1812.11073017574,1,7
"912342809",12,1678.69757975921,1968.69006049611,1,11
"912342810",11,1653.97663098229,1933.98659929558,1,10
"912342811",12,1619.92911611466,1968.69006049611,1,11
"912342812",13,1654.2850398357,2001.16379457045,1,12
"912342813",11,1690.6628079888,1933.98659929558,2,9
"912342814",6,1557.68404779782,1708.62817714657,1,5
"912342815",2,1307.96437984173,1364.97646362037,0,2
"912342816",13,1616.7266790162,2001.16379457045,1,12
"912342817",10,1765.53053050528,1896.67490607898,3,7
"912342818",10,1712.2968137951,1896.67490607898,2,8
"912342819",11,1637.66614810787,1933.98659929558,1,10
"912342820",5,1545.62799414079,1646.12614877363,0,5
"912342821",7,1597.39759896449,1763.32076508842,1,6
"912342822",5,1519.09902761733,1646.12614877363,0,5
"912342823",5,1548.91644237097,1646.12614877363,0,5
"912342824",6,1576.08938759309,1708.62817714657,0,6
"912342825",12,1686.43687636401,1968.69006049611,1,11
"912342826",5,1530.01559067668,1646.12614877363,0,5
"912342827",11,1636.8815553231,1933.98659929558,0,11
"912342828",10,1634.86005338094,1896.67490607898,0,10
"912342829",5,1513.13414894377,1646.12614877363,0,5
"912342830",12,1623.52623163643,1968.69006049611,0,12
"912342831",10,1656.6007056053,1896.67490607898,0,10
"912342832",10,1671.02816360244,1896.67490607898,0,10
"912342833",2,1329.5677261165,1364.97646362037,0,2
"912342834",9,1664.265844776,1856.26587460569,0,9
"912342835",7,1635.93330981527,1763.32076508842,0,7
"912342836",12,1618.8434106922,1968.69006049611,1,11
"912342837",11,1575.84558232768,1933.98659929558,2,9
"912342838",14,1645.92236737505,2031.70713799962,1,13
"912342839",15,1609.42220985141,2060.56118614118,3,12
"912342840",13,1626.2213362934,2001.16379457045,1,12
"912342841",15,1682.76371093202,2060.56118614118,1,14
"912342842",16,1710.89705804428,2087.92318348224,2,14
"912342843",10,1634.40957135348,1896.67490607898,1,9
"912342844",17,1589.52043951462,2113.95669457394,3,14
"912342845",9,1631.61861958455,1856.26587460569,2,7
"912342846",13,1644.53712391975,2001.16379457045,3,10
"912342847",13,1613.12321099984,2001.16379457045,1,12
"912342848",17,1738.45936240052,2113.95669457394,4,13
"912342849",17,1668.60196529824,2113.95669457394,2,15
"912342850",4,1495.86092238106,1572.73281143487,1,3
"912342851",15,1642.70899824815,2060.56118614118,2,13
"912342852",13,1646.95569714432,2001.16379457045,1,12
"912342853",6,1527.5193564655,1708.62817714657,1,5
"912342854",21,1538.91346353091,2207.26116887512,2,19
"912342855",16,1560.45340481361,2087.92318348224,1,15
"912342856",7,1579.61562212576,1763.32076508842,2,5
"912342857",11,1620.00795631205,1933.98659929558,1,10
"912342858",10,1658.84319300622,1896.67490607898,2,8
"912342859",9,1628.59545132115,1856.26587460569,1,8
"912342860",8,1593.73979026237,1812.11073017574,1,7
"912342861",8,1596.92735392174,1812.11073017574,1,7
"912342862",12,1615.92039283854,1968.69006049611,1,11
"912342863",6,1543.93747725951,1708.62817714657,1,5
"912342864",10,1593.09201276208,1896.67490607898,1,9
"912342865",15,1714.61691980423,2060.56118614118,3,12
"912342866",7,1540.34578796589,1763.32076508842,2,5
"912342867",14,1639.23118693135,2031.70713799962,1,13
"912342868",9,1619.51268714665,1856.26587460569,1,8
"912342869",11,1685.32906353607,1933.98659929558,2,9
"912342870",15,1647.91644697723,2060.56118614118,2,13
"912342871",7,1549.85320753332,1763.32076508842,1,6
"912342872",12,1677.53292273307,1968.69006049611,2,10
"912342873",12,1694.24957711644,1968.69006049611,2,10
"912342874",11,1678.84965746495,1933.98659929558,1,10
"912342875",13,1702.01354752174,2001.16379457045,1,12
"912342876",17,1673.69070004821,2113.95669457394,1,16
"912342877",23,1661.11657955912,2248.68783741607,3,20
"912342878",8,1579.25080558573,1812.11073017574,1,7
"912342879",17,1669.13541872567,2113.95669457394,2,15
"912342880",18,1730.69134184211,2138.79896507223,2,16
"912342881",9,1633.15455471924,1856.26587460569,2,7
"912342882",17,1659.81222681256,2113.95669457394,1,16
"912342883",12,1683.20870508759,1968.69006049611,2,10
"912342884",16,1706.41917015871,2087.92318348224,2,14
"912342885",16,1716.87787736865,2087.92318348224,2,14
"912342886",14,1657.53018790248,2031.70713799962,2,12
"912342887",14,1615.32420528777,2031.70713799962,1,13
"912342888",13,1709.52739051473,2001.16379457045,2,11
"912342889",17,1652.46494244015,2113.95669457394,2,15
"912342890",17,1682.01418893326,2113.95669457394,2,15
"912342891",19,1718.45476270529,2162.56636020013,2,17
"912342892",14,1656.00641925061,2031.70713799962,2,12
"912342893",17,1702.47269532256,2113.95669457394,2,15
"912342894",16,1632.16922437867,2087.92318348224,2,14
"912342895",3,1405.39401978422,1482.92019466158,0,3
"912342896",1,1162.65434719398,1184.66451052022,0,1
"912342897",1,1164.35739673228,1184.66451052022,0,1
"912342898",10,1733.98401622444,1896.67490607898,1,9
"912342899",9,1650.12991117798,1856.26587460569,2,7
"912342900",7,1599.50996051327,1763.32076508842,1,6
"912342901",10,1657.06588551483,1896.67490607898,0,10
"912342902",10,1646.6342714419,1896.67490607898,0,10
"912342903",7,1640.43713232914,1763.32076508842,0,7
"912342904",10,1646.54278580153,1896.67490607898,0,10
"912342905",10,1658.1332511445,1896.67490607898,1,9
"912342906",19,1659.62718904852,2162.56636020013,2,17
"912342907",15,1648.20572175409,2060.56118614118,0,15
"912342908",19,1699.08146434594,2162.56636020013,4,15
"912342909",8,1611.18309011432,1812.11073017574,1,7
"912342910",16,1680.15517765899,2087.92318348224,3,13
"912342911",11,1608.89590723675,1933.98659929558,3,8
"912342912",6,1580.38182863122,1708.62817714657,2,4
"912342913",14,1597.49673424496,2031.70713799962,2,12
"912342914",8,1621.15807165424,1812.11073017574,1,7
"912342915",6,1525.93058853359,1708.62817714657,0,6
"912342916",26,1597.32744668639,2305.75108410937,4,22
"912342917",13,1654.22173429439,2001.16379457045,3,10
"912342918",19,1562.36185682953,2162.56636020013,3,16
"912342919",10,1607.8926794008,1896.67490607898,2,8
"912342920",15,1600.40939724742,2060.56118614118,2,13
"912342921",13,1639.37131023368,2001.16379457045,2,11
"912342922",10,1671.29712422637,1896.67490607898,1,9
"912342923",5,1562.10667448255,1646.12614877363,0,5
"912342924",11,1705.91169391095,1933.98659929558,0,11
"912342925",1,1162.65434719398,1184.66451052022,0,1
"912342926",7,1630.42008286775,1763.32076508842,0,7
"912342927",11,1712.68275460326,1933.98659929558,0,11
"912342928",7,1621.18424753523,1763.32076508842,0,7
"912342929",11,1692.6901933841,1933.98659929558,2,9
"912342930",10,1622.58961084505,1896.67490607898,1,9
"912342931",15,1675.65599542062,2060.56118614118,2,13
"912342932",14,1643.24317228676,2031.70713799962,2,12
"912342933",13,1639.65021333846,2001.16379457045,2,11
"912342934",15,1602.67308012354,2060.56118614118,1,14
"912342935",10,1617.14066966558,1896.67490607898,1,9
"912342936",12,1604.83742791186,1968.69006049611,1,11
"912342937",13,1661.56961824034,2001.16379457045,3,10
"912342938",12,1662.84595771006,1968.69006049611,1,11
"912342939",7,1573.5768215017,1763.32076508842,1,6
"912342940",14,1625.68011110469,2031.70713799962,1,13
"912342941",9,1673.08825828946,1856.26587460569,3,6
"912342942",6,1569.17769839136,1708.62817714657,0,6
"912342943",11,1526.06336313858,1933.98659929558,2,9
"912342944",9,1777.99876787184,1856.26587460569,2,7
"912342947",9,1785.82158415689,1856.26587460569,2,7
"912342948",9,1788.53940856904,1856.26587460569,1,8
"912342949",7,1692.53858435286,1763.32076508842,2,5
"912342950",10,1745.00524927658,1896.67490607898,2,8
"912342951",10,1771.43534966262,1896.67490607898,2,8
"912342953",7,1667.51417606086,1763.32076508842,1,6
"912342954",8,1689.00538778675,1812.11073017574,2,6
"912342955",7,1728.48355101715,1763.32076508842,2,5
"912342956",8,1641.09288482671,1812.11073017574,2,6
"912342957",8,1703.23767714188,1812.11073017574,3,5
"912342958",11,1762.14857664771,1933.98659929558,1,10
"912342960",9,1741.80160765483,1856.26587460569,2,7
"912342961",9,1758.34218916266,1856.26587460569,2,7
"912342973",32,1765.85482127817,2405.71569249515,6,26
"912342977",5,1546.75885546028,1646.12614877363,1,4
"912342999",17,1890.69046387771,2113.95669457394,3,14
"912343000",19,1949.74215225297,2162.56636020013,2,17
"912343025",6,1646.41672323002,1708.62817714657,2,4
"912343026",9,1757.68748431817,1856.26587460569,1,8
"912343028",7,1714.4470678174,1763.32076508842,2,5
"912343029",6,1700.24098387136,1708.62817714657,1,5
"912343050",31,1922.43267831362,2390.15469389133,5,26
"912343055",6,1670.28767831473,1708.62817714657,1,5
"912343056",5,1639.67142778817,1646.12614877363,1,4
"912343057",4,1591.64083574002,1572.73281143487,1,3
"912343058",6,1729.18889025462,1708.62817714657,1,5
"912343059",9,1655.15205716433,1856.26587460569,1,8
"912343060",8,1699.36110195579,1812.11073017574,1,7
"912343061",27,2292.16615797566,2323.60649590586,3,24
"912343063",9,1822.46155646882,1856.26587460569,1,8
"912343064",10,1766.30825759036,1896.67490607898,1,9
"912343065",12,1854.07198559463,1968.69006049611,2,10
"912343066",10,1764.07649497558,1896.67490607898,2,8
"912343073",13,1801.00323968898,2001.16379457045,2,11
"912343075",32,2136.93912771662,2405.71569249515,6,26
"912343076",22,2201.58806119882,2228.3491786518,3,19
"912343085",12,1871.10447495014,1968.69006049611,2,10
"912343088",32,2409.12750894873,2405.71569249515,14,18
"912343089",45,2879.85198088383,2579.33597919865,16,29
"912343090",52,2752.79808266982,2656.6981055205,19,33
"912343091",47,2760.44688771187,2602.36394728806,17,30
"912343092",50,3105.55108465338,2635.48551585152,18,32
"912343093",40,2781.77596151209,2517.98110851286,14,26
"912343095",36,2653.14354148414,2464.33502634194,11,25
"912343096",56,2927.41006536942,2697.24673169728,21,35
"912343097",40,2776.22771129547,2517.98110851286,15,25
"912343098",44,2537.16941630859,2567.51523707907,17,27
"912343099",40,2730.51560823345,2517.98110851286,18,22
"912343100",39,2584.95577603962,2504.98447234734,15,24
"912343101",42,2761.54599171678,2543.21752514954,18,24
"912343102",53,2722.64362845179,2667.061866114,16,37
"912343103",37,2283.24365629746,2478.17471526668,15,22
"912343104",29,2352.21237353394,2357.79423966008,10,19
"912343105",46,2567.25467699354,2590.94954296761,19,27
"912343106",43,2787.75236381855,2555.47878346624,18,25
"912343107",42,2653.677898337,2543.21752514954,17,25
"912343108",37,2558.8048614515,2478.17471526668,10,27
"912343109",39,2613.36012378864,2504.98447234734,16,23
"912343110",43,2805.10846209144,2555.47878346624,18,25
"912343111",49,2646.00051775443,2624.62502504328,20,29
"912343112",33,2264.22549588796,2420.89448855093,11,22
"912343113",29,2437.73991507833,2357.79423966008,6,23
"912343114",42,2569.79089432961,2543.21752514954,11,31
"912343115",39,2441.38609405607,2504.98447234734,16,23
"912343116",51,2633.89625538859,2646.17454577679,23,28
"912343117",29,2256.92521036306,2357.79423966008,12,17
"912343118",42,2594.96097326071,2543.21752514954,12,30
"912343119",40,2687.07411760099,2517.98110851286,13,27
"912343120",42,3045.20821049696,2543.21752514954,15,27
"912343121",46,2619.40633902087,2590.94954296761,18,28
"912343122",35,2443.049096115,2450.1860183293,12,23
"912343123",51,2927.99460496258,2646.17454577679,14,37
"912343124",63,3246.91212309185,2762.96971264875,25,38
"912343125",40,2625.8089187342,2517.98110851286,14,26
"912343126",35,2916.34963107274,2450.1860183293,14,21
"912343127",56,3271.55521788097,2697.24673169728,15,41
"912343128",63,2966.96270887997,2762.96971264875,20,43
"912343129",43,2604.76770698456,2555.47878346624,20,23
"912343130",35,2398.09573001402,2450.1860183293,14,21
"912343131",47,2889.97764108228,2602.36394728806,18,29
"912343132",52,3010.59797289691,2656.6981055205,20,32
"912343133",37,2620.44218312685,2478.17471526668,14,23
"912343134",27,2500.61701942375,2323.60649590586,8,19
"912343135",40,2770.31055224687,2517.98110851286,16,24
"912343136",35,2736.97711237333,2450.1860183293,16,19
"912343137",40,2975.08856151753,2517.98110851286,17,23
"912343138",33,2631.53744926627,2420.89448855093,16,17
"912343139",37,2369.94928922677,2478.17471526668,14,23
"912343140",38,2507.10322267455,2491.71993967651,16,22
"912343141",34,2608.67685210244,2435.71163614839,15,19
"912343142",49,3061.8011321377,2624.62502504328,20,29
"912343143",30,2596.35998038738,2374.18906024059,8,22
"912343144",39,2741.50252886698,2504.98447234734,13,26
"912343145",55,2752.25874217678,2687.33120998132,20,35
"912343146",43,2931.91381419301,2555.47878346624,18,25
"912343147",44,2797.42334435507,2567.51523707907,17,27
"912343148",56,2700.54940288875,2697.24673169728,19,37
"912343149",50,2722.68904392502,2635.48551585152,19,31
"912343150",50,2763.96051842517,2635.48551585152,22,28
"912343151",38,2610.3309514965,2491.71993967651,8,30
"912343152",39,2782.68554132396,2504.98447234734,15,24
"912343153",41,2602.26257890145,2530.72175773865,15,26
"912343154",57,2362.42525311412,2707.02236739438,17,40
"912343155",24,2405.95064105691,2268.33468283819,7,17
"912343156",33,2468.46060089061,2420.89448855093,12,21
"912343157",35,2477.92106316431,2450.1860183293,10,25
"912343158",47,2275.63626844932,2602.36394728806,15,32
"912343159",48,2810.34876596227,2613.58673801098,21,27
"912343160",34,2359.43868951273,2435.71163614839,11,23
"912343161",52,2679.60317490785,2656.6981055205,19,33
"912343162",35,2742.17507959727,2450.1860183293,8,27
"912343163",43,2605.13702499349,2555.47878346624,17,26
"912343164",56,2762.61088729,2697.24673169728,21,35
"912343165",39,2354.9387942288,2504.98447234734,12,27
"912343166",47,2728.82530232996,2602.36394728806,13,34
"912343167",43,2711.9095135311,2555.47878346624,14,29
"912343168",32,2486.54022582144,2405.71569249515,14,18
"912343169",42,2503.50467369089,2543.21752514954,14,28
"912343170",59,2741.95450243714,2726.17127719361,18,41
"912343171",47,2709.63479521621,2602.36394728806,17,30
"912343172",38,2957.73054831343,2491.71993967651,15,23
"912343173",53,2444.09899029391,2667.061866114,20,33
"912343174",42,2664.06172933301,2543.21752514954,12,30
"912343175",54,3111.36504854135,2677.2712016452,13,41
"912343176",56,2968.69427404231,2697.24673169728,19,37
"912343177",49,2829.07858721736,2624.62502504328,17,32
"912343178",52,3079.43022514319,2656.6981055205,22,30
"912343179",30,2494.43648707399,2374.18906024059,13,17
"912343180",63,2578.10056909475,2762.96971264875,17,46
"912343181",49,2731.07987964986,2624.62502504328,14,35
"912343182",53,2431.22549884335,2667.061866114,17,36
"912343183",49,2727.53479747206,2624.62502504328,14,35
"912343185",35,2461.04991053368,2450.1860183293,16,19
"912343186",38,2888.02091628626,2491.71993967651,12,26
"912343187",50,2920.78655463734,2635.48551585152,21,29
"912343188",53,2853.82814202788,2667.061866114,16,37
"912343189",47,2820.07668702544,2602.36394728806,13,34
"912343190",50,2586.07732888438,2635.48551585152,18,32
"912343191",41,2395.57343521164,2530.72175773865,13,28
"912343192",46,2524.3326205659,2590.94954296761,13,33
"912343193",28,2447.32491856958,2340.94327947849,12,16
"912343194",31,2278.99244525271,2390.15469389133,13,18
"912343195",43,3027.9485942403,2555.47878346624,18,25
"912343196",53,3025.79704558489,2667.061866114,24,29
"912343197",46,3165.85711571196,2590.94954296761,19,27
"912343198",46,2967.01427590107,2590.94954296761,15,31
"912343199",56,2808.6048213294,2697.24673169728,17,39
"912343200",50,2799.1735302606,2635.48551585152,15,35
"912343201",50,2629.823748619,2635.48551585152,14,36
"912343202",43,2616.37172820899,2555.47878346624,13,30
"912343203",40,2460.11216833157,2517.98110851286,16,24
"912343204",44,2733.67223106872,2567.51523707907,13,31
"912343205",43,2943.11452950353,2555.47878346624,16,27
"912343206",69,2937.42100126036,2814.82611826518,27,42
"912343207",55,2609.49484098591,2687.33120998132,20,35
"912343208",55,2114.17250972722,2687.33120998132,19,36
"912343209",58,2552.81491571933,2716.66249357165,22,36
"912343210",38,2740.07967596783,2491.71993967651,10,28
"912343211",53,2677.30788611062,2667.061866114,19,34
"912343212",52,3045.50357381827,2656.6981055205,20,32
"912343213",46,2777.22876665089,2590.94954296761,14,32
"912343214",39,2695.39499002802,2504.98447234734,11,28
"912343215",24,2186.90907739716,2268.33468283819,6,18
"912343216",42,2374.2110589774,2543.21752514954,11,31
"912343217",58,2788.49220698252,2716.66249357165,18,40
"912343218",41,2879.64686133436,2530.72175773865,12,29
"912343219",36,2813.93516481475,2464.33502634194,11,25
"912343220",41,2756.95534730995,2530.72175773865,14,27
"912343221",41,2571.68713564876,2530.72175773865,17,24
"912343222",42,2998.82999699192,2543.21752514954,14,28
"912343223",40,2625.64283781164,2517.98110851286,13,27
"912343224",48,2717.13871310594,2613.58673801098,15,33
"912343225",55,3073.35075625656,2687.33120998132,22,33
"912343226",53,3149.92804496952,2667.061866114,15,38
"912343227",49,2504.3204821322,2624.62502504328,18,31
"912343228",56,2442.99338434309,2697.24673169728,18,38
"912343229",74,2661.5632103894,2855.36548874306,30,44
"912343230",55,3018.71753916046,2687.33120998132,22,33
"912343231",63,3092.37140916884,2762.96971264875,25,38
"912343232",61,3151.57603061851,2744.81051624266,24,37
"912343233",53,2850.17783207728,2667.061866114,22,31
"912343234",70,3127.35968303536,2823.11677003184,29,41
"912343235",60,3011.81644764345,2735.5526890818,25,35
"912343236",44,2538.60982283909,2567.51523707907,19,25
"912343238",27,2237.9985955479,2323.60649590586,10,17
"912343239",30,2137.51400284424,2374.18906024059,11,19
"912343240",41,2471.14072241833,2530.72175773865,17,24
"912343241",44,2802.68527741099,2567.51523707907,18,26
"912343242",43,2458.87071637656,2555.47878346624,18,25
"912343243",20,2271.00665504091,2185.35845629437,7,13
"912343244",42,2577.0230731868,2543.21752514954,16,26
"912343245",58,2501.90732053258,2716.66249357165,23,35
"912343246",49,2480.70702643065,2624.62502504328,18,31
"912343247",59,2554.9169038595,2726.17127719361,20,39
"912343248",49,2732.29574127817,2624.62502504328,18,31
"912343249",52,2586.29121601183,2656.6981055205,18,34
"912343250",45,3092.46910279223,2579.33597919865,19,26
"912343251",56,3065.70635613466,2697.24673169728,24,32
"912343252",46,2988.51686746991,2590.94954296761,14,32
"912343253",54,2987.42933400099,2677.2712016452,17,37
"912343254",62,2760.50975334536,2753.94837323248,23,39
"912343255",58,2912.67639089607,2716.66249357165,22,36
"912343256",52,2695.97623927011,2656.6981055205,13,39
"912343257",43,2625.30776641901,2555.47878346624,16,27
"912343258",56,2749.54789591425,2697.24673169728,21,35
"912343259",38,2414.35454499206,2491.71993967651,14,24
"912343260",41,2644.90852829742,2530.72175773865,20,21
"912343261",61,2742.95729443231,2744.81051624266,23,38
"912343262",58,2873.01458315379,2716.66249357165,24,34
"912343263",52,2725.39281874782,2656.6981055205,19,33
"912343264",38,2630.40282455025,2491.71993967651,10,28
"912343265",44,2691.71113117239,2567.51523707907,16,28
"912343267",51,2331.73198035333,2646.17454577679,17,34
"912343268",44,2653.19803335241,2567.51523707907,10,34
"912343269",51,2827.47314735505,2646.17454577679,25,26
"912343270",44,2757.99713097134,2567.51523707907,16,28
"912343271",38,2235.94630916354,2491.71993967651,13,25
"912343272",40,2367.42168635068,2517.98110851286,15,25
"912343273",35,2581.36412591085,2450.1860183293,13,22
"912343274",44,2382.75844446606,2567.51523707907,17,27
"912343275",54,2476.20892630386,2677.2712016452,18,36
"912343276",60,2892.40936200035,2735.5526890818,21,39
"912343277",51,2763.67480585125,2646.17454577679,17,34
"912343278",43,2499.25841000665,2555.47878346624,19,24
"912343279",33,2607.88912500766,2420.89448855093,13,20
"912343280",42,2454.17218239419,2543.21752514954,21,21
"912343281",49,2893.32771737017,2624.62502504328,19,30
"912343282",42,2479.47358792261,2543.21752514954,16,26
"912343283",50,2550.87176824414,2635.48551585152,17,33
"912343284",48,2789.70932582957,2613.58673801098,20,28
"912343285",55,2851.8453987874,2687.33120998132,19,36
"912343286",59,2732.89547682451,2726.17127719361,19,40
"912343287",71,2922.86706800565,2831.31372136695,23,48
"912343288",33,2358.7493897184,2420.89448855093,11,22
"912343289",67,2755.55927116719,2797.95380131742,21,46
"912343290",29,2527.6173732988,2357.79423966008,7,22
"912343291",34,2285.29426136905,2435.71163614839,14,20
"912343292",58,3141.28386453924,2716.66249357165,16,42
"912343293",46,2545.3914948091,2590.94954296761,14,32
"912343294",57,2982.63273520858,2707.02236739438,19,38
"912343295",46,2630.28308650543,2590.94954296761,16,30
"912343296",50,2461.68713914677,2635.48551585152,19,31
"912343297",53,2578.90597188296,2667.061866114,22,31
"912343298",44,2833.75104150182,2567.51523707907,11,33
"912343299",52,2648.90434959101,2656.6981055205,14,38
"912343300",41,2589.62118408167,2530.72175773865,13,28
"912343301",59,2804.52842013371,2726.17127719361,17,42
"912343302",60,2512.94670892042,2735.5526890818,23,37
"912343303",43,2603.04217997689,2555.47878346624,14,29
"912343304",40,2728.68795860132,2517.98110851286,15,25
"912343305",60,2722.60660964462,2735.5526890818,17,43
"912343306",42,2688.54077309197,2543.21752514954,11,31
"912343307",47,2675.362696426,2602.36394728806,13,34
"912343308",56,2645.62661122416,2697.24673169728,19,37
"912343309",53,2825.48808775727,2667.061866114,17,36
"912343310",41,2594.29695956397,2530.72175773865,16,25
"912343311",41,2798.56449179108,2530.72175773865,18,23
"912343312",58,2939.27322479864,2716.66249357165,25,33
"912343313",62,2945.27341823632,2753.94837323248,23,39
"912343314",33,2754.72498672495,2420.89448855093,11,22
"912343315",27,2748.65763088007,2323.60649590586,6,21
"912343316",48,2335.23650918413,2613.58673801098,16,32
"912343317",44,2419.08222882255,2567.51523707907,11,33
"912343318",56,2878.16555226845,2697.24673169728,23,33
"912343319",57,2919.76712043267,2707.02236739438,23,34
"912343320",40,2519.52984621158,2517.98110851286,13,27
"912343321",51,2776.51870350726,2646.17454577679,19,32
"912343322",45,2529.94022856594,2579.33597919865,9,36
"912343323",36,2596.53015420262,2464.33502634194,8,28
"912343324",67,2361.31691388828,2797.95380131742,23,44
"912343325",50,2348.9009788585,2635.48551585152,12,38
"912343326",64,3023.366118881,2771.87783482774,23,41
"912343327",68,3032.44379468081,2806.43931339586,21,47
"912343328",55,2846.02080004633,2687.33120998132,18,37
"912343329",51,2868.08226362056,2646.17454577679,16,35
"912343330",56,3075.02673169672,2697.24673169728,19,37
"912343331",37,2551.62420181389,2478.17471526668,16,21
"912343332",51,2648.60509580942,2646.17454577679,15,36
"912343333",45,2704.54351307682,2579.33597919865,13,32
"912343334",51,2740.30826751979,2646.17454577679,16,35
"912343335",56,2772.9547442985,2697.24673169728,20,36
"912343336",52,2449.34098469328,2656.6981055205,16,36
"912343337",55,2343.17667399563,2687.33120998132,20,35
"912343338",49,2568.16611269897,2624.62502504328,19,30
"912343339",61,2524.55842807938,2744.81051624266,19,42
"912343340",70,3042.9613004362,2823.11677003184,24,46
"912343341",60,2663.89289417016,2735.5526890818,21,39
"912343342",60,2449.1309339992,2735.5526890818,23,37
"912343343",53,2679.35109727136,2667.061866114,25,28
"912343344",52,2614.17787798565,2656.6981055205,19,33
"912343345",57,2516.85184814368,2707.02236739438,19,38
"912343346",64,2660.88181688381,2771.87783482774,21,43
"912343347",56,2358.34802229332,2697.24673169728,23,33
"912343348",75,2818.9039196283,2863.21031780169,27,48
"912343349",59,2717.60988965901,2726.17127719361,21,38
"912343350",70,2763.89919962612,2823.11677003184,29,41
"912343351",74,2403.98427337812,2855.36548874306,27,47
"912343352",42,2243.63146883518,2543.21752514954,10,32
"912343353",28,2332.53447939122,2340.94327947849,10,18
"912343354",55,3105.56739211262,2687.33120998132,14,41
"912343355",38,2644.88206165442,2491.71993967651,9,29
"912343356",46,2741.65808030418,2590.94954296761,15,31
"912343357",48,3117.98931994802,2613.58673801098,14,34
"912343358",40,1930.52240582109,2517.98110851286,13,27
"912343359",40,1870.06497953912,2517.98110851286,14,26
"912343361",25,1899.13988125644,2287.34065519221,6,19
"912343363",20,1963.9460308263,2185.35845629437,1,19
"912343364",16,1928.25434373378,2087.92318348224,1,15
"912343366",11,1746.35665434102,1933.98659929558,1,10
"912343367",9,1793.83468215915,1856.26587460569,1,8
"912343370",13,1841.71269642301,2001.16379457045,0,13
"912343371",15,1857.16446016287,2060.56118614118,1,14
"912343372",11,1855.16731344243,1933.98659929558,1,10
"912343373",23,2043.80589298106,2248.68783741607,4,19
"912343374",19,1962.54179735635,2162.56636020013,1,18
"912343375",17,1889.85095964321,2113.95669457394,3,14
"912343376",13,1881.31056310561,2001.16379457045,1,12
"912343378",21,1901.58359767419,2207.26116887512,2,19
"912343379",21,1929.85097418783,2207.26116887512,4,17
"912343380",18,1849.00661305599,2138.79896507223,5,13
"912343381",17,1810.7226922361,2113.95669457394,3,14
"912343382",22,2031.16982966671,2228.3491786518,3,19
"912343383",19,1948.63040334577,2162.56636020013,3,16
"912343384",25,1885.05226658039,2287.34065519221,4,21
"912343385",17,2052.17641583762,2113.95669457394,2,15
"912343389",18,1971.07160146356,2138.79896507223,3,15
"912343390",4,1578.66879064673,1572.73281143487,1,3
"912343391",3,1412.63814391331,1482.92019466158,0,3
"912343392",5,1587.71773281963,1646.12614877363,1,4
"912343393",3,1452.43772794921,1482.92019466158,0,3
"912343394",7,1723.69238247194,1763.32076508842,2,5
"912343395",14,1880.83051587598,2031.70713799962,1,13
"912343399",16,1724.99314577061,2087.92318348224,4,12
"912343407",58,2701.5356855292,2716.66249357165,18,40
"912343408",50,2619.22311675381,2635.48551585152,19,31
"912343409",57,2876.13016857612,2707.02236739438,19,38
"912343410",55,2938.77727580041,2687.33120998132,19,36
"912343411",50,2538.27947736348,2635.48551585152,21,29
"912343412",49,2974.23975465294,2624.62502504328,14,35
"912343414",61,3078.17871397342,2744.81051624266,21,40
"912343415",53,2661.33076896099,2667.061866114,20,33
"912343416",57,3161.78374514377,2707.02236739438,18,39
"912343417",51,2746.71033104516,2646.17454577679,17,34
"912343418",48,3154.54547671034,2613.58673801098,19,29
"912343419",37,2372.32988635133,2478.17471526668,13,24
"912343420",32,2382.72119491727,2405.71569249515,9,23
"912343421",22,1975.93898047961,2228.3491786518,7,15
"912343422",40,2314.1809198915,2517.98110851286,12,28
"912343423",62,2905.98256028871,2753.94837323248,25,37
"912343424",51,3031.8118766553,2646.17454577679,15,36
"912343425",54,2654.39538069464,2677.2712016452,16,38
"912343426",40,2193.07515708789,2517.98110851286,15,25
"912343427",47,2623.643401481,2602.36394728806,11,36
"912343428",45,2546.16115318053,2579.33597919865,11,34
"912343429",52,2342.18056397851,2656.6981055205,15,37
"912343431",33,2313.6856651833,2420.89448855093,9,24
"912343432",38,2548.26540383557,2491.71993967651,13,25
"912343433",43,2341.76227124501,2555.47878346624,14,29
"912343434",49,2431.03457974696,2624.62502504328,17,32
"912343439",21,1998.54738913589,2207.26116887512,2,19
"912343444",18,1923.73181392916,2138.79896507223,2,16
"912343445",16,1814.64142747857,2087.92318348224,3,13
"912343448",13,1767.79484254951,2001.16379457045,2,11
"912343453",19,1921.38720494209,2162.56636020013,3,16
"912343457",14,1880.91719667109,2031.70713799962,3,11
"912343458",14,1777.01115947825,2031.70713799962,2,12
"912343461",21,1772.59399819162,2207.26116887512,4,17
"912343464",20,1932.32534328786,2185.35845629437,3,17
"912343469",23,2027.04787869978,2248.68783741607,1,22
"912343470",19,1949.26623515169,2162.56636020013,2,17
"912343473",22,1848.58302057755,2228.3491786518,2,20
"912343481",24,2040.96421914763,2268.33468283819,3,21
"912343484",16,1786.11307830333,2087.92318348224,5,11
"912343485",14,1906.99648491914,2031.70713799962,3,11
"912343486",21,1863.918699926,2207.26116887512,4,17
"912343487",25,1859.12627193136,2287.34065519221,5,20
"912343488",37,2285.41777719996,2478.17471526668,8,29
"912343489",61,2573.04821500335,2744.81051624266,15,46
"912343522",7,1689.8768842712,1763.32076508842,0,7
"912343534",14,1869.14612093302,2031.70713799962,3,11
"912343548",12,1868.08626977295,1968.69006049611,2,10
"912343549",17,1965.77090403618,2113.95669457394,2,15
"912343551",3,1447.9021784562,1482.92019466158,0,3
"912343552",6,1672.82141838193,1708.62817714657,0,6
"912343748",40,2657.85232053947,2517.98110851286,10,30
"912343749",51,2599.61455622066,2646.17454577679,13,38
"912343750",67,2673.91248166492,2797.95380131742,16,51
"912343751",47,2921.19134516292,2602.36394728806,9,38
"912343752",54,3057.64104213977,2677.2712016452,14,40
"912343753",56,3053.13697496147,2697.24673169728,17,39
"912343754",49,2827.73593430664,2624.62502504328,9,40
"912343756",74,2535.18226364567,2855.36548874306,21,53
"912343757",47,2642.27024624191,2602.36394728806,15,32
"912343758",63,3086.09247215062,2762.96971264875,16,47
"912343759",53,3053.87121131255,2667.061866114,13,40
"912343760",43,2760.49037158445,2555.47878346624,11,32
"912343761",42,2595.24159322077,2543.21752514954,13,29
"912343762",37,2620.51484762402,2478.17471526668,9,28
"912343763",82,3135.19090455086,2915.91045786314,25,57
"912343764",84,2557.37431559319,2930.30814451558,26,58
"912343765",78,2270.28864281518,2886.25582696583,25,53
"912343766",76,2819.49820252371,2870.97236507783,18,58
"912343767",68,3161.85047133616,2806.43931339586,27,41
"912343768",68,3301.95729791496,2806.43931339586,19,49
"912343769",57,2699.44278046755,2707.02236739438,18,39
"912343770",77,3094.12779528057,2878.65357631343,28,49
"912343771",80,2615.61753628182,2901.2306171403,18,62
"912343772",73,2991.97907317162,2847.4358582506,25,48
"912343773",63,3190.47422695107,2762.96971264875,21,42
"912343774",63,3258.44581204241,2762.96971264875,21,42
"912343775",73,3566.12155764353,2847.4358582506,22,51
"912343776",75,3152.19380938904,2863.21031780169,24,51
"912343777",73,3308.63706870214,2847.4358582506,20,53
"912343778",85,2286.28972996728,2937.40494579778,22,63
"912343779",39,2484.39916202452,2504.98447234734,14,25
"912343780",45,2787.97361919629,2579.33597919865,14,31
"912343781",42,2805.50183803081,2543.21752514954,10,32
"912343782",38,2852.94268504647,2491.71993967651,12,26
"912343783",35,2683.53569709755,2450.1860183293,10,25
"912343784",46,2393.74496759778,2590.94954296761,11,35
"912343785",44,2718.12984809104,2567.51523707907,12,32
"912343786",44,2712.0658689028,2567.51523707907,11,33
"912343787",38,2470.61159331247,2491.71993967651,13,25
"912343788",31,2521.0704770622,2390.15469389133,10,21
"912343789",47,2384.83213665274,2602.36394728806,11,36
"912343790",57,2382.21154907459,2707.02236739438,16,41
"912343791",58,2867.912010021,2716.66249357165,17,41
"912343792",57,2659.2601657745,2707.02236739438,23,34
"912343793",57,2603.64082190824,2707.02236739438,20,37
"912343794",61,2900.02243796906,2744.81051624266,17,44
"912343796",55,2802.96066202407,2687.33120998132,18,37
"912343797",57,3100.11497637267,2707.02236739438,16,41
"912343798",56,2838.65062024998,2697.24673169728,14,42
"912343799",54,2828.90939078478,2677.2712016452,21,33
"912343800",52,3244.05986782648,2656.6981055205,13,39
"912343801",67,2613.46771477203,2797.95380131742,26,41
"912343802",60,2949.90814871346,2735.5526890818,16,44
"912343803",65,3261.12591082331,2780.67589681985,18,47
"912343804",53,2543.85812233737,2667.061866114,15,38
"912343805",77,2577.71063339915,2878.65357631343,21,56
"912343806",45,2455.43444866623,2579.33597919865,20,25
"912343807",51,2767.84340680215,2646.17454577679,17,34
"912343808",55,2841.12966848139,2687.33120998132,15,40
"912343809",60,3385.09177999378,2735.5526890818,17,43
"912343810",63,3029.25021117832,2762.96971264875,18,45
"912343811",49,2736.91954362279,2624.62502504328,15,34
"912343812",66,2798.90276131182,2789.3669207067,19,47
"912343813",50,2653.6890702372,2635.48551585152,10,40
"912343814",28,2365.82293183851,2340.94327947849,6,22
"912343815",81,2962.56860369098,2908.60658576875,24,57
"912343816",83,2543.58892373337,2923.1438046077,27,56
"912343817",101,2843.29688056452,3042.80202352452,31,70
"912343818",68,2489.1862884013,2806.43931339586,20,48
"912343819",36,2431.45279919615,2464.33502634194,14,22
"912343820",8,1773.64401563916,1812.11073017574,1,7
"912343821",29,2203.11426558698,2357.79423966008,4,25
"912343823",25,2328.09836276065,2287.34065519221,6,19
"912343824",6,1789.968644101,1708.62817714657,2,4
"912343825",32,2129.20891239787,2405.71569249515,6,26
"912343826",39,2414.85418639778,2504.98447234734,8,31
"912343827",24,2101.72689473103,2268.33468283819,5,19
"912343828",9,1883.05491172377,1856.26587460569,2,7
"912343829",31,2361.55363224707,2390.15469389133,4,27
"912343830",24,2311.79527116739,2268.33468283819,6,18
"912343831",29,2242.5905398394,2357.79423966008,6,23
"912343843",29,2054.93399029705,2357.79423966008,7,22
"912343844",11,1781.96376830739,1933.98659929558,2,9
"912343845",24,1852.91684367524,2268.33468283819,6,18
"912343846",17,1923.24635902014,2113.95669457394,3,14
"912343847",20,2054.65513707461,2185.35845629437,3,17
"912343848",11,1830.31321051553,1933.98659929558,1,10
"912343849",21,1815.05472146546,2207.26116887512,6,15
"912343850",16,1831.3350536443,2087.92318348224,4,12
"912343851",20,1901.87242507235,2185.35845629437,4,16
"912343852",21,1895.35591279747,2207.26116887512,4,17
"912343853",12,1726.98770938573,1968.69006049611,3,9
"912343854",14,1685.7409920873,2031.70713799962,5,9
"912343855",23,2027.69568400579,2248.68783741607,4,19
"912343856",18,1836.06091249722,2138.79896507223,7,11
"912343857",29,2045.91456519522,2357.79423966008,4,25
"912343858",20,1858.33940500876,2185.35845629437,5,15
"912343859",33,1875.7303307842,2420.89448855093,9,24
"912343860",18,1839.57764027752,2138.79896507223,7,11
"912343861",24,1902.36048331866,2268.33468283819,4,20
"912343862",18,1872.80564001168,2138.79896507223,5,13
"912343863",19,1865.90169573392,2162.56636020013,3,16
"912343864",15,1913.11368224911,2060.56118614118,5,10
"912343865",17,1955.83306646944,2113.95669457394,4,13
"912343866",18,1914.55214665444,2138.79896507223,3,15
"912343867",12,1847.82934322255,1968.69006049611,2,10
"912343868",17,1882.43767561261,2113.95669457394,4,13
"912343869",20,1927.99218658793,2185.35845629437,6,14
"912343870",15,1807.79150762373,2060.56118614118,3,12
"912343871",16,1845.35894995158,2087.92318348224,4,12
"912343872",8,1674.25415457163,1812.11073017574,1,7
"912343873",5,1602.87208940249,1646.12614877363,1,4
"912343874",7,1613.93027964504,1763.32076508842,1,6
"912343875",11,1781.9852348124,1933.98659929558,3,8
"912343876",10,1729.56876002609,1896.67490607898,2,8
"912343877",7,1625.95038667089,1763.32076508842,1,6
"912343878",3,1471.15207791048,1482.92019466158,0,3
"912343879",8,1693.41256660001,1812.11073017574,3,5
"912343880",20,1796.664059027,2185.35845629437,5,15
"912343881",21,1933.21693948535,2207.26116887512,6,15
"912343882",19,1825.83625534661,2162.56636020013,4,15
"912343883",18,1872.92939786575,2138.79896507223,3,15
"912343884",17,1872.55692567979,2113.95669457394,3,14
"912343885",13,1771.10253079083,2001.16379457045,3,10
"912343886",18,1898.04640251044,2138.79896507223,4,14
"912343887",17,1843.86246678595,2113.95669457394,4,13
"912343888",20,1860.8395929765,2185.35845629437,3,17
"912343889",16,1865.5988660592,2087.92318348224,4,12
"912343890",16,1878.32271044637,2087.92318348224,4,12
"912343891",13,1858.81095514505,2001.16379457045,4,9
"912343892",18,1926.50022552215,2138.79896507223,4,14
"912343893",17,1919.0245628414,2113.95669457394,3,14
"912343894",14,1894.66615391642,2031.70713799962,4,10
"912343895",16,1891.99513488171,2087.92318348224,3,13
"912343896",19,1891.5544653095,2162.56636020013,3,16
"912343897",17,1889.26504436532,2113.95669457394,3,14
"912343898",20,1904.58194935251,2185.35845629437,5,15
"912343899",17,1896.23610259483,2113.95669457394,3,14
"912343900",14,1822.6241607714,2031.70713799962,3,11
"912343901",14,1824.26876711988,2031.70713799962,3,11
"912343902",17,1788.7084106312,2113.95669457394,3,14
"912343903",10,1744.89848662582,1896.67490607898,3,7
"912343904",12,1755.91934997867,1968.69006049611,2,10
"912343905",12,1799.87956139129,1968.69006049611,2,10
"912343906",20,1896.59155383084,2185.35845629437,4,16
"912343907",12,1762.11359877164,1968.69006049611,4,8
"912343908",10,1729.37126566763,1896.67490607898,2,8
"912343909",19,1883.67371687385,2162.56636020013,3,16
"912343910",17,1779.50300048038,2113.95669457394,3,14
"912343911",15,1798.26274160221,2060.56118614118,4,11
"912343912",16,1831.26306055939,2087.92318348224,2,14
"912343913",13,1868.38876085439,2001.16379457045,3,10
"912343914",13,1824.46131157856,2001.16379457045,4,9
"912343915",14,1806.96315828723,2031.70713799962,3,11
"912343934",17,2015.5772080415,2113.95669457394,3,14
"912343935",10,1839.59013426292,1896.67490607898,1,9
"912343936",12,2030.93743719618,1968.69006049611,3,9
"912343945",20,2009.3297364088,2185.35845629437,2,18
"912343956",9,1680.25074088091,1856.26587460569,1,8
"912344074",8,1607.71271768695,1812.11073017574,1,7
"912344075",4,1475.57606540489,1572.73281143487,0,4
"912344076",5,1490.90902255619,1646.12614877363,1,4
"912344085",9,1591.28876338584,1856.26587460569,1,8
"912344086",12,1632.32545926921,1968.69006049611,3,9
"912344087",10,1621.16693735516,1896.67490607898,0,10
"912344095",3,1398.46704240366,1482.92019466158,0,3
"912344099",8,1638.70531745718,1812.11073017574,0,8
"912344100",10,1643.73996678937,1896.67490607898,2,8
"912344101",13,1680.41952614208,2001.16379457045,3,10
"912344102",14,1574.79026803415,2031.70713799962,1,13
"912344103",8,1655.17768273118,1812.11073017574,2,6
"912344104",1,1150.67276488192,1184.66451052022,1,0
"912344106",1,1150.67276488192,1184.66451052022,1,0
"912344107",1,1168.07761147649,1184.66451052022,0,1
"912344108",3,1377.17718976313,1482.92019466158,1,2
"912344109",2,1310.95801905599,1364.97646362037,1,1
"912344110",12,1646.0702090724,1968.69006049611,2,10
"912344111",9,1630.07272271481,1856.26587460569,2,7
"912344112",8,1614.45551068786,1812.11073017574,1,7
"912344113",5,1533.40675714441,1646.12614877363,2,3
"912344114",9,1672.31837460676,1856.26587460569,2,7
"912344115",8,1655.00676084187,1812.11073017574,1,7
"912344116",11,1707.91355756274,1933.98659929558,3,8
"912344117",10,1735.57216870022,1896.67490607898,1,9
"912344118",10,1836.60736846985,1896.67490607898,2,8
"912344119",10,1897.10739218128,1896.67490607898,2,8
"912344120",10,1789.3203183806,1896.67490607898,2,8
"912344121",10,1836.2987776781,1896.67490607898,3,7
"912344122",11,1668.60722010163,1933.98659929558,2,9
"912344123",5,1554.23511163189,1646.12614877363,2,3
"912344124",10,1665.16562125903,1896.67490607898,1,9
"912344125",8,1628.33832355452,1812.11073017574,2,6
"912344126",9,1623.52141038176,1856.26587460569,1,8
"912344127",10,1819.79242894323,1896.67490607898,1,9
"912344128",9,1681.17707900758,1856.26587460569,2,7
"912344129",11,1744.25696336749,1933.98659929558,3,8
"912344130",14,1914.34327851659,2031.70713799962,1,13
"912344131",9,1743.1850702421,1856.26587460569,2,7
"912344132",8,1820.20807897428,1812.11073017574,2,6
"912344133",9,1758.02830494722,1856.26587460569,3,6
"912344134",2,1319.99049277353,1364.97646362037,1,1
"912344136",2,1310.95801905599,1364.97646362037,1,1
"912344138",1,1150.67276488192,1184.66451052022,1,0
"912344139",3,1382.12537714648,1482.92019466158,1,2
"912344140",22,1973.56686330151,2228.3491786518,5,17
"912344142",24,1879.90907758618,2268.33468283819,5,19
"912344143",24,1951.87131227068,2268.33468283819,8,16
"912344144",9,1679.03409111891,1856.26587460569,3,6
"912344145",19,1835.8970512269,2162.56636020013,4,15
"912344146",15,1806.30661569408,2060.56118614118,2,13
"912344147",15,1799.99856362799,2060.56118614118,3,12
"912344149",19,1857.04463000875,2162.56636020013,5,14
"912344150",7,1671.34530449318,1763.32076508842,2,5
"912344151",17,1850.20408812092,2113.95669457394,2,15
"912344152",13,1780.4840966259,2001.16379457045,3,10
"912344153",11,1815.59815787117,1933.98659929558,3,8
"912344154",10,1806.91782021274,1896.67490607898,5,5
"912344155",3,1482.43247679265,1482.92019466158,0,3
"912344156",1,1199.87616926906,1184.66451052022,0,1
"912344157",4,1541.93169217737,1572.73281143487,1,3
"912344158",5,1628.43730721309,1646.12614877363,3,2
"912344159",13,1888.73539885805,2001.16379457045,5,8
"912344160",12,1877.83687577147,1968.69006049611,5,7
"912344161",15,1837.94717100655,2060.56118614118,3,12
"912344162",12,1828.4123332121,1968.69006049611,4,8
"912344163",13,1819.84188048662,2001.16379457045,4,9
"912344164",36,2500.003062435,2464.33502634194,10,26
"912344165",42,2672.73558747452,2543.21752514954,8,34
"912344166",51,2499.13055525048,2646.17454577679,19,32
"912344168",48,2888.75442104299,2613.58673801098,18,30
"912344169",55,2964.53218378795,2687.33120998132,16,39
"912344170",43,3141.63423800487,2555.47878346624,10,33
"912344171",37,2773.88344164766,2478.17471526668,17,20
"912344172",37,3227.44279963782,2478.17471526668,13,24
"912344173",57,3125.45920342895,2707.02236739438,19,38
"912344174",52,3181.86288479035,2656.6981055205,24,28
"912344175",35,2669.42053220263,2450.1860183293,11,24
"912344176",33,2759.81841581187,2420.89448855093,9,24
"912344177",40,2306.69246780916,2517.98110851286,14,26
"912344178",42,2406.38528639042,2543.21752514954,14,28
"912344179",66,3342.72819610327,2789.3669207067,26,40
"912344180",55,2812.03207876189,2687.33120998132,21,34
"912344181",55,2952.52472229273,2687.33120998132,16,39
"912344182",60,2632.55809219616,2735.5526890818,24,36
"912344183",53,2796.25984704403,2667.061866114,18,35
"912344184",63,3388.90804989151,2762.96971264875,22,41
"912344185",56,2686.41375823568,2697.24673169728,17,39
"912344186",65,2542.16126870778,2780.67589681985,16,49
"912344187",52,3030.08428412823,2656.6981055205,14,38
"912344188",40,2758.84796387496,2517.98110851286,12,28
"912344189",62,3039.62663022593,2753.94837323248,24,38
"912344190",59,2695.64119100874,2726.17127719361,20,39
"912344191",82,3145.29756039419,2915.91045786314,28,54
"912344192",51,2760.51101211544,2646.17454577679,18,33
"912344193",64,3140.07901479483,2771.87783482774,21,43
"912344194",46,2603.39592223344,2590.94954296761,17,29
"912344195",46,2881.43344482111,2590.94954296761,18,28
"912344196",61,3182.42960456199,2744.81051624266,21,40
"912344197",69,2845.13153953291,2814.82611826518,25,44
"912344199",51,2933.17235065457,2646.17454577679,19,32
"912344200",54,2839.52456782352,2677.2712016452,19,35
"912344201",63,2862.68151244775,2762.96971264875,20,43
"912344202",56,2768.6249554307,2697.24673169728,17,39
"912344203",49,2900.29812322108,2624.62502504328,16,33
"912344205",62,3518.72560155548,2753.94837323248,21,41
"912344206",57,3221.37405435302,2707.02236739438,17,40
"912344207",46,2725.17750590297,2590.94954296761,14,32
"912344208",40,2740.50525149434,2517.98110851286,14,26
"912344209",44,2766.06187901292,2567.51523707907,17,27
"912344210",56,2682.97773453982,2697.24673169728,16,40
"912344211",47,2988.03776828721,2602.36394728806,15,32
"912344212",65,3370.68711627388,2780.67589681985,26,39
"912344213",61,3728.3763945473,2744.81051624266,21,40
"912344214",68,3641.91583409655,2806.43931339586,22,46
"912344215",73,3322.49720730998,2847.4358582506,27,46
"912344216",68,3306.87311545296,2806.43931339586,20,48
"912344217",56,3092.22557849433,2697.24673169728,20,36
"912344218",52,3033.68473761256,2656.6981055205,14,38
"912344219",48,3081.71490287133,2613.58673801098,18,30
"912344220",46,2872.10082874828,2590.94954296761,15,31
"912344221",54,3089.336623233,2677.2712016452,18,36
"912344222",55,2991.62601480541,2687.33120998132,13,42
"912344223",45,2751.05995366197,2579.33597919865,16,29
"912344224",52,2816.01505495752,2656.6981055205,18,34
"912344225",48,2949.98639446092,2613.58673801098,18,30
"912344226",56,2684.53780528799,2697.24673169728,24,32
"912344227",57,3319.17588540304,2707.02236739438,20,37
"912344228",77,3231.27487856823,2878.65357631343,29,48
"912344229",47,3003.01189487197,2602.36394728806,14,33
"912344230",58,3173.81631586501,2716.66249357165,19,39
"912344231",54,3437.42566922348,2677.2712016452,19,35
"912344232",56,3299.34970318177,2697.24673169728,23,33
"912344233",51,2817.14191010396,2646.17454577679,12,39
"912344234",63,3088.9461313884,2762.96971264875,21,42
"912344235",59,2621.81062426605,2726.17127719361,29,30
"912344236",49,2532.00888352759,2624.62502504328,22,27
"912344238",61,3387.42544258053,2744.81051624266,22,39
"912344239",61,3105.60499488413,2744.81051624266,21,40
"912344240",56,3088.62647332949,2697.24673169728,17,39
"912344241",69,3601.33826666947,2814.82611826518,30,39
"912344242",66,2746.46641968286,2789.3669207067,22,44
"912344243",58,2988.59007336147,2716.66249357165,20,38
"912344244",75,2779.16310753242,2863.21031780169,23,52
"912344245",55,3156.04553136663,2687.33120998132,18,37
"912344246",66,3557.87067692811,2789.3669207067,22,44
"912344247",51,3133.84484230792,2646.17454577679,15,36
"912344248",43,2942.23964205024,2555.47878346624,14,29
"912344249",45,2429.76897853031,2579.33597919865,10,35
"912344250",36,2580.49759827917,2464.33502634194,12,24
"912344251",43,2554.42933677769,2555.47878346624,15,28
"912344252",39,2758.09133084796,2504.98447234734,16,23
"912344253",45,2788.01169507466,2579.33597919865,16,29
"912344254",44,2789.89286472644,2567.51523707907,15,29
"912344255",45,2618.99780353354,2579.33597919865,11,34
"912344256",39,2128.60745420961,2504.98447234734,10,29
"912344257",40,2500.28089351407,2517.98110851286,10,30
"912344258",48,2431.26309244969,2613.58673801098,14,34
"912344259",40,2459.26188237724,2517.98110851286,13,27
"912344260",57,2934.21695141447,2707.02236739438,20,37
"912344261",44,2664.73300513882,2567.51523707907,14,30
"912344262",56,2836.81978812218,2697.24673169728,17,39
"912344263",70,3103.13578210151,2823.11677003184,24,46
"912344264",49,2789.65553214361,2624.62502504328,16,33
"912344265",46,2921.37614121148,2590.94954296761,19,27
"912344266",62,2960.61584357976,2753.94837323248,21,41
"912344267",66,3156.1274142271,2789.3669207067,24,42
"912344268",47,3099.84974138422,2602.36394728806,13,34
"912344269",11,1883.60579701239,1933.98659929558,0,11
"912344270",37,2344.54665873479,2478.17471526668,9,28
"912344271",31,2360.56212470963,2390.15469389133,8,23
"912344272",13,1971.44806574219,2001.16379457045,2,11
"912344273",37,2257.61661396688,2478.17471526668,7,30
"912344274",43,2479.80038327655,2555.47878346624,14,29
"912344275",28,2207.76518255226,2340.94327947849,7,21
"912344277",36,2537.51144408703,2464.33502634194,9,27
"912344278",20,1945.34560489317,2185.35845629437,6,14
"912344279",14,1789.33271605151,2031.70713799962,3,11
"912344280",6,1691.82915144165,1708.62817714657,2,4
"912344281",10,1819.86494704156,1896.67490607898,4,6
"912344282",23,2424.66765381926,2248.68783741607,6,17
"912344283",29,2118.24862449984,2357.79423966008,9,20
"912344284",29,2285.82558267193,2357.79423966008,10,19
"912344285",4,1537.42941526474,1572.73281143487,1,3
"912344286",27,2178.78781868397,2323.60649590586,5,22
"912344287",31,2315.65354731338,2390.15469389133,7,24
"912344288",42,2082.03194091773,2543.21752514954,11,31
"912344289",36,2050.08882804269,2464.33502634194,9,27
"912344290",43,2258.59066536116,2555.47878346624,12,31
"912344291",43,2116.06734392766,2555.47878346624,10,33
"912344292",34,1908.34114580932,2435.71163614839,9,25
"912344293",40,2369.80592482761,2517.98110851286,13,27
"912344294",34,2171.82097996129,2435.71163614839,10,24
"912344295",42,2256.57169965862,2543.21752514954,13,29
"912344296",55,2034.2145407618,2687.33120998132,14,41
"912344297",51,2277.43090882885,2646.17454577679,15,36
"912344298",48,2297.69320375999,2613.58673801098,14,34
"912344299",43,2152.0377861687,2555.47878346624,13,30
"912344300",36,2266.00818048819,2464.33502634194,10,26
"912344301",30,2175.52151671064,2374.18906024059,9,21
"912344304",55,2182.76570869523,2687.33120998132,18,37
"912344305",49,2104.2278943124,2624.62502504328,17,32
"912344306",40,2132.57712366109,2517.98110851286,14,26
"912344307",42,2263.7534373504,2543.21752514954,10,32
"912344308",34,2269.97917681757,2435.71163614839,11,23
"912344309",43,2280.78160878224,2555.47878346624,13,30
"912344310",31,2255.4509432048,2390.15469389133,7,24
"912344311",30,2350.94954632311,2374.18906024059,8,22
"912344312",43,2230.94898325639,2555.47878346624,12,31
"912344313",38,2216.99763872977,2491.71993967651,12,26
"912344314",31,2371.03581081828,2390.15469389133,7,24
"912344315",51,2050.92197636113,2646.17454577679,14,37
"912344316",72,2462.53436057631,2839.4193288992,21,51
"912344317",57,2489.94580505897,2707.02236739438,15,42
"912344318",39,2210.50213490776,2504.98447234734,10,29
"912344319",38,2264.75732484055,2491.71993967651,14,24
"912344320",55,2490.36159899725,2687.33120998132,15,40
"912344321",54,2342.19558524729,2677.2712016452,15,39
"912344322",41,2538.82102431273,2530.72175773865,11,30
"912344323",59,2603.84376013257,2726.17127719361,17,42
"912344324",55,2718.60456524282,2687.33120998132,17,38
"912344325",46,2665.97457411512,2590.94954296761,14,32
"912344326",41,2876.38268838298,2530.72175773865,13,28
"912344327",21,2142.75076485977,2207.26116887512,5,16
"912344328",63,2606.53054791577,2762.96971264875,20,43
"912344329",57,2616.66178909576,2707.02236739438,16,41
"912344330",36,2524.6872567732,2464.33502634194,11,25
"912344331",33,2529.47081462059,2420.89448855093,12,21
"912344332",36,2347.56254606034,2464.33502634194,5,31
"912344333",48,2521.12970430088,2613.58673801098,13,35
"912344334",45,2737.90700092331,2579.33597919865,14,31
"912344335",52,2442.01886528156,2656.6981055205,13,39
"912344336",52,2528.31582102527,2656.6981055205,10,42
"912344337",49,2345.53160372505,2624.62502504328,11,38
"912344338",59,2514.97509540037,2726.17127719361,17,42
"912344339",47,2802.48415332873,2602.36394728806,13,34
"912344340",77,2580.12002327414,2878.65357631343,17,60
"912344341",58,2829.55285236648,2716.66249357165,15,43
"912344342",48,2566.13251330744,2613.58673801098,14,34
"912344343",38,2651.59681888705,2491.71993967651,9,29
"912344344",64,2658.97565734298,2771.87783482774,19,45
"912344345",61,2741.30154216222,2744.81051624266,12,49
"912344346",58,2534.99604463845,2716.66249357165,13,45
"912344347",57,2628.97744993466,2707.02236739438,14,43
"912344348",33,2302.89302453764,2420.89448855093,7,26
"912344349",47,2564.21335006343,2602.36394728806,17,30
"912344350",51,2396.01334472728,2646.17454577679,10,41
"912344351",59,2415.28618579527,2726.17127719361,15,44
"912344352",45,2817.53062864218,2579.33597919865,12,33
"912344353",59,2746.49417972433,2726.17127719361,13,46
"912344354",27,2253.8319717309,2323.60649590586,9,18
"912344355",26,2152.7566824863,2305.75108410937,6,20
"912344356",26,2295.8754888774,2305.75108410937,10,16
"912344357",49,2547.30369839543,2624.62502504328,16,33
"912344358",65,2236.65945470267,2780.67589681985,15,50
"912344359",65,2576.34032193951,2780.67589681985,14,51
"912344360",67,2350.01144458271,2797.95380131742,18,49
"912344361",76,2069.48645379865,2870.97236507783,19,57
"912344362",31,2419.70944807647,2390.15469389133,9,22
"912344363",33,2531.73346963039,2420.89448855093,10,23
"912344364",51,2304.59911286856,2646.17454577679,15,36
"912344365",52,2287.39713584317,2656.6981055205,15,37
"912344366",54,2166.69461539037,2677.2712016452,15,39
"912344367",52,2026.43823640256,2656.6981055205,14,38
"912344368",41,2361.12177945991,2530.72175773865,11,30
"912344369",36,2202.78743266675,2464.33502634194,8,28
"912344370",35,1967.28942732132,2450.1860183293,10,25
"912344371",26,1984.79121388981,2305.75108410937,6,20
"912344372",29,2012.8806990438,2357.79423966008,9,20
"912344373",63,2870.81305498142,2762.96971264875,15,48
"912344374",62,2947.18378050822,2753.94837323248,22,40
"912344375",72,2784.77894700891,2839.4193288992,19,53
"912344376",74,3184.44339742484,2855.36548874306,22,52
"912344377",55,2750.22122279551,2687.33120998132,18,37
"912344378",47,2589.53034032254,2602.36394728806,14,33
"912344379",14,1883.15877034878,2031.70713799962,6,8
"912344380",4,1583.10480357965,1572.73281143487,2,2
"912344381",16,1855.46036234617,2087.92318348224,10,6
"912344382",23,2141.82234597883,2248.68783741607,11,12
"912344383",17,1901.06434857235,2113.95669457394,7,10
"912344384",20,1904.99311067658,2185.35845629437,7,13
"912344404",23,1913.4984759848,2248.68783741607,8,15
"912344406",12,1874.95516026757,1968.69006049611,4,8
"912344416",25,1904.98072315151,2287.34065519221,7,18
"912344426",14,1847.86337212527,2031.70713799962,4,10
"912344434",27,1876.30209814289,2323.60649590586,10,17
"912344437",18,1936.04175366466,2138.79896507223,6,12
"912344439",17,1963.98535004347,2113.95669457394,3,14
"912344440",30,2075.48451958354,2374.18906024059,5,25
"912344443",23,1817.72960628091,2248.68783741607,4,19
"912344446",29,2077.20803477457,2357.79423966008,6,23
"912344447",45,2230.44856411168,2579.33597919865,7,38
"912344452",40,1953.21963023287,2517.98110851286,7,33
"912344464",89,3249.0190854435,2965.14449011489,29,60
"912344467",109,3156.22078988562,3090.58221916578,35,74
"912344468",51,2541.31711335022,2646.17454577679,16,35
"912344469",43,2738.44612196094,2555.47878346624,16,27
"912344470",21,2161.91721281202,2207.26116887512,6,15
"912344471",96,2717.69462159954,3011.38790884243,19,77
"912344472",67,2427.34645829288,2797.95380131742,21,46
"912344473",86,2771.66546707861,2944.43562859908,26,60
"912344474",87,3516.83895227301,2951.40156710974,22,65
"912344475",87,3022.8772535946,2951.40156710974,20,67
"912344476",118,2825.63551381604,3141.10838648581,34,84
"912344477",103,2623.55111882223,3055.02181112984,27,76
"912344479",72,3021.96982874549,2839.4193288992,19,53
"912344480",96,2982.87859794267,3011.38790884243,30,66
"912344481",84,3074.09025933248,2930.30814451558,30,54
"912344482",119,2944.89224444889,3146.53110896604,35,84
"912344483",90,3109.64987852225,2971.92401064611,24,66
"912344484",86,2959.15045017961,2944.43562859908,20,66
"912344485",77,3222.80379567313,2878.65357631343,20,57
"912344486",101,3865.18259195727,3042.80202352452,31,70
"912344488",86,2784.58692008326,2944.43562859908,25,61
"912344489",78,2411.84790876654,2886.25582696583,22,56
"912344490",95,3235.63325519628,3004.94950458202,25,70
"912344491",76,2860.29611601774,2870.97236507783,23,53
"912344492",72,3275.04314039402,2839.4193288992,21,51
"912344493",92,3031.25818490619,2985.30521778333,26,66
"912344494",94,2888.40949550724,2998.45695239283,26,68
"912344495",68,3051.15009074703,2806.43931339586,23,45
"912344496",73,2566.52954587992,2847.4358582506,15,58
"912344497",96,2901.5728529609,3011.38790884243,24,72
"912344499",107,2705.75409603312,3078.90571391637,28,79
"912344500",56,2981.09289305403,2697.24673169728,11,45
"912344501",106,2786.7715469118,3073.00222293854,31,75
"912344502",92,3215.92136255311,2985.30521778333,25,67
"912344503",86,3273.95557105116,2944.43562859908,24,62
"912344504",57,1819.77207831099,2707.02236739438,19,38
"912344505",59,2000.34483728323,2726.17127719361,16,43
"912344506",90,2780.1481896666,2971.92401064611,27,63
"912344507",71,2576.50398289673,2831.31372136695,21,50
"912344508",82,3062.74900388226,2915.91045786314,18,64
"912344509",74,2948.75002336293,2855.36548874306,24,50
"912344511",88,3216.13811472694,2958.30409156145,24,64
"912344513",99,2511.13040755188,3030.38817685238,19,80
"912344514",123,2615.15116398421,3167.86598086922,29,94
"912344515",83,2974.45942630193,2923.1438046077,22,61
"912344516",76,3088.53641860324,2870.97236507783,19,57
"912344517",97,3685.59286229702,3017.77317381863,25,72
"912344519",71,2604.64925638221,2831.31372136695,21,50
"912344522",119,3199.47424998565,3146.53110896604,32,87
"912344524",103,3111.70949797709,3055.02181112984,25,78
"912344525",105,3675.06645155356,3067.05425459434,29,76
"912344526",102,3247.96916481451,3048.93574640007,31,71
"912344528",100,2709.5414763128,3036.61979185145,22,78
"912344529",61,2372.27214928107,2744.81051624266,21,40
"912344530",54,2428.88649287779,2677.2712016452,17,37
"912344531",36,2364.99777676542,2464.33502634194,8,28
"912344532",42,2591.23435308537,2543.21752514954,16,26
"912344533",51,2919.04886670745,2646.17454577679,18,33
"912344534",44,2410.8255490552,2567.51523707907,13,31
"912344535",58,2739.59580248121,2716.66249357165,25,33
"912344537",29,2331.31894742423,2357.79423966008,13,16
"912344538",49,2459.88602662176,2624.62502504328,19,30
"912344539",59,2575.10598885837,2726.17127719361,20,39
"912344540",54,2192.42742251958,2677.2712016452,19,35
"912344541",51,2263.54031797706,2646.17454577679,14,37
"912344542",32,2260.13697069249,2405.71569249515,12,20
"912344543",56,2628.6863775426,2697.24673169728,22,34
"912344544",51,3025.94920508139,2646.17454577679,26,25
"912344545",57,2833.16541872426,2707.02236739438,17,40
"912344546",62,2999.31128373393,2753.94837323248,25,37
"912344547",60,2530.43158224877,2735.5526890818,25,35
"912344548",52,2758.20564362462,2656.6981055205,22,30
"912344549",50,2990.04146391849,2635.48551585152,20,30
"912344550",34,2066.98352824615,2435.71163614839,10,24
"912344551",45,2224.4534431909,2579.33597919865,9,36
"912344552",21,1717.24937965535,2207.26116887512,3,18
"912344553",24,2201.72002447059,2268.33468283819,2,22
"912344554",19,1960.28718110011,2162.56636020013,5,14
"912344555",31,2270.5094965516,2390.15469389133,8,23
"912344556",25,2406.81271823373,2287.34065519221,5,20
"912344557",27,2393.26612570038,2323.60649590586,5,22
"912344558",26,2264.38268523708,2305.75108410937,2,24
"912344559",25,2230.75053167377,2287.34065519221,3,22
"912344560",24,1918.19062649456,2268.33468283819,5,19
"912344561",22,2005.85614168061,2228.3491786518,6,16
"912344562",23,2113.77432613436,2248.68783741607,4,19
"912344563",20,2004.93404279148,2185.35845629437,6,14
"912344564",20,1972.64539279189,2185.35845629437,4,16
"912344565",26,2029.9646947591,2305.75108410937,9,17
"912344566",22,2117.20178324353,2228.3491786518,4,18
"912344567",19,2011.6307761437,2162.56636020013,4,15
"912344568",28,2094.29698127819,2340.94327947849,5,23
"912344569",22,2036.6296176056,2228.3491786518,2,20
"912344570",27,2442.51270952546,2323.60649590586,1,26
"912344571",27,2204.99865305164,2323.60649590586,4,23
"912344572",31,2448.56907405194,2390.15469389133,6,25
"912344574",139,3044.46019197373,3248.04687922572,41,98
"912344576",70,2679.31410583709,2823.11677003184,26,44
"912344583",12,1801.77001906763,1968.69006049611,2,10
"912344584",15,1809.8876173465,2060.56118614118,3,12
"912344585",16,1744.47205718319,2087.92318348224,3,13
"912344586",17,1782.58879083287,2113.95669457394,2,15
"912344587",12,1855.73539590478,1968.69006049611,4,8
"912344588",20,1759.99870255992,2185.35845629437,4,16
"912344589",17,1761.43030085757,2113.95669457394,5,12
"912344590",11,1883.4289011011,1933.98659929558,2,9
"912344591",14,1752.69936815229,2031.70713799962,4,10
"912344592",19,1820.98711333515,2162.56636020013,4,15
"912344593",17,1869.35153877539,2113.95669457394,4,13
"912344594",17,1766.25089216714,2113.95669457394,3,14
"912344595",15,1682.46164820964,2060.56118614118,2,13
"912344596",14,1666.16085762572,2031.70713799962,2,12
"912344597",6,1588.95205145632,1708.62817714657,2,4
"912344598",11,1704.64232163625,1933.98659929558,2,9
"912344599",14,1733.14411319942,2031.70713799962,4,10
"912344600",14,1840.17560332323,2031.70713799962,2,12
"912344601",15,1797.1079029075,2060.56118614118,3,12
"912344602",13,1781.71720673829,2001.16379457045,3,10
"912344603",17,1697.96461703489,2113.95669457394,3,14
"912344604",11,1772.43085138947,1933.98659929558,4,7
"912344605",18,1777.50098823346,2138.79896507223,3,15
"912344606",16,1836.28836365593,2087.92318348224,2,14
"912344610",3,1457.98289787004,1482.92019466158,1,2
"912344611",5,1521.60107383745,1646.12614877363,2,3
"912344613",4,1519.07121919174,1572.73281143487,3,1
"912344615",2,1329.39960247251,1364.97646362037,1,1
"912344616",6,1553.72416597775,1708.62817714657,2,4
"912344618",1,1158.1580747686,1184.66451052022,1,0
"912344621",1,1158.1580747686,1184.66451052022,1,0
"912344623",4,1504.71716026846,1572.73281143487,0,4
"912344624",2,1312.20988091708,1364.97646362037,1,1
"912344625",1,1158.1580747686,1184.66451052022,1,0
"912344632",3,1429.79819096952,1482.92019466158,2,1
"912344633",2,1342.49914198821,1364.97646362037,1,1
"912344634",4,1511.18573615525,1572.73281143487,1,3
"912344635",6,1545.93022092129,1708.62817714657,3,3
"912344640",5,1611.87179758888,1646.12614877363,2,3
"912344641",2,1297.55089769445,1364.97646362037,0,2
"912344642",6,1673.21390374495,1708.62817714657,2,4
"912344655",13,1913.74854218314,2001.16379457045,2,11
"912344657",17,1874.29305523154,2113.95669457394,3,14
"912344658",16,1942.66099019397,2087.92318348224,2,14
"912344663",24,1899.39869050567,2268.33468283819,5,19
"912344664",21,1825.15810533909,2207.26116887512,4,17
"912344667",18,2018.82587887719,2138.79896507223,2,16
"912344668",20,1927.96907826437,2185.35845629437,2,18
"912344671",11,1893.49688920588,1933.98659929558,1,10
"912344672",10,1851.87012099739,1896.67490607898,0,10
"912344673",22,1872.69420458602,2228.3491786518,4,18
"912344674",15,1928.58658470079,2060.56118614118,1,14
"912344679",16,1972.8507790812,2087.92318348224,2,14
"912344680",16,1820.75216239258,2087.92318348224,1,15
"912344681",19,1902.11925535559,2162.56636020013,5,14
"912344682",13,1876.72324487451,2001.16379457045,2,11
"912344687",21,1886.61261494239,2207.26116887512,5,16
"912344688",17,1987.58180655124,2113.95669457394,4,13
"912344689",19,1904.44222598265,2162.56636020013,4,15
"912344695",18,1921.25452401542,2138.79896507223,3,15
"912344696",15,1865.48144500927,2060.56118614118,3,12
"912344703",13,1869.5709578778,2001.16379457045,2,11
"912344704",16,1882.54571530383,2087.92318348224,1,15
"912344711",9,1843.08168786857,1856.26587460569,1,8
"912344712",17,1898.39808812701,2113.95669457394,2,15
"912344713",19,1979.30215584151,2162.56636020013,2,17
"912344714",17,1857.93461012992,2113.95669457394,2,15
"912344715",24,1799.9322670999,2268.33468283819,5,19
"912344716",23,1894.06577577614,2248.68783741607,3,20
"912344717",17,1897.63178882253,2113.95669457394,3,14
"912344718",17,1830.84813107255,2113.95669457394,3,14
"912344719",13,1831.78060150834,2001.16379457045,3,10
"912344720",16,1902.55441490053,2087.92318348224,2,14
"912344721",18,1900.81038290468,2138.79896507223,4,14
"912344722",17,1800.93999359917,2113.95669457394,4,13
"912344723",3,1469.25216534244,1482.92019466158,0,3
"912344725",3,1398.46704240366,1482.92019466158,0,3
"912344726",24,2366.72696363028,2268.33468283819,7,17
"912344727",16,1968.83330825917,2087.92318348224,4,12
"912344728",18,2050.32416497367,2138.79896507223,6,12
"912344729",16,2033.7896827418,2087.92318348224,3,13
"912344730",12,1875.40847933994,1968.69006049611,3,9
"912344731",12,1947.85727518075,1968.69006049611,2,10
"912344732",25,2297.05005355518,2287.34065519221,6,19
"912344733",22,2074.49092551991,2228.3491786518,5,17
"912344734",15,2078.25578860144,2060.56118614118,5,10
"912344735",21,2248.28353264687,2207.26116887512,5,16
"912344736",12,1826.26353770938,1968.69006049611,4,8
"912344737",23,2166.97429035777,2248.68783741607,6,17
"912344738",19,2065.97268766183,2162.56636020013,4,15
"912344739",17,1990.76000424935,2113.95669457394,3,14
"912344740",24,2064.25775646745,2268.33468283819,6,18
"912344741",18,1970.20248400545,2138.79896507223,4,14
"912344742",20,2150.22218646739,2185.35845629437,6,14
"912344743",20,2209.7266205524,2185.35845629437,7,13
"912344744",25,2316.73369520804,2287.34065519221,6,19
"912344745",16,2172.14639275836,2087.92318348224,4,12
"912344746",20,2153.94708679211,2185.35845629437,5,15
"912344748",15,1963.91537597324,2060.56118614118,4,11
"912344750",12,2117.89004190371,1968.69006049611,2,10
"912344751",16,2088.87742864482,2087.92318348224,3,13
"912344752",22,2392.66035866143,2228.3491786518,7,15
"912344753",12,1910.38646332877,1968.69006049611,3,9
"912344754",21,2098.77282935737,2207.26116887512,4,17
"912344756",21,1960.10278825745,2207.26116887512,6,15
"912344757",18,2087.75495400236,2138.79896507223,3,15
"912344758",9,1886.70374650032,1856.26587460569,2,7
"912344759",12,1907.75607583027,1968.69006049611,1,11
"912344763",17,1885.8748820558,2113.95669457394,1,16
"912344766",17,1885.8748820558,2113.95669457394,1,16
"912344771",7,1680.63455849308,1763.32076508842,1,6
"912344772",15,1938.95518081636,2060.56118614118,4,11
"912344773",10,1925.16124660036,1896.67490607898,2,8
"912344794",24,2121.69915210045,2268.33468283819,3,21
"912344795",26,2075.63852597243,2305.75108410937,4,22
"912344796",19,2094.84694298117,2162.56636020013,3,16
"912344797",22,2037.3914002892,2228.3491786518,2,20
"912344798",15,1953.87193204079,2060.56118614118,3,12
"912344799",12,1900.59531676109,1968.69006049611,1,11
"912344800",11,1762.91986224636,1933.98659929558,2,9
"912344801",19,1976.97703156043,2162.56636020013,2,17
"912344802",20,2026.89146735451,2185.35845629437,5,15
"912344803",19,1943.42877601609,2162.56636020013,4,15
"912344804",27,2021.11603191825,2323.60649590586,6,21
"912344805",23,2076.94334454711,2248.68783741607,2,21
"912344808",24,2066.36005784485,2268.33468283819,1,23
"912344809",16,1926.64251546259,2087.92318348224,2,14
"912344811",20,2165.06235489314,2185.35845629437,4,16
"912344812",20,2053.06455874879,2185.35845629437,3,17
"912344813",17,2031.67440958762,2113.95669457394,2,15
"912344814",18,1908.40580985146,2138.79896507223,6,12
"912344815",15,1922.3379714188,2060.56118614118,3,12
"912344816",17,1942.4580188561,2113.95669457394,4,13
"912344817",19,1983.85213568741,2162.56636020013,4,15
"912344818",21,2061.43206891254,2207.26116887512,2,19
"912344819",22,2141.45161203686,2228.3491786518,5,17
"912344820",15,2129.84563001557,2060.56118614118,3,12
"912344821",22,2107.22593075377,2228.3491786518,6,16
"912344822",21,2158.35115965285,2207.26116887512,3,18
"912344823",16,1990.75780601277,2087.92318348224,1,15
"912344826",20,2153.85739310764,2185.35845629437,3,17
"912344827",18,1987.02366075047,2138.79896507223,1,17
"912344828",16,1966.98279264966,2087.92318348224,1,15
"912344829",20,1959.29063918142,2185.35845629437,4,16
"912344830",16,1888.44030278531,2087.92318348224,3,13
"912344831",17,1914.50342192577,2113.95669457394,4,13
"912344832",23,1874.07516054116,2248.68783741607,4,19
"912344835",23,1993.97623349264,2248.68783741607,4,19
"912344836",27,1976.01609426148,2323.60649590586,5,22
"912344838",22,2042.07117060607,2228.3491786518,5,17
"912344839",25,1894.71821256552,2287.34065519221,6,19
"912344840",23,1974.68920030534,2248.68783741607,6,17
"912344841",20,1914.00844381726,2185.35845629437,4,16
"912344842",18,1913.01687506158,2138.79896507223,4,14
"912344843",16,1869.52818734118,2087.92318348224,5,11
"912344844",12,1789.77054438435,1968.69006049611,3,9
"912344845",22,1861.13057118331,2228.3491786518,6,16
"912344846",22,1802.77302409283,2228.3491786518,6,16
"912344847",28,1973.01479484509,2340.94327947849,6,22
"912344848",24,1842.14147806179,2268.33468283819,6,18
"912344849",25,1876.41482600255,2287.34065519221,6,19
"912344851",16,1861.34171501311,2087.92318348224,3,13
"912344852",13,1938.09336123749,2001.16379457045,1,12
"912344853",24,1951.5037237841,2268.33468283819,5,19
"912344854",19,1957.48628715615,2162.56636020013,4,15
"912344855",26,1848.21998568708,2305.75108410937,6,20
"912344856",22,1856.14477177781,2228.3491786518,5,17
"912344857",21,1991.50373651173,2207.26116887512,3,18
"912344858",21,1950.4339942655,2207.26116887512,3,18
"912344859",18,1970.08059255046,2138.79896507223,4,14
"912344860",22,1993.35148913006,2228.3491786518,5,17
"912344861",20,1811.64255886175,2185.35845629437,6,14
"912344862",19,1886.99286700033,2162.56636020013,6,13
"912344863",19,1918.86210438572,2162.56636020013,5,14
"912344864",24,1889.27231462793,2268.33468283819,5,19
"912344865",19,1990.91243727261,2162.56636020013,3,16
"912344866",16,1880.30899310249,2087.92318348224,4,12
"912344867",18,1920.18312322236,2138.79896507223,4,14
"912344868",18,1977.36683515957,2138.79896507223,4,14
"912344889",42,2216.05071787797,2543.21752514954,18,24
"912344891",65,3044.9316889992,2780.67589681985,16,49
"912344892",46,2741.32572370325,2590.94954296761,14,32
"912344905",49,2975.09816274962,2624.62502504328,18,31
"912344906",52,2888.90378641606,2656.6981055205,15,37
"912344907",56,2751.51133518157,2697.24673169728,21,35
"912344913",37,2432.90790103445,2478.17471526668,10,27
"912344917",46,3073.34889850606,2590.94954296761,17,29
"912344920",39,2294.91223046719,2504.98447234734,14,25
"912344933",48,3042.30041610699,2613.58673801098,17,31
"912344939",35,2836.41065536949,2450.1860183293,6,29
"912344960",52,3175.90603415182,2656.6981055205,17,35
"912344970",82,3138.94336370821,2915.91045786314,25,57
"912344972",51,2764.45617122113,2646.17454577679,16,35
"912345003",6,1573.09427745459,1708.62817714657,2,4
"912345004",5,1526.1754038826,1646.12614877363,1,4
"912345005",4,1506.2659374016,1572.73281143487,1,3
"912345027",8,1720.40052991342,1812.11073017574,2,6
"912345033",23,2318.36256175185,2248.68783741607,6,17
"912345034",27,2365.36209993122,2323.60649590586,9,18
"912345035",23,2536.80150342274,2248.68783741607,9,14
"912345036",20,2407.67108851702,2185.35845629437,6,14
"912345037",31,2547.73698951345,2390.15469389133,10,21
"912345038",35,2539.88836857623,2450.1860183293,12,23
"912345041",15,1749.85010830874,2060.56118614118,2,13
"912345043",8,1573.82550277292,1812.11073017574,1,7
"912345044",19,1818.8222462227,2162.56636020013,5,14
"912345045",12,1740.23217220888,1968.69006049611,2,10
"912345046",7,1657.22221418631,1763.32076508842,2,5
"912345051",17,1834.71394281454,2113.95669457394,1,16
"912345073",9,1786.00022522722,1856.26587460569,3,6
"912345074",9,1826.04517173874,1856.26587460569,3,6
"912345080",8,1710.01468386461,1812.11073017574,3,5
"912345081",9,1830.79473376445,1856.26587460569,2,7
"912345082",9,1751.52480754401,1856.26587460569,2,7
"912345083",6,1649.96854874923,1708.62817714657,1,5
"912345084",7,1699.53342722344,1763.32076508842,2,5
"912345091",9,1744.33554118839,1856.26587460569,2,7
"912345092",10,1751.85024442588,1896.67490607898,3,7
"912345093",7,1668.23134976139,1763.32076508842,2,5
"912345094",11,1758.20845834364,1933.98659929558,2,9
"912345095",14,1686.25122208204,2031.70713799962,1,13
"912345096",14,1680.80123150303,2031.70713799962,2,12
"912345097",9,1720.59452710427,1856.26587460569,1,8
"912345098",6,1639.41403379284,1708.62817714657,1,5
"912345099",6,1712.91783101678,1708.62817714657,2,4
"912345100",8,1765.10479266041,1812.11073017574,2,6
"912345101",7,1662.38993155805,1763.32076508842,1,6
"912345102",12,1759.36405323632,1968.69006049611,1,11
"912345103",9,1725.52477577603,1856.26587460569,1,8
"912345104",8,1695.85535140601,1812.11073017574,1,7
"912345105",5,1637.68022633328,1646.12614877363,1,4
"912345106",5,1639.67142778817,1646.12614877363,1,4
"912345107",10,1758.21678017478,1896.67490607898,1,9
"912345108",12,1762.94992888529,1968.69006049611,1,11
"912345109",12,1787.46966342592,1968.69006049611,2,10
"912345110",7,1657.47881234254,1763.32076508842,1,6
"912345111",7,1675.17464918495,1763.32076508842,1,6
"912345112",5,1637.68022633328,1646.12614877363,1,4
"912345113",6,1653.8961533709,1708.62817714657,2,4
"912345114",5,1654.15582111192,1646.12614877363,2,3
"912345115",7,1768.26701377042,1763.32076508842,2,5
"912345116",11,1790.96340414969,1933.98659929558,3,8
"912345117",9,1720.58392318414,1856.26587460569,3,6
"912345118",7,1756.46334909791,1763.32076508842,3,4
"912345119",7,1740.64920360142,1763.32076508842,2,5
"912345120",6,1555.10351702639,1708.62817714657,1,5
"912345121",4,1492.7202302652,1572.73281143487,1,3
"912345122",1,1171.73368704246,1184.66451052022,0,1
"912345123",4,1493.71864291705,1572.73281143487,1,3
"912345124",3,1435.6619444338,1482.92019466158,1,2
"912345126",11,1663.85483836435,1933.98659929558,3,8
"912345273",14,1898.71091992223,2031.70713799962,6,8
"912345280",10,1804.81396869298,1896.67490607898,3,7
"912345281",14,1825.05744241718,2031.70713799962,3,11
"912345282",14,1658.26826576094,2031.70713799962,1,13
"912345283",9,1793.91813116892,1856.26587460569,2,7
"912345284",13,1858.41795954094,2001.16379457045,4,9
"912345286",10,1787.79636183271,1896.67490607898,3,7
"912345360",48,2827.60184455976,2613.58673801098,12,36
"912345361",51,2677.00182554028,2646.17454577679,13,38
"912345362",56,2590.95639600883,2697.24673169728,17,39
"912345363",51,2865.19830291665,2646.17454577679,15,36
"912345364",49,2886.59347281167,2624.62502504328,14,35
"912345365",54,2978.64827437763,2677.2712016452,12,42
"912345366",46,2997.13235830429,2590.94954296761,8,38
"912345367",58,3301.27755254388,2716.66249357165,18,40
"912345368",59,3244.71601581252,2726.17127719361,17,42
"912345369",61,2534.70838054689,2744.81051624266,6,55
"912345370",72,3094.93635340793,2839.4193288992,20,52
"912345371",68,3235.21532555202,2806.43931339586,19,49
"912345372",40,2860.93832788748,2517.98110851286,12,28
"912345373",34,2376.73687255988,2435.71163614839,11,23
"912345374",63,3098.8903737695,2762.96971264875,18,45
"912345375",58,2482.33795364761,2716.66249357165,14,44
"912345376",73,3357.62449703167,2847.4358582506,20,53
"912345377",66,3326.44499450481,2789.3669207067,17,49
"912345378",48,2595.56543017676,2613.58673801098,11,37
"912345379",41,2747.20690187032,2530.72175773865,10,31
"912345380",46,2720.38283647986,2590.94954296761,16,30
"912345381",66,3214.47260184654,2789.3669207067,20,46
"912345382",69,3170.57482409028,2814.82611826518,18,51
"912345383",90,3026.13886702616,2971.92401064611,23,67
"912345384",62,2835.15058545593,2753.94837323248,18,44
"912345385",60,2739.32808003191,2735.5526890818,16,44
"912345386",64,2835.03856627242,2771.87783482774,14,50
"912345387",71,2974.02679511696,2831.31372136695,17,54
"912345388",82,3649.79546730219,2915.91045786314,23,59
"912345389",69,3499.13851207277,2814.82611826518,18,51
"912345390",61,3159.33053325588,2744.81051624266,16,45
"912345393",25,2245.5209360701,2287.34065519221,8,17
"912345394",24,2139.10603712342,2268.33468283819,5,19
"912345395",21,2206.40908002648,2207.26116887512,5,16
"912345396",32,2414.86281135943,2405.71569249515,11,21
"912345397",49,3100.24119450889,2624.62502504328,17,32
"912345398",25,2224.63188808058,2287.34065519221,7,18
"912345399",51,2636.3792316865,2646.17454577679,15,36
"912345400",52,2828.77168874354,2656.6981055205,11,41
"912345401",61,2884.64971112426,2744.81051624266,18,43
"912345402",51,2640.14478218509,2646.17454577679,11,40
"912345403",46,2505.2543918515,2590.94954296761,11,35
"912345404",10,1927.69620860897,1896.67490607898,2,8
"912345405",17,2150.97258012583,2113.95669457394,4,13
"912345406",31,2125.26308041837,2390.15469389133,6,25
"912345407",40,2571.85649196839,2517.98110851286,9,31
"912345408",47,2577.14142368909,2602.36394728806,11,36
"912345409",46,2723.28918727563,2590.94954296761,12,34
"912345410",51,2919.26139234762,2646.17454577679,13,38
"912345411",63,3038.88160426831,2762.96971264875,18,45
"912345412",51,2716.09902121816,2646.17454577679,14,37
"912345413",51,2783.1301642423,2646.17454577679,14,37
"912345414",53,2558.85220451497,2667.061866114,16,37
"912345415",54,3028.79076516005,2677.2712016452,14,40
"912345416",48,2087.15325439142,2613.58673801098,9,39
"912345417",56,2506.18188253381,2697.24673169728,15,41
"912345418",45,2553.5798775948,2579.33597919865,12,33
"912345419",57,2424.66984116644,2707.02236739438,14,43
"912345420",64,2710.61738667297,2771.87783482774,19,45
"912345421",53,2595.97000079348,2667.061866114,13,40
"912345434",42,2720.13604159449,2543.21752514954,13,29
"912345435",28,2604.83536234846,2340.94327947849,8,20
"912345437",67,2861.94476802134,2797.95380131742,18,49
"912345440",63,2815.75030450335,2762.96971264875,24,39
"912345441",43,2682.63672158213,2555.47878346624,12,31
"912345442",65,2833.97334131215,2780.67589681985,21,44
"912345443",54,2887.091920666,2677.2712016452,24,30
"912345444",63,2983.89995215844,2762.96971264875,20,43
"912345445",73,3022.15485032152,2847.4358582506,21,52
"912345446",69,2994.78441790228,2814.82611826518,26,43
"912345447",59,2661.96659027552,2726.17127719361,18,41
"912345448",46,2783.74513972996,2590.94954296761,16,30
"912345449",60,2711.71399157841,2735.5526890818,20,40
"912345450",70,2850.62341244155,2823.11677003184,21,49
"912345451",80,2667.16632278208,2901.2306171403,31,49
"912345452",64,2776.40263053237,2771.87783482774,21,43
"912345453",67,2434.95593821165,2797.95380131742,23,44
"912345454",12,1857.90715268336,1968.69006049611,4,8
"912345455",10,1819.43206560852,1896.67490607898,3,7
"912345456",55,2837.71648773034,2687.33120998132,17,38
"912345457",56,3065.69954742985,2697.24673169728,12,44
"912345458",85,2832.20230782446,2937.40494579778,31,54
"912345459",92,2923.26611294983,2985.30521778333,35,57
"912345460",55,2810.42627698036,2687.33120998132,18,37
"912345461",60,3071.20531517827,2735.5526890818,24,36
"912345462",67,3037.24228202091,2797.95380131742,25,42
"912345463",47,2886.50241732946,2602.36394728806,12,35
"912345464",33,2532.26482989093,2420.89448855093,6,27
"912345466",42,2794.98041900281,2543.21752514954,15,27
"912345467",20,2032.39409289119,2185.35845629437,9,11
"912345468",22,2143.48131215266,2228.3491786518,8,14
"912345471",85,3271.30556325402,2937.40494579778,25,60
"912345472",39,2889.1792993742,2504.98447234734,11,28
"912345473",49,2695.23287888274,2624.62502504328,10,39
"912345474",52,3450.40507523362,2656.6981055205,15,37
"912345475",48,2951.98160655543,2613.58673801098,16,32
"912345476",61,3224.69380895524,2744.81051624266,18,43
"912345477",86,3369.56214272198,2944.43562859908,29,57
"912345478",29,2584.43500681922,2357.79423966008,5,24
"912345479",20,2072.48636548593,2185.35845629437,5,15
"912345481",39,2412.55655917356,2504.98447234734,9,30
"912345482",55,2499.9994460066,2687.33120998132,14,41
"912345483",50,2829.18697154244,2635.48551585152,16,34
"912345484",58,3165.85710228517,2716.66249357165,15,43
"912345485",60,2818.32488174987,2735.5526890818,17,43
"912345489",49,2479.40301899285,2624.62502504328,14,35
"912345490",61,2987.10351793039,2744.81051624266,20,41
"912345491",51,2816.58413677397,2646.17454577679,17,34
"912345492",59,2678.44082622457,2726.17127719361,18,41
"912345493",32,2180.92852194608,2405.71569249515,9,23
"912345494",49,2725.47715488357,2624.62502504328,17,32
"912345495",62,3216.65637320721,2753.94837323248,19,43
"912345496",79,3462.83315103943,2893.78092561085,30,49
"912345497",66,3548.02259692949,2789.3669207067,22,44
"912345498",61,2790.52291910846,2744.81051624266,22,39
"912345499",49,2542.01849625395,2624.62502504328,14,35
"912345500",87,3019.39371913987,2951.40156710974,31,56
"912345501",54,2544.04084639377,2677.2712016452,18,36
"912345502",69,2651.43571070814,2814.82611826518,27,42
"912345503",80,3975.27896635722,2901.2306171403,26,54
"912345504",66,3520.52422587049,2789.3669207067,22,44
"912345505",48,2602.50747496569,2613.58673801098,16,32
"912345506",55,2880.0723533142,2687.33120998132,13,42
"912345507",79,3436.06430470711,2893.78092561085,21,58
"912345508",73,3163.69590896385,2847.4358582506,19,54
"912345509",77,2611.74116325474,2878.65357631343,22,55
"912345510",59,2723.59294577997,2726.17127719361,18,41
"912345511",75,3231.41547301426,2863.21031780169,25,50
"912345512",70,2657.75102637446,2823.11677003184,26,44
"912345513",66,3047.12218948724,2789.3669207067,24,42
"912345514",66,2686.59772220929,2789.3669207067,21,45
"912345516",82,3828.91475267805,2915.91045786314,26,56
"912345517",85,2734.11855515636,2937.40494579778,30,55
"912345518",85,3673.96940855096,2937.40494579778,26,59
"912345519",73,3336.62483955688,2847.4358582506,26,47
"912345520",42,2859.88943524653,2543.21752514954,12,30
"912345521",52,2585.66292368702,2656.6981055205,14,38
"912345522",35,2465.69659168904,2450.1860183293,13,22
"912345523",67,2988.65663438039,2797.95380131742,19,48
"912345524",79,3393.55840665297,2893.78092561085,24,55
"912345525",65,3196.55402151423,2780.67589681985,16,49
"912345526",62,2713.9465414013,2753.94837323248,18,44
"912345527",62,3145.94134289791,2753.94837323248,18,44
"912345528",83,3661.72278803068,2923.1438046077,29,54
"912345531",55,2853.46228600378,2687.33120998132,10,45
"912345532",59,2773.08345317926,2726.17127719361,19,40
"912345533",66,3606.24771448783,2789.3669207067,20,46
"912345534",56,3218.83889855376,2697.24673169728,14,42
"912345535",67,2515.54003524067,2797.95380131742,24,43
"912345536",60,3530.48792156173,2735.5526890818,18,42
"912345537",78,3186.6215275241,2886.25582696583,27,51
"912345538",74,3139.34823403257,2855.36548874306,18,56
"912345547",8,1616.24611010267,1812.11073017574,2,6
"912345595",19,2035.42345611572,2162.56636020013,2,17
"912345596",8,1692.31062245629,1812.11073017574,0,8
"912345597",17,1905.2306502839,2113.95669457394,4,13
"912345598",13,1808.46221298468,2001.16379457045,3,10
"912345599",13,1999.11664078034,2001.16379457045,4,9
"912345600",14,1999.09200806117,2031.70713799962,4,10
"912345601",3,1444.99417681959,1482.92019466158,1,2
"912345602",7,1645.00681203309,1763.32076508842,3,4
"912345603",10,1650.31579292988,1896.67490607898,1,9
"912345604",13,1870.10223120354,2001.16379457045,4,9
"912345605",12,1829.50036279287,1968.69006049611,3,9
"912345606",14,1760.15835975982,2031.70713799962,5,9
"912345607",12,1772.99915175697,1968.69006049611,3,9
"912345608",14,1903.67450973282,2031.70713799962,4,10
"912345609",13,1882.42703418352,2001.16379457045,2,11
"912345610",17,2024.26962795595,2113.95669457394,2,15
"912345611",17,2100.66267469534,2113.95669457394,2,15
"912345612",8,1730.2187458111,1812.11073017574,2,6
"912345613",19,1895.32750159358,2162.56636020013,4,15
"912345614",11,1829.02310609068,1933.98659929558,2,9
"912345615",17,1836.62327929497,2113.95669457394,4,13
"912345616",12,1789.91778329817,1968.69006049611,2,10
"912345617",15,1979.90395282344,2060.56118614118,1,14
"912345618",16,1853.96470528865,2087.92318348224,4,12
"912345619",12,1906.5283740863,1968.69006049611,2,10
"912345621",3,1415.26525227375,1482.92019466158,1,2
"912345622",2,1317.30375788425,1364.97646362037,0,2
"912345623",2,1311.53488138081,1364.97646362037,0,2
"912345635",10,1666.76486424323,1896.67490607898,2,8
"912345636",14,1669.810033673,2031.70713799962,4,10
"912345637",17,1782.0157477878,2113.95669457394,5,12
"912345640",4,1572.01810552435,1572.73281143487,0,4
"912345641",4,1480.3159405387,1572.73281143487,2,2
"912345642",5,1559.29001433503,1646.12614877363,2,3
"912345643",8,1604.41227194899,1812.11073017574,2,6
"912345644",11,1789.73674511901,1933.98659929558,2,9
"912345645",7,1685.32217613563,1763.32076508842,2,5
"912345688",5,1615.33611413119,1646.12614877363,0,5
"912345698",18,1832.57271453859,2138.79896507223,3,15
"912345703",12,1634.32091339374,1968.69006049611,1,11
"912345704",11,1749.55775570536,1933.98659929558,0,11
"912345705",8,1610.24059334361,1812.11073017574,1,7
"912345706",12,1715.74636665454,1968.69006049611,0,12
"912345707",11,1617.45736059993,1933.98659929558,1,10
"912345708",13,1736.77135786632,2001.16379457045,1,12
"912345709",8,1615.17036691144,1812.11073017574,2,6
"912345710",56,3073.41671539737,2697.24673169728,15,41
"912345711",45,2758.43440660384,2579.33597919865,11,34
"912345712",49,2843.53223589926,2624.62502504328,11,38
"912345713",48,2907.52245181204,2613.58673801098,12,36
"912345714",47,2647.34068304918,2602.36394728806,9,38
"912345715",40,2707.02550493094,2517.98110851286,11,29
"912345716",32,2528.4113058027,2405.71569249515,10,22
"912345717",42,2763.98049239965,2543.21752514954,13,29
"912345718",64,3487.27179507601,2771.87783482774,18,46
"912345719",52,3047.85205167163,2656.6981055205,16,36
"912345720",83,3425.88214287077,2923.1438046077,21,62
"912345721",76,3456.2519070874,2870.97236507783,19,57
"912345722",60,3216.50171378147,2735.5526890818,20,40
"912345723",62,3511.75054055472,2753.94837323248,23,39
"912345724",63,3045.41797374537,2762.96971264875,19,44
"912345725",55,3217.17917437128,2687.33120998132,16,39
"912345726",74,3638.81242722219,2855.36548874306,23,51
"912345727",62,3444.25242096988,2753.94837323248,18,44
"912345728",62,3774.8858087672,2753.94837323248,21,41
"912345729",73,3965.21838290125,2847.4358582506,26,47
"912345730",63,3352.28844789032,2762.96971264875,24,39
"912345731",56,3216.2912960868,2697.24673169728,21,35
"912345732",59,3360.37764996339,2726.17127719361,20,39
"912345733",65,3470.9232588611,2780.67589681985,25,40
"912345734",41,2553.93469760775,2530.72175773865,9,32
"912345735",51,2538.65655319711,2646.17454577679,10,41
"912345736",37,2505.79142248906,2478.17471526668,7,30
"912345737",62,2627.04124834964,2753.94837323248,13,49
"912345738",39,2364.75046035319,2504.98447234734,7,32
"912345739",45,2609.35551760301,2579.33597919865,10,35
"912345740",51,2405.80893436133,2646.17454577679,15,36
"912345741",38,2323.68777185067,2491.71993967651,11,27
"912345742",38,2303.66575460845,2491.71993967651,11,27
"912345743",56,2328.03670122974,2697.24673169728,13,43
"912345744",45,2210.21784279156,2579.33597919865,10,35
"912345745",52,2645.22530554685,2656.6981055205,15,37
"912345746",56,2355.90713013534,2697.24673169728,17,39
"912345747",57,2555.1241723219,2707.02236739438,11,46
"912345748",44,2600.63416593978,2567.51523707907,12,32
"912345749",41,2266.19836112258,2530.72175773865,10,31
"912345750",55,2445.18645319196,2687.33120998132,13,42
"912345751",52,2338.9915769182,2656.6981055205,15,37
"912345752",32,2145.17450218859,2405.71569249515,7,25
"912345753",44,2077.95522914508,2567.51523707907,12,32
"912345754",25,2098.79692065421,2287.34065519221,9,16
"912345755",28,2047.11764722173,2340.94327947849,8,20
"912345756",20,1953.73423754732,2185.35845629437,8,12
"912345757",20,2012.33610837154,2185.35845629437,7,13
"912345758",18,1945.10359179782,2138.79896507223,8,10
"912345759",16,1903.55530249561,2087.92318348224,8,8
"912345760",19,2111.88412228407,2162.56636020013,8,11
"912345761",21,1937.70105696216,2207.26116887512,8,13
"912345762",20,2086.66919701846,2185.35845629437,9,11
"912345763",8,1759.08135673377,1812.11073017574,2,6
"912345764",23,2153.08118698892,2248.68783741607,7,16
"912345765",27,2193.05777882675,2323.60649590586,11,16
"912345766",40,2233.9318795585,2517.98110851286,10,30
"912345767",28,2136.94090715025,2340.94327947849,3,25
"912345768",33,2124.40981694837,2420.89448855093,3,30
"912345769",28,2071.25776886895,2340.94327947849,5,23
"912345770",36,2176.47577240643,2464.33502634194,7,29
"912345771",30,2279.22874445358,2374.18906024059,5,25
"912345772",20,1968.53404044385,2185.35845629437,7,13
"912345773",27,2062.56111022778,2323.60649590586,6,21
"912345774",36,2252.64649936714,2464.33502634194,9,27
"912345775",36,2249.01683126349,2464.33502634194,8,28
"912345776",36,2040.29869202222,2464.33502634194,9,27
"912345777",32,2107.1236131312,2405.71569249515,7,25
"912345778",23,1990.89964202894,2248.68783741607,6,17
"912345779",26,2061.25690798783,2305.75108410937,7,19
"912345780",16,1994.67548137137,2087.92318348224,5,11
"912345781",21,2130.26402009538,2207.26116887512,6,15
"912345782",24,2186.61149114944,2268.33468283819,5,19
"912345783",28,2116.88260104663,2340.94327947849,7,21
"912345784",38,2132.11005653666,2491.71993967651,9,29
"912345785",29,2018.59891061576,2357.79423966008,4,25
"912345787",29,2179.69939162118,2357.79423966008,6,23
"912345788",18,2182.14462001546,2138.79896507223,3,15
"912345789",43,2384.45344553091,2555.47878346624,11,32
"912345790",46,2199.05898256289,2590.94954296761,12,34
"912345791",35,2098.99474193207,2450.1860183293,7,28
"912345792",38,2238.76612228554,2491.71993967651,11,27
"912345793",51,2297.62731049847,2646.17454577679,14,37
"912345794",38,2221.42193204209,2491.71993967651,10,28
"912345795",42,2216.95941584694,2543.21752514954,12,30
"912345797",36,2108.45957711263,2464.33502634194,11,25
"912345798",35,2191.90774878021,2450.1860183293,9,26
"912345799",39,2151.93797332559,2504.98447234734,10,29
"912345800",40,2109.75739330599,2517.98110851286,10,30
"912345801",43,2332.09601005818,2555.47878346624,13,30
"912345802",37,2353.99218470251,2478.17471526668,9,28
"912345803",37,2351.24234631795,2478.17471526668,7,30
"912345804",46,2225.67012016496,2590.94954296761,11,35
"912345805",40,2211.04019693014,2517.98110851286,9,31
"912345806",45,2225.94463272098,2579.33597919865,11,34
"912345807",32,2133.793491711,2405.71569249515,5,27
"912345808",25,1986.17453614074,2287.34065519221,3,22
"912345809",37,2250.99595070975,2478.17471526668,8,29
"912345810",37,2156.76601013972,2478.17471526668,9,28
"912345811",40,1998.75998041496,2517.98110851286,9,31
"912345812",44,2029.33668317499,2567.51523707907,11,33
"912345813",42,2103.63018096913,2543.21752514954,14,28
"912345814",32,1892.43180909439,2405.71569249515,11,21
"912345815",36,2108.32378153117,2464.33502634194,11,25
"912345820",47,2121.51874939905,2602.36394728806,12,35
"912345821",49,2002.91164643457,2624.62502504328,13,36
"912345822",38,2084.170281608,2491.71993967651,13,25
"912345823",35,2113.63919125636,2450.1860183293,15,20
"912345824",36,2016.30090494792,2464.33502634194,8,28
"912345825",42,2067.20768697207,2543.21752514954,14,28
"912345826",18,2076.45358516512,2138.79896507223,3,15
"912345827",16,2189.3464586369,2087.92318348224,4,12
"912345828",37,2138.9476285293,2478.17471526668,12,25
"912345829",12,1963.63008722611,1968.69006049611,6,6
"912345830",28,2246.07469701626,2340.94327947849,9,19
"912345831",18,2182.34619885577,2138.79896507223,7,11
"912345832",25,2327.54435704477,2287.34065519221,7,18
"912345833",30,2143.80198774881,2374.18906024059,8,22
"912345834",34,1966.63014055157,2435.71163614839,12,22
"912345835",24,1853.63088861547,2268.33468283819,8,16
"912345836",35,2224.44500710888,2450.1860183293,8,27
"912345837",38,2680.76843063045,2491.71993967651,10,28
"912345838",34,2542.21621387044,2435.71163614839,10,24
"912345839",34,2245.56981821765,2435.71163614839,8,26
"912345840",30,2090.11918523493,2374.18906024059,9,21
"912345841",33,2090.8971537282,2420.89448855093,8,25
"912345842",48,2236.75571099897,2613.58673801098,17,31
"912345843",55,2399.74905628313,2687.33120998132,14,41
"912345844",70,2255.64592489607,2823.11677003184,17,53
"912345845",54,2381.01111799407,2677.2712016452,11,43
"912345846",58,2575.69679036057,2716.66249357165,10,48
"912345847",46,2468.20650583384,2590.94954296761,9,37
"912345848",32,2229.6673060022,2405.71569249515,7,25
"912345849",84,2811.30736059342,2930.30814451558,21,63
"912345850",69,2869.04976226417,2814.82611826518,25,44
"912345851",59,2602.79674632707,2726.17127719361,21,38
"912345852",80,2241.02562280076,2901.2306171403,26,54
"912345853",75,2111.22420755484,2863.21031780169,25,50
"912345854",68,2452.50821062109,2806.43931339586,23,45
"912345855",98,2328.05987013052,3024.10627920296,34,64
"912345856",85,2578.48289667234,2937.40494579778,24,61
"912345857",68,2682.83884790801,2806.43931339586,27,41
"912345858",86,3041.18542470359,2944.43562859908,24,62
"912345859",96,3207.71850722017,3011.38790884243,33,63
"912345860",106,2871.77351527311,3073.00222293854,38,68
"912345861",74,2930.81068271872,2855.36548874306,23,51
"912345862",67,3612.55397906843,2797.95380131742,18,49
"912345863",68,2797.36798921173,2806.43931339586,21,47
"912345864",58,2871.69604142053,2716.66249357165,21,37
"912345865",103,3665.65288408961,3055.02181112984,36,67
"912345866",69,3188.99033103227,2814.82611826518,16,53
"912345867",65,3458.39695900258,2780.67589681985,21,44
"912345868",75,2903.35406897421,2863.21031780169,22,53
"912345869",75,2800.9586741547,2863.21031780169,19,56
"912345870",63,3313.7148028895,2762.96971264875,21,42
"912345871",96,3233.27973819361,3011.38790884243,36,60
"912345872",58,2578.11841621063,2716.66249357165,16,42
"912345873",60,3222.45266107812,2735.5526890818,20,40
"912345874",94,3010.46606557341,2998.45695239283,30,64
"912345875",81,3285.07324069816,2908.60658576875,24,57
"912345876",57,3231.49034014025,2707.02236739438,24,33
"912345877",64,3242.49161046534,2771.87783482774,22,42
"912345878",69,2891.41466309245,2814.82611826518,23,46
"912345879",70,3092.23931584346,2823.11677003184,22,48
"912345880",39,2735.62883033852,2504.98447234734,16,23
"912345881",54,2956.9029189371,2677.2712016452,16,38
"912345882",48,2801.04502319885,2613.58673801098,21,27
"912345883",93,3416.32761325276,2991.90921350397,25,68
"912345884",48,2879.61291447547,2613.58673801098,20,28
"912345885",50,3141.59236547924,2635.48551585152,17,33
"912345886",100,2855.72074339305,3036.61979185145,32,68
"912345887",74,3756.07775049978,2855.36548874306,27,47
"912345888",56,3064.8945495793,2697.24673169728,16,40
"912345889",95,2915.47323698252,3004.94950458202,30,65
"912345890",88,2931.49443975765,2958.30409156145,26,62
"912345891",96,3242.72275730359,3011.38790884243,30,66
"912345892",50,2566.50072400635,2635.48551585152,13,37
"912345893",72,2698.38378236475,2839.4193288992,16,56
"912345894",64,2470.32364358277,2771.87783482774,13,51
"912345895",56,2796.86378700028,2697.24673169728,15,41
"912345896",44,2363.40558422641,2567.51523707907,8,36
"912345897",65,3130.64439420241,2780.67589681985,18,47
"912345898",83,2392.32034302723,2923.1438046077,28,55
"912345899",70,2610.74110407722,2823.11677003184,18,52
"912345900",77,2776.15034720443,2878.65357631343,28,49
"912345901",96,2760.98299442885,3011.38790884243,27,69
"912345902",73,2833.54071295133,2847.4358582506,21,52
"912345903",50,2415.0448936373,2635.48551585152,11,39
"912345908",55,2429.82994738874,2687.33120998132,19,36
"912345909",60,2524.07560134343,2735.5526890818,15,45
"912345910",57,2144.64379937465,2707.02236739438,15,42
"912345911",62,2360.0376379201,2753.94837323248,11,51
"912345912",18,1979.83484252101,2138.79896507223,5,13
"912345913",20,2095.42803427731,2185.35845629437,4,16
"912345914",29,2624.81807547017,2357.79423966008,8,21
"912345915",26,2571.27173664338,2305.75108410937,8,18
"912345916",34,2425.24838147994,2435.71163614839,11,23
"912345917",38,2683.38691812043,2491.71993967651,12,26
"912345918",34,2655.62570540299,2435.71163614839,9,25
"912345919",38,2704.87702486051,2491.71993967651,9,29
"912345949",16,1818.26746075749,2087.92318348224,4,12
"912345957",62,2957.19587048738,2753.94837323248,16,46
"912345962",65,2800.25560880649,2780.67589681985,17,48
"912345963",65,2882.68095868469,2780.67589681985,19,46
"912345964",52,2481.72415258277,2656.6981055205,9,43
"912345965",38,2569.77199102085,2491.71993967651,7,31
"912345966",56,2892.68315280406,2697.24673169728,20,36
"912345967",44,2913.14735555154,2567.51523707907,15,29
"912345968",28,2520.52512866764,2340.94327947849,8,20
"912345969",44,2780.96307285952,2567.51523707907,12,32
"912345970",50,2812.40706235204,2635.48551585152,13,37
"912345971",53,3392.73138155393,2667.061866114,22,31
"912345972",59,3162.18278020056,2726.17127719361,18,41
"912345973",86,3160.92367549406,2944.43562859908,30,56
"912345974",100,3350.06704315938,3036.61979185145,31,69
"912345975",86,3265.05816403035,2944.43562859908,27,59
"912345976",83,3835.82991219053,2923.1438046077,24,59
"912345977",75,3322.50776730218,2863.21031780169,24,51
"912345978",75,2554.00891839049,2863.21031780169,27,48
"912345979",35,2184.20379015292,2450.1860183293,6,29
"912345980",67,3424.77796882667,2797.95380131742,28,39
"912345981",76,2680.49222045763,2870.97236507783,24,52
"912345982",26,2400.36918579378,2305.75108410937,5,21
"912345983",69,2492.25964110666,2814.82611826518,19,50
"912345984",80,3187.50520728724,2901.2306171403,28,52
"912345985",84,2886.03083483881,2930.30814451558,30,54
"912345986",78,2770.51175594187,2886.25582696583,19,59
"912345987",109,2464.0499422967,3090.58221916578,27,82
"912345988",68,2786.18159303824,2806.43931339586,22,46
"912345989",53,2260.44327528053,2667.061866114,17,36
"912345990",93,2954.72319887112,2991.90921350397,22,71
"912345991",87,2500.71211218687,2951.40156710974,31,56
"912345992",86,2911.60418166088,2944.43562859908,24,62
"912345993",101,3291.55995672319,3042.80202352452,31,70
"912345994",52,2801.18261295244,2656.6981055205,19,33
"912345995",58,2901.69962835415,2716.66249357165,13,45
"912345996",34,2122.27979743628,2435.71163614839,7,27
"912345997",44,2507.92168702646,2567.51523707907,12,32
"912345998",22,2245.48909160742,2228.3491786518,7,15
"912345999",22,2055.05218500387,2228.3491786518,9,13
"912346000",68,2935.30243970914,2806.43931339586,20,48
"912346001",44,2468.38770640255,2567.51523707907,10,34
"912346002",47,2351.61356500753,2602.36394728806,11,36
"912346003",73,2571.92462908105,2847.4358582506,21,52
"912346004",59,2437.3401281253,2726.17127719361,17,42
"912346005",58,2573.70781211738,2716.66249357165,18,40
"912346006",75,2465.80823787297,2863.21031780169,19,56
"912346007",68,3401.11462332297,2806.43931339586,19,49
"912346008",62,2968.44495139644,2753.94837323248,13,49
"912346009",39,2467.45682520011,2504.98447234734,15,24
"912346010",41,2635.10367100149,2530.72175773865,15,26
"912346011",51,2886.83724894225,2646.17454577679,13,38
"912346012",68,3349.40170550388,2806.43931339586,21,47
"912346013",75,3337.93921428181,2863.21031780169,34,41
"912346014",84,3107.91399109217,2930.30814451558,27,57
"912346015",96,2738.88508572226,3011.38790884243,33,63
"912346016",65,3105.02228172244,2780.67589681985,17,48
"912346017",84,2951.19144140676,2930.30814451558,19,65
"912346018",84,2886.30948779965,2930.30814451558,21,63
"912346019",114,2452.36813232132,3119.04491539519,33,81
"912346020",44,1937.44910519129,2567.51523707907,11,33
"912346021",91,2578.09426754183,2978.64386243803,31,60
"912346022",107,2372.65329323681,3078.90571391637,26,81
"912346023",109,2218.40063321188,3090.58221916578,33,76
"912346024",80,2724.15102213915,2901.2306171403,20,60
"912346025",107,2601.71703161755,3078.90571391637,31,76
"912346026",31,2451.53143098382,2390.15469389133,5,26
"912346027",58,3323.36973884844,2716.66249357165,17,41
"912346028",33,2178.21355789964,2420.89448855093,7,26
"912346029",49,2187.996541664,2624.62502504328,16,33
"912346030",23,2129.56985615644,2248.68783741607,8,15
"912346031",23,2085.35288074505,2248.68783741607,7,16
"912346032",77,3173.08919740272,2878.65357631343,24,53
"912346033",81,3089.83661326268,2908.60658576875,22,59
"912346034",95,2851.32779620226,3004.94950458202,27,68
"912346035",62,2576.58777623586,2753.94837323248,16,46
"912346036",43,2530.02631271934,2555.47878346624,11,32
"912346037",81,2973.28805993645,2908.60658576875,23,58
"912346038",47,2622.40779525491,2602.36394728806,15,32
"912346039",66,3294.83821781115,2789.3669207067,20,46
"912346040",61,3229.41215897769,2744.81051624266,20,41
"912346041",62,2542.24468668665,2753.94837323248,14,48
"912346042",50,2813.80686441902,2635.48551585152,16,34
"912346043",49,2233.32787327771,2624.62502504328,11,38
"912346044",70,3046.84668017166,2823.11677003184,21,49
"912346045",71,2520.1862404037,2831.31372136695,17,54
"912346046",44,2126.95678641732,2567.51523707907,11,33
"912346047",75,2898.03467534706,2863.21031780169,23,52
"912346048",67,2676.70726309255,2797.95380131742,18,49
"912346049",7,1695.25906384387,1763.32076508842,1,6
"912346050",8,1663.06969885902,1812.11073017574,2,6
"912346051",12,1724.51316180166,1968.69006049611,2,10
"912346052",5,1585.03728852431,1646.12614877363,1,4
"912346053",18,1783.49616007588,2138.79896507223,2,16
"912346054",19,1840.69679446117,2162.56636020013,3,16
"912346055",9,1626.79191418399,1856.26587460569,1,8
"912346056",12,1793.47955277199,1968.69006049611,4,8
"912346057",12,1688.29872505885,1968.69006049611,4,8
"912346058",10,1733.02972020102,1896.67490607898,2,8
"912346059",12,1763.62595975284,1968.69006049611,1,11
"912346060",14,1743.05844167561,2031.70713799962,2,12
"912346061",11,1782.97597865942,1933.98659929558,2,9
"912346062",18,1837.18612292982,2138.79896507223,2,16
"912346063",5,1633.11816363792,1646.12614877363,2,3
"912346064",8,1713.21469027378,1812.11073017574,1,7
"912346065",12,1700.05549115154,1968.69006049611,2,10
"912346066",18,1896.31163432645,2138.79896507223,3,15
"912346067",16,1754.73195239846,2087.92318348224,3,13
"912346068",11,1692.15561830407,1933.98659929558,3,8
"912346069",19,1728.16850503316,2162.56636020013,3,16
"912346070",9,1697.81336161818,1856.26587460569,2,7
"912346112",31,2047.1813685745,2390.15469389133,10,21
"912346113",44,2022.93460065668,2567.51523707907,12,32
"912346118",24,1947.16617298358,2268.33468283819,5,19
"912346119",23,1792.87655032289,2248.68783741607,5,18
"912346123",17,1856.73238067383,2113.95669457394,3,14
"912346150",26,2009.56830680811,2305.75108410937,9,17
"912346199",18,1840.75754751609,2138.79896507223,4,14
"912346262",16,1778.57961039696,2087.92318348224,3,13
"912346263",23,1820.51338474244,2248.68783741607,4,19
"912346268",12,1784.07809798595,1968.69006049611,2,10
"912346269",9,1717.19382107047,1856.26587460569,1,8
"912346274",6,1588.40930780788,1708.62817714657,3,3
"912346275",10,1674.54403704102,1896.67490607898,3,7
"912346280",9,1686.08581595491,1856.26587460569,2,7
"912346281",12,1795.48044724154,1968.69006049611,1,11
"912346282",13,1824.72591340472,2001.16379457045,3,10
"912346283",11,1757.32099836984,1933.98659929558,4,7
"912346285",11,1730.14082095935,1933.98659929558,3,8
"912346287",10,1743.42588055912,1896.67490607898,2,8
"912346288",8,1728.72236458599,1812.11073017574,2,6
"912346289",11,1694.33202204926,1933.98659929558,4,7
"912346290",16,1887.41967400733,2087.92318348224,3,13
"912346291",16,1746.63330881366,2087.92318348224,3,13
"912346292",17,1841.50522717114,2113.95669457394,2,15
"912346293",12,1760.721420981,1968.69006049611,2,10
"912346294",13,1775.25363354377,2001.16379457045,3,10
"912346295",14,1860.58311057389,2031.70713799962,1,13
"912346296",9,1717.10426467992,1856.26587460569,2,7
"912346297",13,1868.23131050815,2001.16379457045,4,9
"912346299",12,1797.51424212339,1968.69006049611,2,10
"912346300",11,1788.71016846963,1933.98659929558,3,8
"912346301",13,1799.07523931917,2001.16379457045,2,11
"912346302",14,1824.56285006575,2031.70713799962,3,11
"912346303",12,1765.51350010132,1968.69006049611,2,10
"912346304",11,1781.06815631973,1933.98659929558,2,9
"912346305",10,1762.48660323663,1896.67490607898,2,8
"912346306",13,1810.28229875657,2001.16379457045,2,11
"912346307",16,1728.0119336139,2087.92318348224,5,11
"912346308",16,1805.36546130077,2087.92318348224,3,13
"912346309",18,1888.51370812813,2138.79896507223,4,14
"912346319",65,3067.99552497094,2780.67589681985,17,48
"912346320",69,2637.65311260951,2814.82611826518,15,54
"912346325",40,2528.14400280181,2517.98110851286,17,23
"912346326",42,2569.3887987003,2543.21752514954,17,25
"912346337",38,2481.62298395984,2491.71993967651,10,28
"912346338",31,2333.32993385212,2390.15469389133,10,21
"912346341",28,2440.72603469443,2340.94327947849,9,19
"912346342",42,2753.66340895225,2543.21752514954,12,30
"912346348",58,2311.42314720812,2716.66249357165,15,43
"912346349",57,2554.67145712377,2707.02236739438,17,40
"912346351",7,1741.24184982417,1763.32076508842,2,5
"912346352",10,1820.83783693422,1896.67490607898,3,7
"912346353",8,1731.87934369971,1812.11073017574,2,6
"912346354",7,1663.2426690568,1763.32076508842,2,5
"912346361",27,2240.08274674203,2323.60649590586,6,21
"912346362",27,2174.08534525415,2323.60649590586,8,19
"912346363",24,2117.49597903172,2268.33468283819,8,16
"912346366",24,2537.10316853756,2268.33468283819,10,14
"912346367",39,2591.55726822156,2504.98447234734,12,27
"912346368",39,2706.83971842808,2504.98447234734,14,25
"912346369",35,2596.01604478608,2450.1860183293,11,24
"912346370",38,2773.8655582039,2491.71993967651,10,28
"912346371",50,2376.64867195347,2635.48551585152,14,36
"912346372",28,2530.12848513089,2340.94327947849,10,18
"912346373",46,2546.63027395058,2590.94954296761,15,31
"912346377",2,1340.79519043948,1364.97646362037,1,1
"912346378",3,1436.27481961039,1482.92019466158,1,2
"912346420",1,1176.51947704734,1184.66451052022,1,0
"912346421",2,1340.79519043948,1364.97646362037,1,1
"912346493",21,1939.89455920646,2207.26116887512,6,15
"912346494",17,1801.85594805206,2113.95669457394,2,15
"912346495",9,1792.44065943564,1856.26587460569,0,9
"912346496",17,1829.00288230229,2113.95669457394,3,14
"912346497",16,1716.21580986116,2087.92318348224,3,13
"912346498",16,1664.12729243502,2087.92318348224,3,13
"912346499",21,1772.33339691864,2207.26116887512,5,16
"912346500",19,1679.73451723858,2162.56636020013,4,15
"912346502",16,1952.0329544374,2087.92318348224,3,13
"912346503",10,1879.9629977085,1896.67490607898,1,9
"912346504",23,1864.87041605065,2248.68783741607,5,18
"912346526",46,2313.57338984982,2590.94954296761,14,32
"912346549",34,2429.25863455471,2435.71163614839,10,24
"912346581",14,2012.51204723397,2031.70713799962,4,10
"912346723",21,2211.84681115518,2207.26116887512,8,13
"912346731",29,2494.05546649101,2357.79423966008,6,23
"912346737",29,2399.7951615383,2357.79423966008,8,21
"912346738",27,2358.12766444651,2323.60649590586,10,17
"912346739",36,2239.64748346306,2464.33502634194,12,24
"912346741",32,2326.77946475421,2405.71569249515,12,20
"912346742",30,2417.1670128649,2374.18906024059,7,23
"912346744",25,2390.39050543417,2287.34065519221,8,17
"912346745",24,2256.96662847609,2268.33468283819,7,17
"912346746",24,2254.53000685084,2268.33468283819,8,16
"912346747",35,2416.07979617347,2450.1860183293,11,24
"912346749",24,2378.07625524924,2268.33468283819,8,16
"912346758",16,1746.52477310635,2087.92318348224,2,14
"912346760",44,2615.84850721026,2567.51523707907,6,38
"912346763",50,2895.46164729105,2635.48551585152,9,41
"912346764",63,3055.66367831598,2762.96971264875,13,50
"912346813",41,2671.16760763813,2530.72175773865,12,29
"912346908",7,1609.10697445515,1763.32076508842,2,5
"912346912",7,1625.45484165673,1763.32076508842,1,6
"912346954",15,1862.15962715516,2060.56118614118,1,14
"912346955",17,1972.00378655026,2113.95669457394,3,14
"912346957",19,1860.5098840661,2162.56636020013,2,17
"912346958",15,1820.09851435732,2060.56118614118,3,12
"912346959",24,1859.62036042833,2268.33468283819,3,21
"912346960",19,1818.08419240559,2162.56636020013,2,17
"912346961",20,1794.64203627661,2185.35845629437,2,18
"912346962",10,1759.98231689275,1896.67490607898,1,9
"912346965",13,1806.01906450728,2001.16379457045,2,11
"912346966",11,1772.09186079088,1933.98659929558,1,10
"912346967",18,1832.30989595189,2138.79896507223,3,15
"912346968",16,1779.89838909197,2087.92318348224,2,14
"912346969",11,1809.71343451984,1933.98659929558,2,9
"912346970",16,1819.30716751195,2087.92318348224,2,14
"912346971",12,1751.7722102815,1968.69006049611,2,10
"912346973",13,1830.59052999002,2001.16379457045,2,11
"912346974",21,1865.12023315351,2207.26116887512,2,19
"912346975",17,1798.62450483884,2113.95669457394,3,14
"912346976",14,1853.68706495061,2031.70713799962,2,12
"912346977",12,1759.29034564617,1968.69006049611,0,12
"912346978",21,1951.86216408097,2207.26116887512,3,18
"912346979",14,1830.12879246211,2031.70713799962,2,12
"912346980",15,1865.35880888106,2060.56118614118,3,12
"912346982",12,1760.0401088739,1968.69006049611,2,10
"912346983",21,1913.74129453913,2207.26116887512,1,20
"912346984",11,1780.43043101545,1933.98659929558,1,10
"912346985",16,1904.7573399963,2087.92318348224,3,13
"912346987",20,1940.37744782635,2185.35845629437,2,18
"912346988",14,1778.90252077035,2031.70713799962,2,12
"912346989",13,1752.52574998458,2001.16379457045,3,10
"912346990",13,1818.89190804966,2001.16379457045,3,10
"912346991",18,1742.9334188312,2138.79896507223,2,16
"912346992",12,1869.9681540023,1968.69006049611,2,10
"912346994",17,1979.2879895729,2113.95669457394,2,15
"912346995",10,1711.52961160484,1896.67490607898,2,8
"912346996",16,1918.07315941371,2087.92318348224,2,14
"912346997",11,1782.21715889301,1933.98659929558,2,9
"912347004",16,1779.77647891925,2087.92318348224,3,13
"912347005",15,1800.81014370527,2060.56118614118,3,12
"912347017",15,1704.62988456505,2060.56118614118,3,12
"912347129",50,3105.84039399672,2635.48551585152,11,39
"912347134",62,2819.91100605379,2753.94837323248,19,43
"912347390",68,3059.79038478518,2806.43931339586,17,51
"912347391",66,3143.09337649989,2789.3669207067,18,48
"912347392",94,3297.20017478509,2998.45695239283,29,65
"912347393",72,2944.27513182841,2839.4193288992,21,51
"912347394",98,3167.93906699367,3024.10627920296,25,73
"912347395",84,3500.85009524876,2930.30814451558,22,62
"912347396",63,3290.90742795473,2762.96971264875,13,50
"912347397",76,3128.61366835459,2870.97236507783,18,58
"912347398",76,2896.2161061272,2870.97236507783,21,55
"912347399",80,2743.87517745222,2901.2306171403,19,61
"912347400",44,2670.93049889607,2567.51523707907,13,31
"912347401",57,2904.01595459052,2707.02236739438,15,42
"912347402",98,3078.36635873422,3024.10627920296,27,71
"912347403",66,2946.32401635476,2789.3669207067,16,50
"912347404",77,3035.28766825883,2878.65357631343,18,59
"912347405",75,3221.38553457823,2863.21031780169,21,54
"912347406",76,2745.2445387176,2870.97236507783,21,55
"912347407",73,2922.13120383683,2847.4358582506,21,52
"912347408",81,2189.19371335135,2908.60658576875,22,59
"912347409",72,2536.16572207868,2839.4193288992,24,48
"912347410",119,2173.96834036045,3146.53110896604,26,93
"912347411",103,2562.59735716537,3055.02181112984,23,80
"912347412",109,3059.26704484214,3090.58221916578,25,84
"912347413",90,2598.72244184757,2971.92401064611,25,65
"912347414",93,2781.42470994907,2991.90921350397,25,68
"912347415",88,2936.64311075186,2958.30409156145,26,62
"912347416",57,3035.36028530446,2707.02236739438,18,39
"912347417",48,3044.18229335887,2613.58673801098,16,32
"912347418",59,2909.42762667037,2726.17127719361,14,45
"912347419",88,2878.69232232349,2958.30409156145,22,66
"912347420",64,3181.39292634763,2771.87783482774,13,51
"912347421",79,3667.19341276876,2893.78092561085,25,54
"912347422",80,2895.2860659598,2901.2306171403,21,59
"912347423",58,3163.00941759012,2716.66249357165,15,43
"912347424",52,2624.14023357503,2656.6981055205,16,36
"912347425",50,2324.97985182672,2635.48551585152,15,35
"912347426",68,2867.54713205164,2806.43931339586,17,51
"912347427",64,2249.26053846855,2771.87783482774,15,49
"912347428",62,2786.12549622886,2753.94837323248,20,42
"912347430",77,3355.9760704144,2878.65357631343,22,55
"912347432",74,2972.1965509783,2855.36548874306,25,49
"912347433",60,2934.42061271475,2735.5526890818,15,45
"912347434",85,3438.7592946456,2937.40494579778,28,57
"912347437",75,2952.90940678081,2863.21031780169,23,52
"912347438",79,3355.34126466705,2893.78092561085,22,57
"912347439",76,3230.76456345622,2870.97236507783,22,54
"912347440",67,2471.0803770986,2797.95380131742,16,51
"912347441",45,2405.04908096432,2579.33597919865,15,30
"912347442",60,2835.85988333016,2735.5526890818,16,44
"912347443",49,2677.43379253232,2624.62502504328,16,33
"912347444",79,3027.93047362527,2893.78092561085,26,53
"912347445",85,3522.78078288943,2937.40494579778,26,59
"912347446",52,3130.19009305219,2656.6981055205,15,37
"912347447",72,3386.31158359385,2839.4193288992,19,53
"912347448",79,3216.94655257577,2893.78092561085,20,59
"912347449",65,2820.7346646338,2780.67589681985,13,52
"912347450",48,2564.57858637644,2613.58673801098,14,34
"912347451",47,2563.40994560526,2602.36394728806,10,37
"912347452",86,2763.76188100412,2944.43562859908,28,58
"912347453",69,2941.92513512934,2814.82611826518,21,48
"912347454",68,2908.53078546269,2806.43931339586,17,51
"912347455",85,3315.44800664283,2937.40494579778,23,62
"912347456",86,3451.09007285615,2944.43562859908,24,62
"912347457",85,3389.36761794957,2937.40494579778,22,63
"912347458",63,2732.22814694294,2762.96971264875,16,47
"912347459",95,3048.10270164844,3004.94950458202,25,70
"912347460",87,3096.69967590033,2951.40156710974,24,63
"912347461",55,2585.59948785557,2687.33120998132,14,41
"912347462",53,2996.7763742369,2667.061866114,13,40
"912347463",58,3003.78570076014,2716.66249357165,19,39
"912347464",73,3111.66663528633,2847.4358582506,20,53
"912347466",74,2648.33319467901,2855.36548874306,23,51
"912347467",74,3076.9842579967,2855.36548874306,18,56
"912347468",86,3195.61031232198,2944.43562859908,18,68
"912347469",42,2251.68324323076,2543.21752514954,8,34
"912347470",43,2173.73183708111,2555.47878346624,9,34
"912347471",40,2705.29607873335,2517.98110851286,9,31
"912347472",33,2293.14585171224,2420.89448855093,7,26
"912347473",67,3003.74858507971,2797.95380131742,16,51
"912347474",62,2742.10340966179,2753.94837323248,16,46
"912347475",80,3261.31776212662,2901.2306171403,16,64
"912347476",79,2700.80796824357,2893.78092561085,19,60
"912347477",61,2989.77821651494,2744.81051624266,14,47
"912347478",70,2788.09845659753,2823.11677003184,20,50
"912347479",33,2356.0573888598,2420.89448855093,11,22
"912347480",31,2134.54470961545,2390.15469389133,9,22
"912347481",75,2677.27142912661,2863.21031780169,23,52
"912347482",76,2960.25450598777,2870.97236507783,17,59
"912347483",78,2762.9152251214,2886.25582696583,13,65
"912347484",82,2874.06277696577,2915.91045786314,23,59
"912347485",75,2785.66668085582,2863.21031780169,16,59
"912347486",79,3144.98310052785,2893.78092561085,19,60
"912347487",53,2843.50742738628,2667.061866114,8,45
"912347488",78,3036.80325629611,2886.25582696583,19,59
"912347489",62,2975.62091365113,2753.94837323248,16,46
"912347490",38,2561.54177542558,2491.71993967651,10,28
"912347491",61,2376.56162885009,2744.81051624266,18,43
"912347497",55,2172.41522223248,2687.33120998132,13,42
"912347498",46,2225.8618539629,2590.94954296761,11,35
"912347499",48,2450.65417155897,2613.58673801098,11,37
"912347500",48,2237.0250982335,2613.58673801098,9,39
"912347501",42,2372.50803002591,2543.21752514954,8,34
"912347502",23,2029.54039036182,2248.68783741607,4,19
"912347503",39,2340.45999335005,2504.98447234734,4,35
"912347504",45,2480.83571492806,2579.33597919865,9,36
"912347505",34,2404.60375958742,2435.71163614839,7,27
"912347506",100,3594.54710819711,3036.61979185145,26,74
"912347507",85,3108.68360277585,2937.40494579778,24,61
"912347508",70,3192.54712523928,2823.11677003184,21,49
"912347509",57,3044.43901747849,2707.02236739438,19,38
"912347510",55,3087.73221303924,2687.33120998132,21,34
"912347511",70,3344.67288649159,2823.11677003184,23,47
"912347512",72,3087.16718414167,2839.4193288992,22,50
"912347519",66,2601.8583556692,2789.3669207067,21,45
"912347524",72,3093.98144157458,2839.4193288992,21,51
"912347525",66,2908.88443792035,2789.3669207067,17,49
"912347548",111,3080.13027182338,3102.08949329874,34,77
"912347549",62,2486.60555740985,2753.94837323248,19,43
"912347553",44,2504.44834028656,2567.51523707907,15,29
"912347554",39,2583.79908229061,2504.98447234734,12,27
"912347555",44,2178.7796775082,2567.51523707907,11,33
"912347556",42,2388.61648075379,2543.21752514954,11,31
"912347557",52,2380.73060494352,2656.6981055205,14,38
"912347558",55,2501.63151988594,2687.33120998132,16,39
"912347559",62,3378.611003006,2753.94837323248,16,46
"912347560",55,3002.01287449429,2687.33120998132,16,39
"912347569",62,2087.55258957754,2753.94837323248,19,43
"912347570",51,2230.75508610884,2646.17454577679,16,35
"912347586",56,2601.30447628987,2697.24673169728,16,40
"912347587",50,2733.79032135478,2635.48551585152,13,37
"912347628",50,2440.90318547728,2635.48551585152,18,32
"912347629",65,2843.62079034137,2780.67589681985,22,43
"912347630",45,2419.88195806912,2579.33597919865,16,29
"912347639",49,2552.24977326024,2624.62502504328,14,35
"912347652",74,2855.97103230936,2855.36548874306,20,54
"912347653",79,3782.46529536878,2893.78092561085,26,53
"912347658",48,2523.06507755491,2613.58673801098,17,31
"912347659",47,2991.62470729519,2602.36394728806,18,29
"912347660",38,2418.18903940248,2491.71993967651,16,22
"912347669",39,2448.64066613998,2504.98447234734,10,29
"912347682",71,2928.42036563421,2831.31372136695,21,50
"912347683",73,3592.99536969114,2847.4358582506,25,48
"912347686",66,2531.36794354441,2789.3669207067,22,44
"912347687",64,2649.73271204449,2771.87783482774,21,43
"912347693",46,2297.1219816547,2590.94954296761,19,27
"912347694",60,2376.47787345025,2735.5526890818,18,42
"912347703",57,2401.53096363933,2707.02236739438,22,35
"912347714",67,2432.85046392976,2797.95380131742,17,50
"912347720",38,2493.59461942624,2491.71993967651,10,28
"912347721",50,2423.39930651627,2635.48551585152,15,35
"912347726",43,2704.80100544501,2555.47878346624,14,29
"912347733",52,2736.30846218504,2656.6981055205,15,37
"912347742",57,2524.09476881184,2707.02236739438,15,42
"912347743",57,2758.83338253656,2707.02236739438,13,44
"912347744",40,2304.24749801241,2517.98110851286,8,32
"912347745",57,2641.68925760218,2707.02236739438,13,44
"912347764",62,2411.4276370316,2753.94837323248,14,48
"912347765",65,2627.81219587372,2780.67589681985,19,46
"912347766",65,3184.75598737286,2780.67589681985,14,51
"912347767",65,2830.47602637027,2780.67589681985,19,46
"912347768",65,2413.31001039306,2780.67589681985,15,50
"912347769",74,2333.04386272064,2855.36548874306,24,50
"912347770",64,3006.98617229402,2771.87783482774,18,46
"912347771",64,2693.25680720865,2771.87783482774,15,49
"912347772",76,3077.73517760626,2870.97236507783,24,52
"912347773",79,2354.65148607252,2893.78092561085,26,53
"912347774",59,2372.62629458334,2726.17127719361,17,42
"912347775",76,2538.44160586693,2870.97236507783,24,52
"912347776",67,2548.4796065801,2797.95380131742,21,46
"912347777",81,2766.7263621458,2908.60658576875,26,55
"912347778",76,2832.0453331183,2870.97236507783,22,54
"912347779",77,2710.12759130126,2878.65357631343,25,52
"912347780",79,3124.48017750739,2893.78092561085,21,58
"912347781",59,2254.17132455043,2726.17127719361,16,43
"912347782",66,2285.2042227476,2789.3669207067,20,46
"912347783",56,2261.8148235947,2697.24673169728,15,41
"912347784",58,2273.9981883784,2716.66249357165,16,42
"912347785",60,2184.74070595205,2735.5526890818,14,46
"912347786",44,2207.26363291221,2567.51523707907,12,32
"912347787",42,2325.67155779329,2543.21752514954,11,31
"912347788",72,2627.27988009725,2839.4193288992,16,56
"912347789",59,2815.96147295196,2726.17127719361,20,39
"912347790",75,2868.43522340955,2863.21031780169,25,50
"912347791",83,3259.69014120661,2923.1438046077,28,55
"912347792",74,2590.56916537687,2855.36548874306,17,57
"912347793",93,3112.06362368252,2991.90921350397,28,65
"912347794",75,2795.27051752173,2863.21031780169,21,54
"912347795",30,2215.26766684178,2374.18906024059,6,24
"912347828",8,1758.33105151379,1812.11073017574,1,7
"912347829",4,1481.85201631946,1572.73281143487,0,4
"912347830",3,1439.8353651524,1482.92019466158,1,2
"912347831",4,1466.22361533402,1572.73281143487,1,3
"912347834",12,1558.84534680763,1968.69006049611,1,11
"912347835",9,1631.68511664538,1856.26587460569,2,7
"912347836",6,1592.6402510709,1708.62817714657,2,4
"912347837",10,1654.73466493952,1896.67490607898,2,8
"912347838",9,1648.73614499634,1856.26587460569,2,7
"912347839",3,1423.61669099069,1482.92019466158,1,2
"912347840",5,1485.05523636953,1646.12614877363,1,4
"912347842",5,1489.5014226738,1646.12614877363,1,4
"912347843",3,1420.88006076079,1482.92019466158,1,2
"912347852",9,1800.1508693893,1856.26587460569,1,8
"912347853",18,1764.57930981058,2138.79896507223,3,15
"912347854",14,1718.1336349218,2031.70713799962,3,11
"912347855",11,1783.04693288898,1933.98659929558,3,8
"912347856",6,1678.12854294157,1708.62817714657,1,5
"912347858",12,1766.76683076154,1968.69006049611,1,11
"912347859",8,1764.53440510733,1812.11073017574,1,7
"912347860",13,1839.64936475062,2001.16379457045,1,12
"912347861",8,1726.77618139025,1812.11073017574,2,6
"912347862",11,1739.7362958183,1933.98659929558,2,9
"912347863",9,1791.77104481041,1856.26587460569,1,8
"912347864",9,1789.0180088497,1856.26587460569,1,8
"912347865",8,1736.45846317433,1812.11073017574,1,7
"912347866",8,1764.53440510733,1812.11073017574,1,7
"912347867",11,1877.13107021375,1933.98659929558,0,11
"912349127",14,1638.21656518473,2031.70713799962,3,11
"912349128",12,1693.7753920408,1968.69006049611,2,10
"912349129",14,1673.53554119568,2031.70713799962,1,13
"912349130",8,1621.83730757546,1812.11073017574,2,6
"912349131",7,1675.73440998474,1763.32076508842,2,5
"912349132",12,1724.93724662641,1968.69006049611,2,10
"912349133",14,1796.40630458617,2031.70713799962,3,11
"912349134",16,1739.60327888862,2087.92318348224,4,12
"912349135",14,1828.76798898639,2031.70713799962,4,10
"912349136",15,1847.77107149331,2060.56118614118,3,12
"912349137",14,1850.35661619563,2031.70713799962,4,10
"912349138",13,1829.93945627201,2001.16379457045,3,10
"912349139",13,1763.32429955956,2001.16379457045,2,11
"912349140",13,1739.56009698044,2001.16379457045,1,12
"912349141",13,1730.71786702041,2001.16379457045,2,11
"912349142",10,1699.19986479021,1896.67490607898,1,9
"912349143",14,1836.14603718107,2031.70713799962,2,12
"912349144",16,1841.68912368449,2087.92318348224,1,15
"912349145",9,1737.23789515974,1856.26587460569,1,8
"912349146",11,1802.48274815601,1933.98659929558,2,9
"912349147",14,1726.59583356963,2031.70713799962,1,13
"912349148",15,1724.31677932692,2060.56118614118,1,14
"912349149",7,1705.4811037157,1763.32076508842,2,5
"912349150",9,1760.77190520823,1856.26587460569,2,7
"912349151",9,1734.63857873933,1856.26587460569,1,8
"912349152",10,1795.77609854386,1896.67490607898,1,9
"912349153",11,1741.89025987346,1933.98659929558,1,10
"912349154",11,1739.28802732334,1933.98659929558,1,10
"912349155",13,1801.47030798168,2001.16379457045,1,12
"912349156",11,1683.55550891132,1933.98659929558,1,10
"912349157",13,1765.19536274345,2001.16379457045,2,11
"912349158",14,1791.28270164644,2031.70713799962,1,13
"912349159",15,1801.30214709391,2060.56118614118,1,14
"912349160",14,1826.13922965089,2031.70713799962,2,12
"912349161",8,1673.7857371218,1812.11073017574,1,7
"912349162",8,1655.89461452586,1812.11073017574,1,7
"912349163",4,1568.69264005966,1572.73281143487,1,3
"912349164",5,1629.90482599211,1646.12614877363,1,4
"912349165",11,1680.07424234573,1933.98659929558,2,9
"912349166",13,1737.54207458708,2001.16379457045,2,11
"912349167",11,1699.28899990782,1933.98659929558,1,10
"912349168",13,1694.59161525363,2001.16379457045,2,11
"912349169",12,1772.65264110005,1968.69006049611,2,10
"912349170",14,1728.23893715652,2031.70713799962,2,12
"912349171",13,1703.54224715194,2001.16379457045,4,9
"912349172",12,1783.96066950764,1968.69006049611,2,10
"912349173",2,1363.86032653284,1364.97646362037,1,1
"912349174",4,1516.03025468959,1572.73281143487,1,3
"912349175",21,1750.54311176133,2207.26116887512,5,16
"912349176",17,1774.53675269462,2113.95669457394,2,15
"912349177",17,1794.83946962575,2113.95669457394,4,13
"912349178",18,1752.5666377424,2138.79896507223,3,15
"912349179",24,1753.08863127957,2268.33468283819,5,19
"912349180",20,1682.76310855262,2185.35845629437,4,16
"912349181",22,1691.48864578752,2228.3491786518,4,18
"912349182",19,1867.12577860687,2162.56636020013,3,16
"912349183",17,1864.96169751944,2113.95669457394,2,15
"912349184",18,1832.34773603941,2138.79896507223,3,15
"912349185",12,1783.34427403437,1968.69006049611,1,11
"912349187",6,1616.61325276706,1708.62817714657,1,5
"912349188",16,1779.2882417509,2087.92318348224,3,13
"912349189",18,1835.1372852963,2138.79896507223,5,13
"912349190",12,1864.24047043875,1968.69006049611,3,9
"912349191",12,1827.34660887365,1968.69006049611,3,9
"912349192",9,1699.12522293093,1856.26587460569,2,7
"912349193",12,1785.32513252296,1968.69006049611,3,9
"912349194",7,1588.71487588233,1763.32076508842,2,5
"912349195",6,1562.79115968992,1708.62817714657,2,4
"912349196",4,1502.85167529139,1572.73281143487,1,3
"912349197",5,1546.61530445321,1646.12614877363,2,3
"912349198",7,1595.73986206206,1763.32076508842,2,5
"912349199",7,1620.43783308067,1763.32076508842,2,5
"912349200",8,1675.88781761181,1812.11073017574,3,5
"912349201",6,1621.06760426541,1708.62817714657,2,4
"912349202",7,1605.81623603874,1763.32076508842,2,5
"912349203",6,1612.23767771791,1708.62817714657,2,4
"912349205",3,1423.00921718486,1482.92019466158,1,2
"912349206",14,1866.64266096952,2031.70713799962,3,11
"912349207",13,1799.99071726571,2001.16379457045,3,10
"912349208",18,1828.54118936208,2138.79896507223,4,14
"912349209",17,1765.03809568548,2113.95669457394,7,10
"912349210",14,1879.2909119669,2031.70713799962,3,11
"912349211",14,1859.58047689622,2031.70713799962,4,10
"912349212",16,1822.71628411873,2087.92318348224,5,11
"912349213",18,1835.9429355999,2138.79896507223,4,14
"912349214",13,1873.92963203055,2001.16379457045,3,10
"912349215",13,1891.14823525183,2001.16379457045,4,9
"912349216",18,1800.29546850018,2138.79896507223,4,14
"912349217",11,1749.76377793435,1933.98659929558,3,8
"912349218",19,1768.25903744361,2162.56636020013,2,17
"912349219",21,1755.84874531056,2207.26116887512,3,18
"912349220",11,1790.0728253553,1933.98659929558,3,8
"912349221",11,1731.31792651301,1933.98659929558,3,8
"912349222",12,1808.81757348356,1968.69006049611,3,9
"912349224",13,1848.65072461954,2001.16379457045,3,10
"912349225",14,1874.21527488064,2031.70713799962,2,12
"912349226",11,1869.37451793812,1933.98659929558,2,9
"912349227",13,1874.06656622635,2001.16379457045,3,10
"912349228",11,1715.78286510275,1933.98659929558,2,9
"912349229",14,1845.85371851589,2031.70713799962,2,12
"912349230",15,1909.59229599897,2060.56118614118,2,13
"912349231",13,1856.84002910859,2001.16379457045,2,11
"912349232",21,1813.6894446201,2207.26116887512,4,17
"912349233",15,1918.70216911331,2060.56118614118,2,13
"912349234",10,1770.76355669695,1896.67490607898,2,8
"912349235",10,1840.48864337977,1896.67490607898,2,8
"912349236",17,1763.814928311,2113.95669457394,3,14
"912349237",13,1795.90799635709,2001.16379457045,2,11
"912349238",13,1776.63155973725,2001.16379457045,3,10
"912349239",11,1732.32702422408,1933.98659929558,4,7
"912349240",10,1729.3043636069,1896.67490607898,3,7
"912349241",12,1789.32928134272,1968.69006049611,2,10
"912349242",13,1873.92963203055,2001.16379457045,3,10
"912349243",10,1836.12539100906,1896.67490607898,3,7
"912349244",16,1876.23161934324,2087.92318348224,4,12
"912349245",17,1801.36109817432,2113.95669457394,4,13
"912349246",15,1899.10377626043,2060.56118614118,4,11
"912349247",19,1853.59340300517,2162.56636020013,5,14
"912349248",17,1845.57971143877,2113.95669457394,5,12
"912349249",16,1879.60110183208,2087.92318348224,5,11
"912349250",15,1801.42112645528,2060.56118614118,4,11
"912349251",13,1786.59285832334,2001.16379457045,4,9
"912349253",8,1765.37485360177,1812.11073017574,2,6
"912349254",9,1777.54669044752,1856.26587460569,2,7
"912349255",5,1650.28324376403,1646.12614877363,2,3
"912349258",9,1791.52474356062,1856.26587460569,3,6
"912349259",8,1729.24356694734,1812.11073017574,3,5
"912349264",9,1696.03270234764,1856.26587460569,2,7
"912349265",12,1747.47524748457,1968.69006049611,1,11
"912349266",10,1776.01475469573,1896.67490607898,2,8
"912349267",10,1683.28173165905,1896.67490607898,1,9
"912349268",9,1777.99876787184,1856.26587460569,2,7
"912349270",11,1761.90846741528,1933.98659929558,1,10
"912349272",6,1653.8961533709,1708.62817714657,2,4
"912349273",8,1694.00992042589,1812.11073017574,2,6
"912349274",6,1689.62232699943,1708.62817714657,1,5
"912349275",10,1701.91987194284,1896.67490607898,2,8
"912349277",9,1748.49579826114,1856.26587460569,1,8
"912349279",7,1693.0080196572,1763.32076508842,1,6
"912349280",10,1672.34613435,1896.67490607898,2,8
"912349281",8,1722.76404576595,1812.11073017574,1,7
"912349282",11,1685.30965331077,1933.98659929558,1,10
"912349283",12,1671.76621198807,1968.69006049611,2,10
"912349284",12,1762.94992888529,1968.69006049611,1,11
"912349285",6,1653.8961533709,1708.62817714657,2,4
"912349286",8,1724.43928681746,1812.11073017574,2,6
"912349287",7,1702.5401794992,1763.32076508842,2,5
"912349288",10,1814.77026160174,1896.67490607898,2,8
"912349289",9,1702.30786088422,1856.26587460569,2,7
"912349290",5,1661.99189573918,1646.12614877363,1,4
"912349291",6,1697.91889604399,1708.62817714657,1,5
"912349292",5,1608.56638524722,1646.12614877363,1,4
"912349293",6,1721.77497995665,1708.62817714657,1,5
"912349294",5,1642.6200192731,1646.12614877363,2,3
"912349295",7,1677.63536853089,1763.32076508842,2,5
"912349296",9,1800.25481403123,1856.26587460569,3,6
"912349298",8,1762.68195250863,1812.11073017574,3,5
"912349299",7,1769.25625735609,1763.32076508842,3,4
"912349300",9,1635.39883776744,1856.26587460569,1,8
"912349302",6,1685.74136438971,1708.62817714657,2,4
"912349303",7,1717.53224047466,1763.32076508842,2,5
"912349304",8,1795.87570790074,1812.11073017574,3,5
"912349305",5,1642.6200192731,1646.12614877363,2,3
"912349306",12,1842.20393249804,1968.69006049611,5,7
"912349308",11,1833.09162948014,1933.98659929558,4,7
"912349309",5,1652.50216632943,1646.12614877363,2,3
"912349310",6,1679.78399337103,1708.62817714657,2,4
"912349312",7,1603.53781610299,1763.32076508842,2,5
"912349313",5,1583.92345512963,1646.12614877363,2,3
"912349316",9,1566.94566506802,1856.26587460569,1,8
"912349317",8,1570.19660200331,1812.11073017574,1,7
"912349318",6,1594.83744289604,1708.62817714657,2,4
"912349319",11,1648.34834217381,1933.98659929558,3,8
"912349320",4,1542.07460496898,1572.73281143487,1,3
"912349321",12,1870.41008559125,1968.69006049611,3,9
"912349322",8,1840.34003826351,1812.11073017574,2,6
"912349323",13,1878.05400487909,2001.16379457045,2,11
"912349324",9,1794.23027474534,1856.26587460569,2,7
"912349325",10,1736.32126004848,1896.67490607898,2,8
"912349326",9,1793.91813116892,1856.26587460569,2,7
"912349327",15,1772.79716260539,2060.56118614118,4,11
"912349328",19,1879.52242024338,2162.56636020013,4,15
"912349329",9,1760.39671651577,1856.26587460569,1,8
"912349330",17,1729.91815654543,2113.95669457394,3,14
"912349331",10,1766.43930567591,1896.67490607898,1,9
"912349332",14,1724.71672593869,2031.70713799962,2,12
"912349333",10,1759.55326385174,1896.67490607898,1,9
"912349334",8,1775.49122791805,1812.11073017574,1,7
"912349335",12,1816.26840085792,1968.69006049611,3,9
"912349336",13,1846.50496771624,2001.16379457045,2,11
"912349337",12,1832.43687489895,1968.69006049611,3,9
"912349338",11,1756.91795195661,1933.98659929558,3,8
"912349339",17,1805.2578615496,2113.95669457394,5,12
"912349340",11,1846.94909007513,1933.98659929558,4,7
"912349341",9,1708.81151570655,1856.26587460569,1,8
"912349342",4,1542.20293086405,1572.73281143487,0,4
"912349343",7,1690.82664637545,1763.32076508842,1,6
"912349344",11,1804.83434427018,1933.98659929558,2,9
"912349345",11,1690.59506334802,1933.98659929558,3,8
"912349346",10,1733.88048315682,1896.67490607898,2,8
"912349347",15,1767.11631502993,2060.56118614118,2,13
"912349348",12,1716.39178965864,1968.69006049611,2,10
"912349349",12,1748.39787227246,1968.69006049611,3,9
"912349350",9,1712.52163526614,1856.26587460569,3,6
"912349351",15,1761.49133861612,2060.56118614118,3,12
"912349352",17,1702.30071615698,2113.95669457394,4,13
"912349353",10,1792.4411927215,1896.67490607898,1,9
"912349354",12,1670.64123570514,1968.69006049611,1,11
"912349355",15,1760.47200787409,2060.56118614118,2,13
"912349356",11,1802.88720960715,1933.98659929558,2,9
"912349357",9,1660.18628323293,1856.26587460569,1,8
"912349358",12,1767.40541825829,1968.69006049611,2,10
"912349359",13,1760.63119433747,2001.16379457045,3,10
"912349360",19,1793.07115456908,2162.56636020013,5,14
"912349362",18,1798.73123772633,2138.79896507223,4,14
"912349363",14,1707.87557957555,2031.70713799962,2,12
"912349364",18,1751.49124155744,2138.79896507223,4,14
"912349365",16,1800.00082705246,2087.92318348224,3,13
"912349366",17,1766.86815873883,2113.95669457394,2,15
"912349367",18,1747.414221424,2138.79896507223,3,15
"912349368",22,1754.67213078258,2228.3491786518,4,18
"912349369",17,1766.17384678788,2113.95669457394,4,13
"912349370",19,1741.16422779407,2162.56636020013,5,14
"912349371",14,1774.82220388677,2031.70713799962,2,12
"912349372",16,1784.78421101726,2087.92318348224,3,13
"912349373",12,1732.05966262511,1968.69006049611,3,9
"912349374",10,1735.1043360266,1896.67490607898,3,7
"912349375",15,1765.64007062707,2060.56118614118,2,13
"912349376",8,1711.26947013307,1812.11073017574,1,7
"912349377",11,1791.90945480708,1933.98659929558,2,9
"912349379",13,1860.70000657678,2001.16379457045,3,10
"912349380",17,1829.6116790112,2113.95669457394,4,13
"912349381",13,1858.71943625494,2001.16379457045,2,11
"912349382",14,1893.25524631909,2031.70713799962,4,10
"912349383",11,1834.35199128512,1933.98659929558,4,7
"912349384",13,1846.19286448689,2001.16379457045,3,10
"912349385",11,1780.46123725631,1933.98659929558,2,9
"912349386",15,1812.48425969979,2060.56118614118,3,12
"912349387",20,1801.94178816231,2185.35845629437,4,16
"912349388",13,1808.693078436,2001.16379457045,2,11
"912349389",15,1830.48160011504,2060.56118614118,3,12
"912349390",22,1755.3884109937,2228.3491786518,4,18
"912349391",11,1831.69641990787,1933.98659929558,1,10
"912349392",7,1680.87062929004,1763.32076508842,1,6
"912349393",14,1851.24151940536,2031.70713799962,3,11
"912349394",13,1850.51286656677,2001.16379457045,2,11
"912349395",12,1781.18739141544,1968.69006049611,1,11
"912349396",10,1785.85001780514,1896.67490607898,1,9
"912349397",16,1869.81366076932,2087.92318348224,3,13
"912349398",12,1789.85296613012,1968.69006049611,1,11
"912349399",15,1854.29222656367,2060.56118614118,3,12
"912349400",10,1820.44173748789,1896.67490607898,2,8
"912349401",8,1771.94552915025,1812.11073017574,1,7
"912349402",12,1883.09985206054,1968.69006049611,2,10
"912349403",3,1435.48897613853,1482.92019466158,1,2
"912349404",5,1585.3572101579,1646.12614877363,2,3
"912349405",2,1340.79519043948,1364.97646362037,1,1
"912349407",6,1528.27125599885,1708.62817714657,1,5
"912349408",6,1590.5844087181,1708.62817714657,1,5
"912349409",6,1600.00564868329,1708.62817714657,1,5
"912349410",6,1555.10351702639,1708.62817714657,1,5
"912349411",9,1622.34105350855,1856.26587460569,1,8
"912349412",13,1652.93328873186,2001.16379457045,1,12
"912349413",10,1655.39850378786,1896.67490607898,2,8
"912349414",5,1485.05523636953,1646.12614877363,1,4
"912349415",5,1489.5014226738,1646.12614877363,1,4
"912349416",3,1420.88006076079,1482.92019466158,1,2
"912349417",3,1439.8353651524,1482.92019466158,1,2
"912349418",4,1500.65733324928,1572.73281143487,2,2
"912349420",9,1631.68511664538,1856.26587460569,2,7
"912349421",17,1759.25598920744,2113.95669457394,4,13
"912349422",16,1725.30313581631,2087.92318348224,3,13
"912349423",20,1804.38933106612,2185.35845629437,4,16
"912349424",17,1833.74011102303,2113.95669457394,2,15
"912349425",18,1887.63104608728,2138.79896507223,2,16
"912349426",13,1831.67027715468,2001.16379457045,2,11
"912349427",14,1876.79170989186,2031.70713799962,2,12
"912349428",11,1881.75181212793,1933.98659929558,2,9
"912349429",8,1811.06743359756,1812.11073017574,2,6
"912349430",11,1844.91617269693,1933.98659929558,2,9
"912349431",10,1822.14395628395,1896.67490607898,2,8
"912349432",12,1840.27284223795,1968.69006049611,3,9
"912349433",11,1818.67462658599,1933.98659929558,2,9
"912349434",12,1828.72669152551,1968.69006049611,2,10
"912349435",16,1878.07495263892,2087.92318348224,2,14
"912349436",11,1822.84466896691,1933.98659929558,2,9
"912349437",14,1869.25007158651,2031.70713799962,3,11
"912349438",16,1825.64735358679,2087.92318348224,2,14
"912349439",12,1882.46396378414,1968.69006049611,2,10
"912349440",17,1682.71532221879,2113.95669457394,2,15
"912349441",16,1752.23115602444,2087.92318348224,2,14
"912349442",16,1855.10301718203,2087.92318348224,3,13
"912349443",17,1750.40853210594,2113.95669457394,3,14
"912349444",10,1645.92212644852,1896.67490607898,3,7
"912349445",12,1664.9336620222,1968.69006049611,3,9
"912349446",10,1720.72901271792,1896.67490607898,3,7
"912349447",9,1647.54687209612,1856.26587460569,3,6
"912349448",13,1817.92948726624,2001.16379457045,3,10
"912349449",13,1757.57072378754,2001.16379457045,3,10
"912349450",17,1851.24428727963,2113.95669457394,4,13
"912349451",13,1858.15930682308,2001.16379457045,3,10
"912349452",14,1837.94656871819,2031.70713799962,2,12
"912349453",17,1855.03883250289,2113.95669457394,3,14
"912349454",11,1819.8345007512,1933.98659929558,2,9
"912349455",12,1862.31192352,1968.69006049611,2,10
"912349456",19,1767.67141075182,2162.56636020013,3,16
"912349457",22,1713.91489030686,2228.3491786518,3,19
"912349458",19,1744.62799443615,2162.56636020013,4,15
"912349459",17,1823.22304135145,2113.95669457394,3,14
"912349460",3,1384.66675302346,1482.92019466158,0,3
"912349461",1,1152.12913723444,1184.66451052022,0,1
"912349462",14,1548.72456613121,2031.70713799962,3,11
"912349463",13,1595.44538356929,2001.16379457045,4,9
"912349464",13,1741.84122926427,2001.16379457045,3,10
"912349465",11,1629.63104347349,1933.98659929558,2,9
"912349466",10,1657.42412102717,1896.67490607898,3,7
"912349467",10,1628.95656810346,1896.67490607898,2,8
"912349468",7,1596.26042032786,1763.32076508842,1,6
"912349469",9,1608.3070516873,1856.26587460569,1,8
"912349470",12,1703.39649199653,1968.69006049611,3,9
"912349471",9,1638.35162380288,1856.26587460569,2,7
"912349472",9,1621.01180567942,1856.26587460569,3,6
"912349473",12,1689.07622173366,1968.69006049611,3,9
"912349474",10,1665.10591605036,1896.67490607898,3,7
"912349475",13,1668.83135174555,2001.16379457045,5,8
"912349476",12,1685.54216245975,1968.69006049611,3,9
"912349477",6,1560.45285660871,1708.62817714657,2,4
"912349478",10,1651.67277989071,1896.67490607898,2,8
"912349479",10,1715.92209525588,1896.67490607898,4,6
"912349480",11,1596.92365823764,1933.98659929558,2,9
"912349481",14,1678.30158194743,2031.70713799962,5,9
"912349482",13,1669.50161440983,2001.16379457045,4,9
"912349483",13,1687.6150870039,2001.16379457045,5,8
"912349484",8,1593.14878853995,1812.11073017574,2,6
"912349485",5,1483.73404408773,1646.12614877363,1,4
"912349487",6,1573.15040710568,1708.62817714657,2,4
"912349488",12,1620.40205689665,1968.69006049611,2,10
"912349489",11,1598.76159063728,1933.98659929558,2,9
"912349490",9,1591.87664460472,1856.26587460569,2,7
"912349491",9,1676.6793807718,1856.26587460569,3,6
"912349492",11,1698.91683116507,1933.98659929558,3,8
"912349493",12,1675.41539121727,1968.69006049611,4,8
"912349494",13,1644.64236097369,2001.16379457045,2,11
"912349495",9,1654.77727024975,1856.26587460569,2,7
"912349496",14,1677.81164599405,2031.70713799962,4,10
"912349497",11,1676.39652369336,1933.98659929558,3,8
"912349498",17,1622.81143076035,2113.95669457394,4,13
"912349499",14,1699.20139300912,2031.70713799962,3,11
"912349500",13,1641.69727536588,2001.16379457045,2,11
"912349501",16,1624.0051272633,2087.92318348224,4,12
"912349502",10,1649.93776699649,1896.67490607898,3,7
"912349503",8,1604.10633385578,1812.11073017574,2,6
"912349504",17,1824.68768613595,2113.95669457394,3,14
"912349505",14,1818.45177377031,2031.70713799962,3,11
"912349506",18,1821.74364040782,2138.79896507223,3,15
"912349507",16,1832.25877381411,2087.92318348224,4,12
"912349508",17,1905.51841550773,2113.95669457394,4,13
"912349509",18,1836.33759732486,2138.79896507223,3,15
"912349510",13,1886.17654733716,2001.16379457045,4,9
"912349511",16,1871.73679716184,2087.92318348224,3,13
"912349512",17,1800.47678141351,2113.95669457394,4,13
"912349513",20,1853.52571722491,2185.35845629437,6,14
"912349514",9,1787.14849020801,1856.26587460569,2,7
"912349515",8,1687.56556101057,1812.11073017574,2,6
"912349516",12,1773.6648258705,1968.69006049611,3,9
"912349517",11,1804.77731613815,1933.98659929558,2,9
"912349518",10,1796.77567317506,1896.67490607898,3,7
"912349519",8,1716.01225926319,1812.11073017574,2,6
"912349520",15,1768.79306983483,2060.56118614118,3,12
"912349521",14,1782.92538455671,2031.70713799962,4,10
"912349522",13,1809.44782144666,2001.16379457045,3,10
"912349523",15,1661.33232796791,2060.56118614118,3,12
"912349524",14,1726.34307947221,2031.70713799962,3,11
"912349525",15,1753.4368506828,2060.56118614118,3,12
"912349526",15,1755.75959195914,2060.56118614118,4,11
"912349527",15,1760.26197984515,2060.56118614118,4,11
"912349528",19,1615.46315456701,2162.56636020013,4,15
"912349529",10,1769.3899291772,1896.67490607898,3,7
"912349530",14,1780.23187054691,2031.70713799962,3,11
"912349531",9,1734.00560003776,1856.26587460569,3,6
"912349532",18,1809.23091143703,2138.79896507223,5,13
"912349533",18,1826.92485612262,2138.79896507223,3,15
"912349534",14,1712.08225309468,2031.70713799962,3,11
"912349535",9,1687.94978347591,1856.26587460569,2,7
"912349536",13,1810.8840669951,2001.16379457045,2,11
"912349537",12,1848.87791338747,1968.69006049611,2,10
"912349538",17,1823.52837343875,2113.95669457394,3,14
"912349539",14,1902.95613858256,2031.70713799962,2,12
"912349540",15,1920.74109645989,2060.56118614118,2,13
"912349541",15,1882.09963633458,2060.56118614118,2,13
"912349542",15,1905.93691974642,2060.56118614118,2,13
"912349559",12,1758.31327948132,1968.69006049611,2,10
"912349583",20,1805.02973171888,2185.35845629437,4,16
"912349593",11,1839.14174755538,1933.98659929558,1,10
"912349605",23,2010.74598156799,2248.68783741607,5,18
"912349607",32,1841.03980862211,2405.71569249515,7,25
"912349608",23,1992.96999861308,2248.68783741607,3,20
"912349610",29,2148.30711866413,2357.79423966008,7,22
"912349612",23,1919.90026331256,2248.68783741607,3,20
"912349613",23,1914.56195126762,2248.68783741607,4,19
"912349702",7,1649.67758584295,1763.32076508842,0,7
"912349703",9,1621.68674798107,1856.26587460569,1,8
"912349704",6,1555.01133752391,1708.62817714657,1,5
"912349705",7,1622.42439825829,1763.32076508842,1,6
"912349706",7,1636.80786939881,1763.32076508842,0,7
"912349707",7,1589.70044815686,1763.32076508842,0,7
"912349708",9,1706.02199595337,1856.26587460569,0,9
"912349709",8,1626.21910253695,1812.11073017574,0,8
"912349725",8,1705.340654162,1812.11073017574,1,7
"912349726",1,1161.73054778348,1184.66451052022,0,1
"912349727",3,1443.55359762675,1482.92019466158,1,2
"912349728",4,1508.31283787556,1572.73281143487,1,3
"912349729",6,1693.65232414268,1708.62817714657,2,4
"912349730",4,1551.99817751276,1572.73281143487,1,3
"912349731",3,1462.05363048004,1482.92019466158,1,2
"912349732",3,1458.75835505736,1482.92019466158,1,2
"912349733",11,1710.87049720784,1933.98659929558,3,8
"912349734",13,1830.31782581705,2001.16379457045,2,11
"912349735",3,1472.63045812309,1482.92019466158,1,2
"912349736",1,1158.1580747686,1184.66451052022,1,0
"912349737",1,1158.1580747686,1184.66451052022,1,0
"912349738",2,1294.80977874145,1364.97646362037,2,0
"912349739",2,1321.6396047043,1364.97646362037,0,2
"912349742",5,1556.86979259587,1646.12614877363,3,2
"912349743",4,1565.41134863356,1572.73281143487,1,3
"912349744",5,1564.09404797346,1646.12614877363,2,3
"912349745",3,1452.18100194327,1482.92019466158,1,2
"912349746",1,1166.48076072443,1184.66451052022,0,1
"912349747",2,1380.25876398244,1364.97646362037,0,2
"912349748",2,1321.6396047043,1364.97646362037,0,2
"912349749",9,1805.94823448827,1856.26587460569,2,7
"912349750",2,1327.75669022694,1364.97646362037,1,1
"912349751",5,1573.67338966683,1646.12614877363,1,4
"912349752",2,1309.73849757372,1364.97646362037,0,2
"912349753",3,1408.62461236138,1482.92019466158,2,1
"912349754",10,1714.68901067904,1896.67490607898,3,7
"912349755",14,1865.40348012322,2031.70713799962,3,11
"912349756",18,1889.98698612885,2138.79896507223,3,15
"912349759",14,1959.57558856319,2031.70713799962,3,11
"912349760",19,1883.72939156109,2162.56636020013,4,15
"912349761",21,1863.26365172316,2207.26116887512,5,16
"912349762",4,1530.66611287053,1572.73281143487,2,2
"912349763",2,1370.04708787715,1364.97646362037,1,1
"912349764",2,1303.6812205037,1364.97646362037,1,1
"912349765",2,1298.99390489522,1364.97646362037,1,1
"912349766",16,1790.28371825437,2087.92318348224,4,12
"912349767",14,1790.53296413758,2031.70713799962,4,10
"912349768",18,1840.79110478691,2138.79896507223,4,14
"912349769",14,1809.70239417171,2031.70713799962,3,11
"912349774",3,1466.82311609986,1482.92019466158,1,2
"912349775",9,1654.6593786007,1856.26587460569,1,8
"912349776",11,1799.27274115987,1933.98659929558,1,10
"912349777",19,1841.36800359003,2162.56636020013,3,16
"912349778",1,1166.48076072443,1184.66451052022,0,1
"912349779",3,1409.23980159338,1482.92019466158,1,2
"912349816",6,1626.35801762953,1708.62817714657,2,4
"912349817",3,1458.56852009454,1482.92019466158,1,2
"912349818",9,1740.03507510201,1856.26587460569,1,8
"912349819",14,1816.08399494063,2031.70713799962,3,11
"912349820",9,1625.20662544781,1856.26587460569,3,6
"912349821",9,1702.69809590125,1856.26587460569,3,6
"912349860",17,1799.81445782446,2113.95669457394,5,12
"912349861",13,1702.58799149894,2001.16379457045,4,9
"912349862",12,1837.95218854503,1968.69006049611,1,11
"912349863",18,1914.46060944058,2138.79896507223,5,13
"912349868",3,1420.36143481589,1482.92019466158,1,2
"912349869",6,1723.3015958829,1708.62817714657,1,5
"912349870",4,1509.25927395459,1572.73281143487,1,3
"912349871",11,1758.91672756742,1933.98659929558,3,8
"912349872",1,1157.36185322259,1184.66451052022,0,1
"912349873",2,1349.57368813546,1364.97646362037,1,1
"912349874",1,1157.36185322259,1184.66451052022,0,1
"912349875",3,1423.44629316604,1482.92019466158,1,2
"912349876",2,1293.91961058023,1364.97646362037,1,1
"912349877",2,1293.91961058023,1364.97646362037,1,1
"912349878",5,1519.99275051489,1646.12614877363,3,2
"912349879",2,1293.91961058023,1364.97646362037,1,1
"912349880",2,1354.87552912533,1364.97646362037,0,2
"912349881",2,1293.91961058023,1364.97646362037,1,1
"912349882",10,1771.82232069014,1896.67490607898,2,8
"912349883",10,1734.00246696194,1896.67490607898,2,8
"912349884",9,1728.35736769405,1856.26587460569,4,5
"912349885",10,1773.75592370759,1896.67490607898,2,8
"912349886",3,1411.92549888629,1482.92019466158,0,3
"912349887",1,1166.3302342754,1184.66451052022,0,1
"912349888",8,1614.28394024379,1812.11073017574,1,7
"912349889",4,1518.93261770296,1572.73281143487,2,2
"912349890",10,1684.09327007455,1896.67490607898,2,8
"912349891",12,1733.17868643943,1968.69006049611,2,10
"912349892",8,1667.43801650326,1812.11073017574,1,7
"912349893",4,1575.68253607557,1572.73281143487,1,3
"912349894",15,1815.65900634192,2060.56118614118,3,12
"912349895",7,1619.33841990415,1763.32076508842,3,4
"912349896",7,1551.8999664133,1763.32076508842,1,6
"912349897",5,1525.24660598509,1646.12614877363,1,4
"912349898",10,1766.72124941157,1896.67490607898,2,8
"912349899",8,1758.9822113955,1812.11073017574,3,5
"912349900",4,1479.95023938814,1572.73281143487,2,2
"912349901",3,1393.38830622769,1482.92019466158,0,3
"912349902",3,1422.64835407722,1482.92019466158,2,1
"912349903",5,1525.0407031142,1646.12614877363,2,3
"912349904",3,1422.64835407722,1482.92019466158,2,1
"912349905",3,1422.64835407722,1482.92019466158,2,1
"912349906",3,1378.83497595843,1482.92019466158,1,2
"912349907",4,1479.95023938814,1572.73281143487,2,2
"912349908",3,1422.64835407722,1482.92019466158,2,1
"912349909",4,1475.05153823052,1572.73281143487,3,1
"912349910",2,1293.91961058023,1364.97646362037,1,1
"912349911",5,1509.38358415791,1646.12614877363,3,2
"912349912",8,1739.36562085022,1812.11073017574,2,6
"912349913",10,1691.16338418636,1896.67490607898,3,7
"912349914",11,1830.42557460351,1933.98659929558,3,8
"912349915",9,1708.60113604482,1856.26587460569,2,7
"912349916",1,1166.48076072443,1184.66451052022,0,1
"912349917",2,1356.7769647325,1364.97646362037,1,1
"912349918",6,1611.71984477921,1708.62817714657,3,3
"912349919",6,1711.35969547508,1708.62817714657,2,4
"912349920",6,1665.72230000012,1708.62817714657,2,4
"912349921",9,1684.73147570322,1856.26587460569,2,7
"912349922",13,1775.02248485558,2001.16379457045,4,9
"912349923",1,1179.80732233099,1184.66451052022,0,1
"912349924",10,1712.73874216735,1896.67490607898,3,7
"912349925",13,1722.38909117924,2001.16379457045,3,10
"912349926",13,1864.21569084865,2001.16379457045,4,9
"912349927",14,1771.91408019652,2031.70713799962,2,12
"912349928",3,1422.64835407722,1482.92019466158,2,1
"912349929",2,1293.91961058023,1364.97646362037,1,1
"912349930",11,1767.6888240541,1933.98659929558,2,9
"912349931",15,1751.24854713467,2060.56118614118,2,13
"912349932",19,1820.8391007215,2162.56636020013,6,13
"912349933",17,1866.09796848701,2113.95669457394,4,13
"912349934",11,1770.3996141433,1933.98659929558,3,8
"912349935",16,1829.15506028943,2087.92318348224,5,11
"912349936",13,1716.95778827726,2001.16379457045,5,8
"912349937",13,1756.94943611509,2001.16379457045,4,9
"912349938",14,1839.53725225479,2031.70713799962,4,10
"912349939",14,1839.17239906822,2031.70713799962,5,9
"912349940",13,1779.16818150024,2001.16379457045,4,9
"912349941",13,1710.51082260958,2001.16379457045,5,8
"912349942",17,1727.87905514252,2113.95669457394,5,12
"912349943",14,1854.58984492452,2031.70713799962,4,10
"912349944",18,1867.96190394759,2138.79896507223,5,13
"912349945",20,1872.70476297895,2185.35845629437,5,15
"912349946",14,1714.27933362606,2031.70713799962,6,8
"912349947",13,1827.00257786033,2001.16379457045,3,10
"912349948",21,1861.39690187644,2207.26116887512,5,16
"912349949",15,1869.61640300901,2060.56118614118,4,11
"912349950",18,1851.49776364714,2138.79896507223,6,12
"912349951",18,1871.1223262944,2138.79896507223,5,13
"912349952",20,1876.58931187145,2185.35845629437,5,15
"912349953",19,1802.87436519167,2162.56636020013,7,12
"912349954",15,1791.83738135167,2060.56118614118,4,11
"912349955",13,1750.08095544645,2001.16379457045,3,10
"912349956",19,1785.06870285485,2162.56636020013,6,13
"912349957",17,1903.52023307066,2113.95669457394,4,13
"912349958",14,1822.96343404053,2031.70713799962,5,9
"912349959",12,1726.22008607877,1968.69006049611,3,9
"912349960",15,1713.63125166935,2060.56118614118,6,9
"912349961",18,1727.2355465259,2138.79896507223,5,13
"912349962",16,1747.04639573927,2087.92318348224,5,11
"912349963",13,1813.2324875407,2001.16379457045,4,9
"912350023",30,2174.71541084275,2374.18906024059,5,25
"912350027",18,1976.97707513798,2138.79896507223,3,15
"912350028",11,1779.84794904558,1933.98659929558,3,8
"912350043",8,1716.14079783653,1812.11073017574,0,8
"912350074",10,1837.28576617564,1896.67490607898,1,9
"912350082",11,1885.01858877216,1933.98659929558,1,10
"912350134",22,2247.30442634544,2228.3491786518,6,16
"912350188",16,1833.61573024797,2087.92318348224,5,11
"912350212",46,2480.68394195538,2590.94954296761,17,29
"912350213",43,2529.85588449535,2555.47878346624,11,32
"912350228",22,2207.26684404176,2228.3491786518,5,17
"912350229",37,2384.24348256182,2478.17471526668,9,28
"912350232",40,2454.91866677693,2517.98110851286,9,31
"912350233",36,2366.95968147872,2464.33502634194,11,25
"912350234",33,2432.9847266062,2420.89448855093,8,25
"912350235",37,2637.61243914849,2478.17471526668,11,26
"912350236",40,2715.48791197747,2517.98110851286,13,27
"912350237",43,2911.29286882981,2555.47878346624,14,29
"912350238",32,2263.08006192992,2405.71569249515,12,20
"912350239",39,2163.45137723029,2504.98447234734,15,24
"912350240",32,2326.55300267733,2405.71569249515,11,21
"912350241",43,2305.55788315799,2555.47878346624,12,31
"912350242",37,2536.36557349718,2478.17471526668,14,23
"912350243",28,2309.31954870536,2340.94327947849,9,19
"912350244",23,2073.45782131045,2248.68783741607,8,15
"912350245",34,1972.57672735338,2435.71163614839,12,22
"912350275",24,2185.78123730776,2268.33468283819,6,18
"912350289",17,1898.42547156076,2113.95669457394,5,12
"912350292",9,1776.26902232527,1856.26587460569,1,8
"912350294",74,2799.24292677415,2855.36548874306,24,50
"912350295",60,2537.1537716535,2735.5526890818,17,43
"912350313",44,2651.81148577809,2567.51523707907,12,32
"912350314",55,2553.43244090718,2687.33120998132,20,35
"912350315",51,2801.03854631226,2646.17454577679,13,38
"912350316",58,2914.26660000961,2716.66249357165,17,41
"912350317",75,3112.28596349551,2863.21031780169,25,50
"912350318",98,2763.81950351872,3024.10627920296,29,69
"912350319",99,2414.82157983909,3030.38817685238,29,70
"912350320",79,2805.71108016911,2893.78092561085,24,55
"912350321",89,2604.87427715533,2965.14449011489,21,68
"912350322",91,3117.03627359031,2978.64386243803,21,70
"912350323",104,2752.29560236031,3061.06104536539,31,73
"912350324",75,2782.49628713689,2863.21031780169,25,50
"912350327",91,2329.35513671661,2978.64386243803,30,61
"912350328",128,2587.84090592193,3193.77171424625,36,92
"912350331",86,2567.42168965173,2944.43562859908,25,61
"912350332",75,2753.22324404676,2863.21031780169,17,58
"912350333",80,2814.87397630247,2901.2306171403,25,55
"912350334",41,2599.56053726016,2530.72175773865,11,30
"912350335",94,2933.96717176759,2998.45695239283,27,67
"912350336",67,2428.97718108842,2797.95380131742,15,52
"912350337",52,2169.02188318508,2656.6981055205,16,36
"912350338",28,2355.44469873013,2340.94327947849,8,20
"912350339",79,2396.66189962201,2893.78092561085,27,52
"912350340",67,2458.37914632334,2797.95380131742,12,55
"912350341",116,3485.4086118356,3130.15231772002,32,84
"912350342",95,2841.69206129367,3004.94950458202,26,69
"912350343",77,2783.48459775203,2878.65357631343,22,55
"912350344",66,2637.29445490549,2789.3669207067,25,41
"912350345",84,2923.78925375574,2930.30814451558,17,67
"912350346",86,3566.87764208656,2944.43562859908,24,62
"912350347",92,3109.55023751357,2985.30521778333,23,69
"912350348",102,3071.33129460186,3048.93574640007,26,76
"912350349",84,3294.29731967093,2930.30814451558,25,59
"912350350",71,3294.8035877355,2831.31372136695,23,48
"912350351",105,3222.03442347221,3067.05425459434,28,77
"912350352",92,2612.29178104717,2985.30521778333,20,72
"912350353",64,2680.61548852642,2771.87783482774,15,49
"912350354",71,3017.27134966781,2831.31372136695,19,52
"912350355",85,3059.31241961941,2937.40494579778,25,60
"912350356",74,2702.44752219133,2855.36548874306,20,54
"912350401",14,1921.27198867565,2031.70713799962,0,14
"912350402",14,1763.09105835651,2031.70713799962,3,11
"912350430",22,2020.64228207891,2228.3491786518,5,17
"912350442",10,1682.7522033699,1896.67490607898,2,8
"912350443",5,1575.23413711193,1646.12614877363,1,4
"912350444",10,1744.79237327976,1896.67490607898,3,7
"912350445",13,1768.3533766789,2001.16379457045,3,10
"912350446",8,1671.098792484,1812.11073017574,2,6
"912350447",7,1654.04759480822,1763.32076508842,2,5
"912350448",6,1600.69598902577,1708.62817714657,2,4
"912350449",12,1832.54693716791,1968.69006049611,2,10
"912350470",10,1669.65444451478,1896.67490607898,3,7
"912350471",14,1877.71623410281,2031.70713799962,3,11
"912350472",12,1691.39532308585,1968.69006049611,4,8
"912350473",15,1865.45009956217,2060.56118614118,4,11
"912350475",1,1158.1580747686,1184.66451052022,1,0
"912350476",2,1290.72570957893,1364.97646362037,1,1
"912350477",1,1158.1580747686,1184.66451052022,1,0
"912350486",7,1573.10455692451,1763.32076508842,1,6
"912350487",9,1722.23835607694,1856.26587460569,3,6
"912350488",4,1496.41931361627,1572.73281143487,0,4
"912350489",4,1494.68721699344,1572.73281143487,2,2
"912350490",13,1749.54219186661,2001.16379457045,3,10
"912350491",10,1728.02335198853,1896.67490607898,2,8
"912350492",13,1813.56543974008,2001.16379457045,2,11
"912350493",7,1673.0004423562,1763.32076508842,1,6
"912350503",9,1619.97845863529,1856.26587460569,3,6
"912350504",6,1497.76376578002,1708.62817714657,2,4
"912350505",2,1303.6812205037,1364.97646362037,1,1
"912350506",4,1444.8137136122,1572.73281143487,2,2
"912350511",22,1802.90952203063,2228.3491786518,5,17
"912350512",18,1809.43991679466,2138.79896507223,5,13
"912350513",22,1815.78212062946,2228.3491786518,5,17
"912350514",20,1864.9269177402,2185.35845629437,4,16
"912350519",8,1594.91685847866,1812.11073017574,1,7
"912350520",10,1677.81337816399,1896.67490607898,1,9
"912350521",10,1763.94927322906,1896.67490607898,2,8
"912350522",11,1737.49760995935,1933.98659929558,4,7
"912350523",7,1627.73831360861,1763.32076508842,2,5
"912350524",6,1577.55515975304,1708.62817714657,1,5
"912350525",6,1652.25058461084,1708.62817714657,1,5
"912350526",10,1677.83330353412,1896.67490607898,2,8
"912350527",11,1778.6431957192,1933.98659929558,2,9
"912350528",11,1656.10732892812,1933.98659929558,4,7
"912350529",12,1734.96296329038,1968.69006049611,2,10
"912350530",11,1753.18562985959,1933.98659929558,3,8
"912350531",8,1695.3504162983,1812.11073017574,1,7
"912350532",5,1566.98174602635,1646.12614877363,1,4
"912350533",4,1526.8057594399,1572.73281143487,0,4
"912350534",10,1804.19002254632,1896.67490607898,1,9
"912350543",5,1542.45559299994,1646.12614877363,0,5
"912350544",5,1562.42593317863,1646.12614877363,1,4
"912350545",9,1686.92204503634,1856.26587460569,2,7
"912350546",7,1639.64651512964,1763.32076508842,1,6
"912350551",7,1650.29949005508,1763.32076508842,1,6
"912350552",3,1424.76789848678,1482.92019466158,0,3
"912350553",4,1487.79210471516,1572.73281143487,1,3
"912350554",2,1329.21628012236,1364.97646362037,0,2
"912350555",8,1640.41398847313,1812.11073017574,3,5
"912350556",6,1641.70061137303,1708.62817714657,1,5
"912350559",11,1744.51325031975,1933.98659929558,2,9
"912350560",8,1661.42371618605,1812.11073017574,2,6
"912350561",11,1746.31063924969,1933.98659929558,1,10
"912350562",11,1720.10744215115,1933.98659929558,3,8
"912350563",2,1377.08032457344,1364.97646362037,0,2
"912350565",4,1510.55565023312,1572.73281143487,0,4
"912350566",4,1518.3816274558,1572.73281143487,0,4
"912350567",10,1722.58538749641,1896.67490607898,3,7
"912350568",5,1546.49274738397,1646.12614877363,2,3
"912350569",8,1695.93939204612,1812.11073017574,2,6
"912350570",8,1704.07091617053,1812.11073017574,2,6
"912350571",8,1634.96836708971,1812.11073017574,3,5
"912350572",9,1706.83418088453,1856.26587460569,2,7
"912350573",8,1695.80560708553,1812.11073017574,2,6
"912350574",8,1652.85082893332,1812.11073017574,4,4
"912350581",3,1420.36143481589,1482.92019466158,1,2
"912350586",15,1771.1405037339,2060.56118614118,3,12
"912350629",5,1554.03668256659,1646.12614877363,0,5
"912350630",6,1583.36003000372,1708.62817714657,0,6
"912350645",9,1679.22836656672,1856.26587460569,3,6
"912350687",62,2745.88336784971,2753.94837323248,23,39
"912350688",44,2584.44144402206,2567.51523707907,15,29
"912350782",16,1979.52931176708,2087.92318348224,3,13
"912350783",23,2002.44673664684,2248.68783741607,3,20
"912350784",18,2129.4795357373,2138.79896507223,1,17
"912350785",27,2123.35608421962,2323.60649590586,6,21
"912350800",25,2113.08523487109,2287.34065519221,6,19
"912350806",27,1865.61329328551,2323.60649590586,11,16
"912350819",16,1792.97964666978,2087.92318348224,4,12
"912350821",15,1835.18889596905,2060.56118614118,3,12
"912350822",12,1745.94843473089,1968.69006049611,3,9
"912350823",11,1729.30029539559,1933.98659929558,2,9
"912350824",22,1946.50960137982,2228.3491786518,4,18
"912350825",10,1755.61792792444,1896.67490607898,0,10
"912350826",21,1900.19721189113,2207.26116887512,5,16
"912350828",15,1931.05091593946,2060.56118614118,2,13
"912350829",16,1918.13973313542,2087.92318348224,4,12
"912350830",16,1795.32539242685,2087.92318348224,4,12
"912350831",18,1849.25019756353,2138.79896507223,4,14
"912350833",17,1838.07140133827,2113.95669457394,4,13
"912350834",22,1894.83482507346,2228.3491786518,3,19
"912350835",13,1825.60422367668,2001.16379457045,2,11
"912350840",29,2187.9977040167,2357.79423966008,2,27
"912350841",25,2101.89896340674,2287.34065519221,8,17
"912350844",24,2116.45211592703,2268.33468283819,6,18
"912350845",29,2192.87700341219,2357.79423966008,8,21
"912350852",16,1984.51503782298,2087.92318348224,3,13
"912350854",37,2385.38721267665,2478.17471526668,10,27
"912350859",32,2533.52320134538,2405.71569249515,5,27
"912350860",22,2318.93464031255,2228.3491786518,3,19
"912350861",23,2189.33836450614,2248.68783741607,4,19
"912350862",30,2213.14620241952,2374.18906024059,7,23
"912350863",19,2080.08674763064,2162.56636020013,5,14
"912350864",22,2336.32655417469,2228.3491786518,5,17
"912350865",23,2274.62947288266,2248.68783741607,2,21
"912350866",29,2329.75079235762,2357.79423966008,3,26
"912350867",28,2265.33993339258,2340.94327947849,5,23
"912350868",28,2322.75298575087,2340.94327947849,3,25
"912350869",32,2493.46241063822,2405.71569249515,5,27
"912350870",38,2406.30179044165,2491.71993967651,6,32
"912350871",22,2190.06840036291,2228.3491786518,3,19
"912350872",22,2270.89012919712,2228.3491786518,4,18
"912350873",24,1977.76845161508,2268.33468283819,2,22
"912350874",32,2285.7930342556,2405.71569249515,3,29
"912350875",15,2036.40717600703,2060.56118614118,2,13
"912350876",14,1999.62251639718,2031.70713799962,2,12
"912350877",24,2101.74133177166,2268.33468283819,2,22
"912350878",25,2144.08066781441,2287.34065519221,2,23
"912350879",26,2241.94625849762,2305.75108410937,6,20
"912351124",10,1688.06325535509,1896.67490607898,3,7
"912351125",10,1763.71884584903,1896.67490607898,2,8
"912351126",9,1671.60230748697,1856.26587460569,3,6
"912351127",5,1559.74401194785,1646.12614877363,1,4
"912351129",11,1731.45841411262,1933.98659929558,2,9
"912351273",7,1710.42101735226,1763.32076508842,2,5
"912351274",2,1335.21376508866,1364.97646362037,0,2
"912351275",10,1919.33183873709,1896.67490607898,1,9
"912351276",5,1674.54992665708,1646.12614877363,0,5
"912351322",8,1853.33783739668,1812.11073017574,1,7
"912351323",8,1792.2418822832,1812.11073017574,2,6
"912351324",9,1813.31997694568,1856.26587460569,0,9
"912351325",1,1168.07761147649,1184.66451052022,0,1
"912351328",2,1319.69935978452,1364.97646362037,0,2
"912351329",3,1396.54496267312,1482.92019466158,1,2
"912351330",6,1525.84549189312,1708.62817714657,0,6
"912351331",5,1519.91944024364,1646.12614877363,0,5
"912351332",9,1583.60775429337,1856.26587460569,1,8
"912351333",6,1525.84549189312,1708.62817714657,0,6
"912351334",11,1598.38510450067,1933.98659929558,1,10
"912351335",8,1600.84063746503,1812.11073017574,0,8
"912351336",6,1525.84549189312,1708.62817714657,0,6
"912351337",5,1513.88428202103,1646.12614877363,1,4
"912351338",4,1477.47953941629,1572.73281143487,0,4
"912351339",3,1416.68271621492,1482.92019466158,0,3
"912351340",10,1671.61110855808,1896.67490607898,1,9
"912351341",5,1519.91944024364,1646.12614877363,0,5
"912351364",9,1780.2419611242,1856.26587460569,1,8
"912351365",9,1787.91997177866,1856.26587460569,2,7
"912351366",10,1777.77814345005,1896.67490607898,1,9
"912351367",5,1589.58809333247,1646.12614877363,1,4
"912351391",5,1609.37797041413,1646.12614877363,0,5
"912351392",8,1747.55971617067,1812.11073017574,1,7
"912351393",15,1970.56151874132,2060.56118614118,2,13
"912351394",14,1932.76556291176,2031.70713799962,1,13
"912351400",3,1462.48998532316,1482.92019466158,1,2
"912351401",3,1370.13663604388,1482.92019466158,1,2
"912351402",8,1649.75945122888,1812.11073017574,1,7
"912351403",4,1525.84105727444,1572.73281143487,1,3
"912351404",3,1467.05224229073,1482.92019466158,1,2
"912351405",1,1152.96854186554,1184.66451052022,0,1
"912351406",5,1549.43812212906,1646.12614877363,1,4
"912351407",3,1411.96999425743,1482.92019466158,1,2
"912351415",3,1461.22840307828,1482.92019466158,2,1
"912351416",3,1428.781544063,1482.92019466158,1,2
"912351417",2,1357.31890381225,1364.97646362037,1,1
"912351418",2,1351.11651627742,1364.97646362037,1,1
"912351419",5,1557.64034092053,1646.12614877363,0,5
"912351420",4,1487.03153520563,1572.73281143487,1,3
"912351421",2,1296.34239218168,1364.97646362037,0,2
"912351422",2,1302.61315359408,1364.97646362037,0,2
"912351431",21,2072.54125232324,2207.26116887512,9,12
"912351432",32,2161.70530311765,2405.71569249515,9,23
"912351460",8,1724.12784128195,1812.11073017574,1,7
"912351461",6,1670.25799206734,1708.62817714657,2,4
"912351462",3,1443.33922733671,1482.92019466158,0,3
"912351463",6,1652.84093467692,1708.62817714657,0,6
"912351468",20,2006.69358789066,2185.35845629437,5,15
"912351469",17,1825.69891480175,2113.95669457394,4,13
"912351470",20,1963.02641811804,2185.35845629437,6,14
"912351471",19,1927.32233795373,2162.56636020013,5,14
"912351472",15,1859.1954580466,2060.56118614118,3,12
"912351473",10,1799.5319625345,1896.67490607898,2,8
"912351474",17,1809.38331388605,2113.95669457394,5,12
"912351475",16,1750.94300153261,2087.92318348224,7,9
"912351476",15,1874.98851097477,2060.56118614118,6,9
"912351477",16,1864.90106298233,2087.92318348224,6,10
"912351478",15,1813.45023489678,2060.56118614118,5,10
"912351479",19,1869.53514103527,2162.56636020013,6,13
"912351480",16,1846.38330108273,2087.92318348224,2,14
"912351481",13,1900.36683361017,2001.16379457045,2,11
"912351482",12,1797.15742568442,1968.69006049611,1,11
"912351483",7,1685.95449069861,1763.32076508842,1,6
"912351484",11,1842.03496908906,1933.98659929558,0,11
"912351485",14,1835.19471808384,2031.70713799962,2,12
"912351486",6,1685.55338828333,1708.62817714657,0,6
"912351487",12,1782.26617725514,1968.69006049611,2,10
"912351488",10,1837.84093737651,1896.67490607898,0,10
"912351489",9,1829.00428506805,1856.26587460569,0,9
"912351490",7,1701.61072781642,1763.32076508842,0,7
"912351491",7,1748.19003524566,1763.32076508842,0,7
"912351492",11,1874.1804438373,1933.98659929558,2,9
"912351493",7,1694.31956215008,1763.32076508842,1,6
"912351494",12,1803.93946609035,1968.69006049611,2,10
"912351495",7,1676.73406974156,1763.32076508842,1,6
"912351496",13,1918.0389168198,2001.16379457045,4,9
"912351497",18,1865.87206138001,2138.79896507223,2,16
"912351498",16,2004.43607928093,2087.92318348224,1,15
"912351499",8,1810.53155549948,1812.11073017574,2,6
"912351504",15,1955.80287899222,2060.56118614118,1,14
"912351505",14,1950.868026128,2031.70713799962,1,13
"912351506",13,1865.9875905875,2001.16379457045,1,12
"912351507",12,1816.97258137382,1968.69006049611,2,10
"912351508",21,1837.03992650601,2207.26116887512,4,17
"912351509",21,1994.05507383009,2207.26116887512,3,18
"912351510",22,1905.09556600729,2228.3491786518,4,18
"912351511",20,1958.26518067175,2185.35845629437,4,16
"912351512",13,1906.29044751499,2001.16379457045,4,9
"912351513",12,1781.67289500562,1968.69006049611,2,10
"912351514",11,1760.31241319438,1933.98659929558,3,8
"912351515",6,1622.27111020902,1708.62817714657,1,5
"912351516",17,1936.93099109893,2113.95669457394,3,14
"912351517",11,1735.69633014181,1933.98659929558,1,10
"912351518",17,1883.94675748069,2113.95669457394,2,15
"912351519",14,1838.88475377109,2031.70713799962,2,12
"912351520",5,1606.05354260412,1646.12614877363,0,5
"912351521",7,1678.58403401727,1763.32076508842,0,7
"912351522",6,1694.73705966664,1708.62817714657,0,6
"912351523",8,1765.12741141329,1812.11073017574,1,7
"912351524",9,1752.5903809488,1856.26587460569,1,8
"912351525",8,1669.26127413027,1812.11073017574,2,6
"912351526",8,1700.46684357122,1812.11073017574,1,7
"912351527",8,1709.35765215364,1812.11073017574,0,8
"912351528",11,1822.41971180185,1933.98659929558,3,8
"912351529",14,1761.27108777056,2031.70713799962,3,11
"912351530",15,1861.26310426839,2060.56118614118,2,13
"912351531",6,1607.79805459395,1708.62817714657,1,5
"912351532",13,1782.29116381173,2001.16379457045,3,10
"912351533",17,1931.40753407418,2113.95669457394,6,11
"912351534",8,1763.3443303323,1812.11073017574,0,8
"912351535",8,1720.53161443072,1812.11073017574,0,8
"912351536",16,1888.90338146257,2087.92318348224,3,13
"912351537",15,1859.20838877048,2060.56118614118,3,12
"912351538",21,1879.86898203995,2207.26116887512,5,16
"912351539",6,1622.15833385729,1708.62817714657,0,6
"912351540",13,1795.48983612503,2001.16379457045,3,10
"912351541",11,1706.52308322796,1933.98659929558,4,7
"912351542",14,1836.81903723107,2031.70713799962,2,12
"912351543",11,1733.76714557529,1933.98659929558,2,9
"912351544",20,1859.91800918517,2185.35845629437,6,14
"912351545",16,1984.97745188854,2087.92318348224,2,14
"912351546",12,1887.20879313381,1968.69006049611,3,9
"912351547",15,1814.01228285597,2060.56118614118,6,9
"912351548",9,1777.97796382334,1856.26587460569,0,9
"912351549",6,1657.22977817363,1708.62817714657,0,6
"912351550",5,1675.78632685221,1646.12614877363,0,5
"912351551",5,1587.4156716335,1646.12614877363,0,5
"912351552",4,1533.67520472193,1572.73281143487,0,4
"912351553",6,1676.68646040709,1708.62817714657,0,6
"912351554",6,1645.32395221521,1708.62817714657,1,5
"912351555",15,1973.51483173206,2060.56118614118,3,12
"912351556",7,1737.76069746995,1763.32076508842,0,7
"912351557",6,1687.51006635643,1708.62817714657,0,6
"912351558",5,1665.26212748092,1646.12614877363,0,5
"912351559",8,1783.44320518969,1812.11073017574,0,8
"912351560",17,1843.0427306662,2113.95669457394,4,13
"912351561",14,1862.39676033664,2031.70713799962,3,11
"912351562",7,1654.90702217599,1763.32076508842,1,6
"912351563",7,1750.51229155642,1763.32076508842,0,7
"912351564",16,1861.11899396942,2087.92318348224,3,13
"912351565",13,1827.99225895038,2001.16379457045,2,11
"912351566",11,1771.7267160693,1933.98659929558,2,9
"912351567",11,1723.37172046542,1933.98659929558,3,8
"912351572",8,1724.30708092991,1812.11073017574,0,8
"912351573",12,1830.6130421709,1968.69006049611,1,11
"912351574",8,1753.6410115461,1812.11073017574,1,7
"912351575",10,1808.40669163223,1896.67490607898,2,8
"912351576",16,1819.63341413076,2087.92318348224,3,13
"912351577",17,2040.89673581111,2113.95669457394,5,12
"912351578",17,1913.92161479096,2113.95669457394,5,12
"912351579",15,2038.39953958092,2060.56118614118,3,12
"912351580",20,1901.29571890876,2185.35845629437,6,14
"912351581",24,1963.84049164899,2268.33468283819,9,15
"912351582",19,1850.72452981612,2162.56636020013,7,12
"912351583",18,1858.06164239521,2138.79896507223,5,13
"912351584",18,1931.73976300994,2138.79896507223,3,15
"912351585",16,1913.15526652757,2087.92318348224,3,13
"912351586",13,1938.53961490433,2001.16379457045,1,12
"912351587",16,1874.82280555456,2087.92318348224,2,14
"912351592",8,1786.74866610342,1812.11073017574,0,8
"912351593",16,1918.0975223909,2087.92318348224,3,13
"912351594",13,1813.03413699296,2001.16379457045,2,11
"912351595",8,1755.535022616,1812.11073017574,2,6
"912351596",7,1673.14463867792,1763.32076508842,0,7
"912351597",10,1817.04507246901,1896.67490607898,2,8
"912351598",10,1802.78643547517,1896.67490607898,0,10
"912351599",10,1785.72553953641,1896.67490607898,2,8
"912351600",15,1898.01412375425,2060.56118614118,2,13
"912351601",17,1921.80976070341,2113.95669457394,3,14
"912351602",10,1823.17975684224,1896.67490607898,0,10
"912351603",8,1709.21628607058,1812.11073017574,0,8
"912351604",15,1744.3009357842,2060.56118614118,2,13
"912351605",9,1736.6799286553,1856.26587460569,0,9
"912351606",11,1828.14487996038,1933.98659929558,2,9
"912351607",10,1740.61293701506,1896.67490607898,2,8
"912351608",13,1794.92976593438,2001.16379457045,1,12
"912351609",13,1859.0739544307,2001.16379457045,1,12
"912351610",13,1776.95090715058,2001.16379457045,2,11
"912351611",13,1835.447932096,2001.16379457045,2,11
"912351612",11,1843.53378901625,1933.98659929558,1,10
"912351613",11,1823.00989664095,1933.98659929558,1,10
"912351614",10,1817.94240571101,1896.67490607898,0,10
"912351615",8,1697.86695348937,1812.11073017574,2,6
"912351616",11,1861.86876148356,1933.98659929558,1,10
"912351617",9,1728.65587928262,1856.26587460569,1,8
"912351618",11,1778.82317910054,1933.98659929558,1,10
"912351619",9,1795.80423606277,1856.26587460569,0,9
"912351620",5,1599.7257674013,1646.12614877363,1,4
"912351621",5,1603.39266369314,1646.12614877363,1,4
"912351622",4,1509.30334158126,1572.73281143487,0,4
"912351623",2,1361.21281064028,1364.97646362037,0,2
"912351624",8,1737.78049627468,1812.11073017574,1,7
"912351625",9,1807.46309067497,1856.26587460569,0,9
"912351626",10,1815.78197395953,1896.67490607898,0,10
"912351627",10,1812.31377742941,1896.67490607898,0,10
"912351628",9,1789.40064552042,1856.26587460569,2,7
"912351629",6,1628.3683460072,1708.62817714657,1,5
"912351630",3,1467.4077686348,1482.92019466158,0,3
"912351631",6,1658.59939925525,1708.62817714657,2,4
"912351632",12,1787.33153173638,1968.69006049611,2,10
"912351633",12,1808.47763074698,1968.69006049611,1,11
"912351634",9,1738.1286665398,1856.26587460569,1,8
"912351635",9,1734.27818349185,1856.26587460569,1,8
"912351636",17,1991.13038901399,2113.95669457394,3,14
"912351637",17,1832.85790810026,2113.95669457394,3,14
"912351638",18,1775.03414566002,2138.79896507223,4,14
"912351639",17,1885.65323492204,2113.95669457394,3,14
"912351640",14,1943.34411244742,2031.70713799962,2,12
"912351641",13,1916.00897529902,2001.16379457045,1,12
"912351642",16,1906.60572842716,2087.92318348224,3,13
"912351643",11,1832.14504230963,1933.98659929558,1,10
"912351644",5,1548.00811977073,1646.12614877363,1,4
"912351645",7,1696.65936117558,1763.32076508842,1,6
"912351646",6,1704.83773341408,1708.62817714657,0,6
"912351647",5,1557.44383981922,1646.12614877363,1,4
"912351648",17,1926.38323249726,2113.95669457394,3,14
"912351649",23,1933.92394382831,2248.68783741607,4,19
"912351650",19,1885.80121943107,2162.56636020013,3,16
"912351651",13,1852.55250277416,2001.16379457045,1,12
"912351652",6,1624.89231048127,1708.62817714657,0,6
"912351653",11,1869.63857714168,1933.98659929558,3,8
"912351657",9,1593.51159008101,1856.26587460569,2,7
"912351659",12,1665.28415472325,1968.69006049611,1,11
"912351730",40,2531.84998347693,2517.98110851286,12,28
"912351731",26,2553.00021287796,2305.75108410937,7,19
"912351732",22,2349.29627193415,2228.3491786518,7,15
"912351733",13,2184.30851581194,2001.16379457045,1,12
"912351734",31,2616.7030677367,2390.15469389133,8,23
"912351736",47,2700.90810746432,2602.36394728806,14,33
"912351737",49,2797.87669427184,2624.62502504328,17,32
"912351738",23,2039.37865671691,2248.68783741607,8,15
"912351739",24,1995.15630213542,2268.33468283819,7,17
"912351740",19,2034.82330919998,2162.56636020013,5,14
"912351741",20,2129.85640374661,2185.35845629437,7,13
"912351742",30,2270.78453874575,2374.18906024059,9,21
"912351743",35,2136.97315429832,2450.1860183293,12,23
"912351744",43,2356.95440565216,2555.47878346624,13,30
"912351745",61,2442.33646683411,2744.81051624266,16,45
"912351746",33,2440.00981859324,2420.89448855093,9,24
"912351747",54,2789.4064257358,2677.2712016452,17,37
"912351748",55,2574.65113124064,2687.33120998132,16,39
"912351755",48,2939.87203576492,2613.58673801098,16,32
"912351756",56,2768.46687615074,2697.24673169728,16,40
"912351757",53,2997.21005133973,2667.061866114,20,33
"912351758",48,3105.78702815313,2613.58673801098,14,34
"912351762",57,2653.22052630552,2707.02236739438,14,43
"912351763",30,2597.54001250858,2374.18906024059,9,21
"912351764",27,2235.82605506709,2323.60649590586,7,20
"912351765",50,2269.1721773885,2635.48551585152,16,34
"912351766",30,2150.52187280647,2374.18906024059,9,21
"912351767",41,2434.72446149427,2530.72175773865,10,31
"912351768",26,2222.22292106278,2305.75108410937,6,20
"912351769",37,2461.34639875955,2478.17471526668,11,26
"912351770",52,2529.41585585826,2656.6981055205,15,37
"912351771",74,2568.64449336445,2855.36548874306,20,54
"912351776",47,2953.43654876424,2602.36394728806,14,33
"912351784",65,3034.03551845323,2780.67589681985,15,50
"912351785",49,2988.66926645118,2624.62502504328,11,38
"912351786",47,2311.46252892511,2602.36394728806,11,36
"912351787",37,2396.87614965382,2478.17471526668,12,25
"912351798",43,2930.89743833453,2555.47878346624,13,30
"912351799",40,2475.62975065972,2517.98110851286,9,31
"912351800",42,2498.22878809295,2543.21752514954,11,31
"912351801",53,2333.79119375787,2667.061866114,16,37
"912351802",54,2316.03135629482,2677.2712016452,13,41
"912351803",55,2945.98683939032,2687.33120998132,12,43
"912351804",23,2259.27004026192,2248.68783741607,9,14
"912351805",26,1978.45519920941,2305.75108410937,10,16
"912351806",29,2200.48665597036,2357.79423966008,12,17
"912351807",30,2081.17799256926,2374.18906024059,10,20
"912351808",38,2088.89983886363,2491.71993967651,12,26
"912351809",50,2319.31550517376,2635.48551585152,14,36
"912351810",55,2390.04238461505,2687.33120998132,14,41
"912351811",63,2257.27327656919,2762.96971264875,13,50
"912351816",41,2737.8804614517,2530.72175773865,16,25
"912351822",53,3033.37842503969,2667.061866114,21,32
"912351823",52,2089.70228354089,2656.6981055205,10,42
"912351824",44,2102.22427878517,2567.51523707907,8,36
"912351826",53,2221.3898204139,2667.061866114,13,40
"912351827",52,2143.79500368203,2656.6981055205,11,41
"912351833",35,2162.532448663,2450.1860183293,4,31
"912351834",45,2170.95075088287,2579.33597919865,10,35
"912351839",48,2283.01340790482,2613.58673801098,14,34
"912351840",50,2432.95385845047,2635.48551585152,12,38
"912351845",43,2427.36427261257,2555.47878346624,12,31
"912351846",38,2573.12543029636,2491.71993967651,9,29
"912351979",29,1928.77144381874,2357.79423966008,6,23
"912351980",33,2081.81989713091,2420.89448855093,8,25
"912351983",27,2229.5089382942,2323.60649590586,8,19
"912351984",34,2184.69197390591,2435.71163614839,8,26
"912351985",31,2110.16066531416,2390.15469389133,8,23
"912351990",25,2222.35056237279,2287.34065519221,5,20
"912351991",24,2271.6499973914,2268.33468283819,5,19
"912351992",30,1973.56092120528,2374.18906024059,9,21
"912351993",28,2210.28085236799,2340.94327947849,5,23
"912351994",61,3080.76764980874,2744.81051624266,19,42
"912351995",59,2746.47508811037,2726.17127719361,15,44
"912352006",74,3289.71010881941,2855.36548874306,19,55
"912352007",72,3586.49413584352,2839.4193288992,19,53
"912352008",61,3032.55073855899,2744.81051624266,18,43
"912352009",70,2701.75047556066,2823.11677003184,26,44
"912352016",46,2549.34058393215,2590.94954296761,13,33
"912352017",33,2326.34591124862,2420.89448855093,4,29
"912352018",70,3000.06162371758,2823.11677003184,21,49
"912352019",57,2613.70075777584,2707.02236739438,14,43
"912352020",64,2725.25441458314,2771.87783482774,16,48
"912352021",63,3598.23730807635,2762.96971264875,19,44
"912352022",66,2614.29221047763,2789.3669207067,17,49
"912352023",45,2717.18473656597,2579.33597919865,11,34
"912352042",73,3020.78283780739,2847.4358582506,23,50
"912352043",86,2714.37782019219,2944.43562859908,31,55
"912352044",61,3153.32678978432,2744.81051624266,20,41
"912352045",52,3077.14725673897,2656.6981055205,14,38
"912352046",41,2408.2208373863,2530.72175773865,10,31
"912352047",52,2425.92251189172,2656.6981055205,16,36
"912352048",34,2224.90532531798,2435.71163614839,10,24
"912352049",41,2297.27624689219,2530.72175773865,13,28
"912352050",38,2314.1741737507,2491.71993967651,10,28
"912352051",44,2432.45813432744,2567.51523707907,13,31
"912352052",23,1936.24656044161,2248.68783741607,3,20
"912352053",40,2232.43809186272,2517.98110851286,10,30
"912352054",65,2613.19366137282,2780.67589681985,27,38
"912352055",52,2964.93075500466,2656.6981055205,12,40
"912352056",70,2907.7802193711,2823.11677003184,20,50
"912352057",77,2685.01613907958,2878.65357631343,20,57
"912352058",46,2611.28811952422,2590.94954296761,11,35
"912352059",48,2507.70113600942,2613.58673801098,13,35
"912352062",74,3517.58490587953,2855.36548874306,21,53
"912352065",44,2092.41617021343,2567.51523707907,12,32
"912352066",57,2119.62200391829,2707.02236739438,20,37
"912352067",26,2102.25198624334,2305.75108410937,6,20
"912352068",26,2069.94575554246,2305.75108410937,6,20
"912352069",30,2193.87222705622,2374.18906024059,7,23
"912352070",40,2300.60290949423,2517.98110851286,13,27
"912352071",44,2316.54831145579,2567.51523707907,12,32
"912352082",51,2955.54772105356,2646.17454577679,17,34
"912352086",32,2273.26107135874,2405.71569249515,6,26
"912352087",59,2589.16538116305,2726.17127719361,14,45
"912352088",44,2594.76376375205,2567.51523707907,8,36
"912352089",78,2574.75446524187,2886.25582696583,20,58
"912352098",77,3222.97361295344,2878.65357631343,30,47
"912352099",36,2286.09440762883,2464.33502634194,9,27
"912352101",49,2856.84200575279,2624.62502504328,19,30
"912352102",50,3210.23635092183,2635.48551585152,14,36
"912352103",33,2313.18303049659,2420.89448855093,10,23
"912352104",33,2472.1958640256,2420.89448855093,10,23
"912352107",63,2993.59656185396,2762.96971264875,20,43
"912352111",48,2762.66996840518,2613.58673801098,13,35
"912352113",70,3037.92210917816,2823.11677003184,23,47
"912352117",51,2465.16642928167,2646.17454577679,14,37
"912352118",73,2241.29445673722,2847.4358582506,19,54
"912352119",40,2627.67199649878,2517.98110851286,12,28
"912352120",65,2429.45645555046,2780.67589681985,18,47
"912352130",57,2785.61325146909,2707.02236739438,15,42
"912352131",47,2871.88336199241,2602.36394728806,16,31
"912352132",77,3017.45236930784,2878.65357631343,25,52
"912352133",89,3031.78584291614,2965.14449011489,27,62
"912352134",47,2734.58888841779,2602.36394728806,12,35
"912352144",21,1906.85926211364,2207.26116887512,2,19
"912352168",6,1643.63997290097,1708.62817714657,1,5
"912352169",6,1645.58894296431,1708.62817714657,1,5
"912352170",8,1723.16763421459,1812.11073017574,1,7
"912352171",8,1740.06533593602,1812.11073017574,0,8
"912352186",8,1853.33783739668,1812.11073017574,1,7
"912352187",8,1792.2418822832,1812.11073017574,2,6
"912352188",9,1813.31997694568,1856.26587460569,0,9
"912352198",3,1402.91749785247,1482.92019466158,1,2
"912352199",2,1325.52818701253,1364.97646362037,0,2
"912352200",4,1475.45626831831,1572.73281143487,0,4
"912352201",4,1475.45626831831,1572.73281143487,0,4
"912352203",2,1320.33302363889,1364.97646362037,0,2
"912352204",4,1475.45626831831,1572.73281143487,0,4
"912352205",3,1413.53589001467,1482.92019466158,0,3
"912352206",2,1320.33302363889,1364.97646362037,0,2
"912352207",3,1413.53589001467,1482.92019466158,0,3
"912352208",2,1320.33302363889,1364.97646362037,0,2
"912352209",3,1411.75208081779,1482.92019466158,0,3
"912352210",5,1492.71465122832,1646.12614877363,0,5
"912352211",1,1167.42353790325,1184.66451052022,0,1
"912352220",5,1543.31856192444,1646.12614877363,0,5
"912352221",12,1623.47768053252,1968.69006049611,1,11
"912352222",6,1545.71927198838,1708.62817714657,1,5
"912352223",4,1476.72861870387,1572.73281143487,0,4
"912352224",5,1551.9704977642,1646.12614877363,0,5
"912352225",5,1551.9704977642,1646.12614877363,0,5
"912352226",15,1612.74929297097,2060.56118614118,2,13
"912352236",13,1839.47950803388,2001.16379457045,4,9
"912352257",12,1848.94384665926,1968.69006049611,2,10
"912352293",30,2044.80941564724,2374.18906024059,6,24
"912352333",11,1669.53071908427,1933.98659929558,1,10
"912352334",8,1545.39209028669,1812.11073017574,1,7
"912352335",9,1592.25592533908,1856.26587460569,1,8
"912352336",6,1513.996271535,1708.62817714657,1,5
"912352337",8,1663.98453918962,1812.11073017574,2,6
"912352338",7,1613.402242999,1763.32076508842,1,6
"912352339",5,1571.15834356765,1646.12614877363,2,3
"912352340",5,1528.96898711364,1646.12614877363,1,4
"912352347",10,1630.32986583333,1896.67490607898,1,9
"912352348",12,1617.58369954903,1968.69006049611,1,11
"912352353",11,1629.28929774475,1933.98659929558,2,9
"912352354",8,1632.379430238,1812.11073017574,2,6
"912352355",15,1734.06671103037,2060.56118614118,2,13
"912352356",10,1724.52052891795,1896.67490607898,2,8
"912352357",7,1595.81415644322,1763.32076508842,2,5
"912352358",6,1544.70549419127,1708.62817714657,1,5
"912352359",8,1658.80664426356,1812.11073017574,2,6
"912352360",5,1584.97577721975,1646.12614877363,1,4
"912352365",11,1585.29180271329,1933.98659929558,3,8
"912352366",10,1651.02091542646,1896.67490607898,1,9
"912352367",7,1576.06320497746,1763.32076508842,1,6
"912352368",6,1554.03740432107,1708.62817714657,1,5
"912352369",5,1525.90108277957,1646.12614877363,1,4
"912352370",8,1597.251024456,1812.11073017574,1,7
"912352375",9,1651.89440686237,1856.26587460569,1,8
"912352376",7,1640.69810589395,1763.32076508842,1,6
"912352377",7,1641.74594308393,1763.32076508842,1,6
"912352378",8,1590.29852778831,1812.11073017574,1,7
"912352379",7,1585.61028504198,1763.32076508842,1,6
"912352380",12,1729.2544887287,1968.69006049611,2,10
"912352381",10,1618.63886966828,1896.67490607898,1,9
"912352382",7,1665.1518254827,1763.32076508842,1,6
"912352387",9,1647.3169177394,1856.26587460569,2,7
"912352388",9,1713.94458261384,1856.26587460569,1,8
"912352389",12,1698.73532170782,1968.69006049611,0,12
"912352390",4,1487.43818566287,1572.73281143487,1,3
"912352391",7,1638.4406899975,1763.32076508842,0,7
"912352392",8,1605.97232647144,1812.11073017574,1,7
"912352393",4,1510.76568556319,1572.73281143487,1,3
"912352394",10,1722.58590104038,1896.67490607898,0,10
"912352395",2,1317.90000378705,1364.97646362037,0,2
"912352396",3,1385.47466498958,1482.92019466158,1,2
"912352397",2,1348.39882161626,1364.97646362037,0,2
"912352398",2,1344.66647943542,1364.97646362037,0,2
"912352399",8,1606.69590518092,1812.11073017574,0,8
"912352400",5,1507.24043372212,1646.12614877363,0,5
"912352401",4,1457.28263111716,1572.73281143487,0,4
"912352402",6,1552.34300645059,1708.62817714657,2,4
"912352415",8,1589.59365365367,1812.11073017574,1,7
"912352416",8,1636.88393982607,1812.11073017574,0,8
"912352417",8,1683.17718926705,1812.11073017574,1,7
"912352418",8,1693.76838702088,1812.11073017574,0,8
"912352419",2,1324.30096493139,1364.97646362037,0,2
"912352420",7,1599.2380687562,1763.32076508842,1,6
"912352421",9,1663.95813056088,1856.26587460569,1,8
"912352422",7,1627.10153058302,1763.32076508842,1,6
"912352423",8,1552.998591991,1812.11073017574,2,6
"912352424",5,1563.79693491823,1646.12614877363,1,4
"912352425",12,1541.80208386851,1968.69006049611,3,9
"912352426",9,1560.31758885323,1856.26587460569,2,7
"912352427",6,1469.74434197994,1708.62817714657,1,5
"912352428",9,1603.45684029437,1856.26587460569,2,7
"912352429",8,1632.26188912075,1812.11073017574,2,6
"912352430",5,1455.13189286058,1646.12614877363,2,3
"912352431",7,1569.32502975644,1763.32076508842,2,5
"912352432",7,1586.48299751169,1763.32076508842,2,5
"912352433",9,1624.38032783746,1856.26587460569,2,7
"912352434",9,1598.70882870097,1856.26587460569,2,7
"912352435",3,1385.6739462962,1482.92019466158,0,3
"912352436",10,1619.66803494265,1896.67490607898,1,9
"912352437",6,1560.27920001464,1708.62817714657,0,6
"912352438",3,1434.3621351892,1482.92019466158,0,3
"912352439",5,1546.82862770905,1646.12614877363,0,5
"912352440",4,1498.65930405938,1572.73281143487,1,3
"912352441",7,1625.31651027276,1763.32076508842,1,6
"912352442",7,1685.94586163333,1763.32076508842,0,7
"912352443",11,1754.99105375485,1933.98659929558,1,10
"912352444",15,1704.20311370188,2060.56118614118,4,11
"912352445",9,1715.97777983268,1856.26587460569,1,8
"912352446",2,1306.33006493936,1364.97646362037,0,2
"912352481",5,1587.88175170588,1646.12614877363,1,4
