"SurveyID","nb_species","aesthe_survey_pres","aesthe_survey_abund","aesthe_SR_survey","nb_sp_pos_survey","nb_sp_neg_survey"
"10000001",47,1716.3752680204,650.216031657586,2602.36394728806,7,40
"10000002",36,1906.6760346937,1461.38203853899,2464.33502634194,6,30
"10000003",26,1906.88693352526,1689.89760068577,2305.75108410937,7,19
"10000004",22,1794.72974512693,1436.5623307319,2228.3491786518,4,18
"10000006",26,1879.10635074116,1531.58485445616,2305.75108410937,5,21
"10000007",14,1824.62919320877,1687.96686861374,2031.70713799962,2,12
"10000008",11,1839.7204177948,1792.95020634482,1933.98659929558,1,10
"10000009",12,1668.33241852466,1246.51338438794,1968.69006049611,3,9
"10000010",12,1823.64631809646,1620.99474345434,1968.69006049611,2,10
"10000011",17,1825.91576043503,1292.35277980529,2113.95669457394,2,15
"10000012",14,1828.86351035815,1613.2072000376,2031.70713799962,3,11
"10000013",28,1975.45302094827,1581.58353218268,2340.94327947849,5,23
"10000014",34,1905.4196025513,1562.54502451919,2435.71163614839,6,28
"10000015",24,1860.80866207597,1529.57614956021,2268.33468283819,6,18
"10000016",17,1694.11234350228,1351.72982271166,2113.95669457394,3,14
"10000017",24,1953.86612760003,1656.65579431437,2268.33468283819,4,20
"10000018",24,1860.48219808173,1457.33643700985,2268.33468283819,4,20
"10000019",22,2029.0387647882,1940.08243940734,2228.3491786518,6,16
"10000020",35,2000.29842930584,1685.23809357635,2450.1860183293,6,29
"10000021",23,1942.1481174765,1257.14609902727,2248.68783741607,4,19
"10000022",31,1998.07090284555,1330.62152379013,2390.15469389133,7,24
"10000023",23,1935.86858041663,1143.46144895602,2248.68783741607,4,19
"10000024",22,1892.03698802097,1457.10193636508,2228.3491786518,6,16
"10000025",23,1901.17214329471,1065.06695054845,2248.68783741607,5,18
"10000026",33,1895.03822870217,990.500645247743,2420.89448855093,9,24
"10000027",34,1879.33032608048,1538.32670646258,2435.71163614839,4,30
"10000028",27,1863.79393150102,1253.95938152253,2323.60649590586,4,23
"10000029",33,1828.62006918989,1733.11036448863,2420.89448855093,7,26
"10000030",27,2087.80410690636,2048.20697225924,2323.60649590586,9,18
"10000031",28,1989.37828008576,1511.7505442305,2340.94327947849,7,21
"10000032",30,1976.34049782605,1316.81907988627,2374.18906024059,7,23
"10000033",30,1985.75621545174,1401.78534932939,2374.18906024059,6,24
"10000034",25,1912.89309755213,1557.61652260499,2287.34065519221,6,19
"10000035",22,1949.56424095665,1580.40377182182,2228.3491786518,5,17
"10000036",32,1981.83733764749,1615.06002995718,2405.71569249515,5,27
"10000038",33,1736.30305849466,1199.50103277678,2420.89448855093,5,28
"10000039",25,1952.45859773346,1350.46812235204,2287.34065519221,4,21
"10000040",30,1758.5196459306,1129.2505249142,2374.18906024059,6,24
"10000041",28,2060.1337880786,1786.72920783067,2340.94327947849,6,22
"10000042",20,1885.64703641527,1366.85517918216,2185.35845629437,8,12
"10000043",25,2002.90762519614,1392.91844144471,2287.34065519221,7,18
"10000044",16,1957.22880360216,1950.3516087455,2087.92318348224,3,13
"10000045",23,1930.01258006597,1558.39922266283,2248.68783741607,3,20
"10000046",20,1958.99932733398,1806.16268990535,2185.35845629437,6,14
"10000047",21,1986.12262453953,1620.42830213901,2207.26116887512,5,16
"10000048",20,2047.31721678014,1869.71794365917,2185.35845629437,5,15
"10000049",23,2073.83605001639,2062.33886607701,2248.68783741607,7,16
"10000050",22,2122.39911426602,2146.75477883657,2228.3491786518,6,16
"10000051",28,2126.26507366973,1746.94614558397,2340.94327947849,6,22
"10000052",22,2056.34548619379,1552.81628389807,2228.3491786518,3,19
"10000053",20,2000.15677049362,1959.63749057316,2185.35845629437,5,15
"10000054",19,1896.64386047544,1614.93915660399,2162.56636020013,4,15
"10000055",23,2014.62924219693,1967.26501001658,2248.68783741607,5,18
"10000056",27,1904.82266212284,1325.20832352644,2323.60649590586,7,20
"10000057",26,1954.86683162799,1992.6020083885,2305.75108410937,6,20
"10000058",23,2047.54958739718,1900.09081319251,2248.68783741607,6,17
"10000059",19,1996.66714526275,1692.60237869091,2162.56636020013,5,14
"10000060",46,1944.68196837183,1767.10527439737,2590.94954296761,14,32
"10000061",30,2015.5307683192,2166.64882488282,2374.18906024059,5,25
"10000062",48,1908.24439778612,1595.45845989835,2613.58673801098,14,34
"10000063",39,1859.23233863237,1432.46196788923,2504.98447234734,12,27
"10000064",13,1950.26066598413,1981.00741994591,2001.16379457045,2,11
"10000065",27,2273.43349117556,2379.83415833593,2323.60649590586,6,21
"10000066",27,1979.63369229289,1740.77725571323,2323.60649590586,9,18
"10000067",25,2045.88601180584,1907.47314759291,2287.34065519221,6,19
"10000068",38,1961.62446915845,1725.48727759824,2491.71993967651,8,30
"10000069",31,1982.43583049537,1478.84932175123,2390.15469389133,6,25
"10000070",33,2065.19687538944,1873.51764644065,2420.89448855093,8,25
"10000071",21,1906.62024201561,1615.92357583054,2207.26116887512,2,19
"10000072",22,1887.22438930971,1478.40077577083,2228.3491786518,4,18
"10000073",27,1951.84715774092,1590.69609639093,2323.60649590586,6,21
"10000074",23,1840.13662229405,1479.10570662527,2248.68783741607,4,19
"10000075",25,1940.55019604883,1706.00555481153,2287.34065519221,6,19
"10000076",29,2303.81011508469,1998.03247813161,2357.79423966008,8,21
"1003253",7,1559.8151853441,1243.71247177087,1763.32076508842,0,7
"1003254",13,1663.62695009119,1468.57525085336,2001.16379457045,0,13
"1003255",11,1640.36749544789,1362.50223507407,1933.98659929558,1,10
"1003256",9,1599.30197343925,1386.09261301471,1856.26587460569,0,9
"1003257",14,1634.03090222011,1256.19340731618,2031.70713799962,0,14
"1003258",14,1652.11556309622,1301.2120654185,2031.70713799962,1,13
"1003259",6,1522.38740446081,1309.82661895057,1708.62817714657,0,6
"1003260",1,1150.67276488192,1025.29167742908,1184.66451052022,1,0
"1003261",1,1150.67276488192,1160.99818604003,1184.66451052022,1,0
"1003262",1,1150.67276488192,1101.98923201365,1184.66451052022,1,0
"1003263",15,1593.82620679338,1290.7906565139,2060.56118614118,0,15
"1003264",8,1655.03112680806,1572.13151232634,1812.11073017574,1,7
"1003265",14,1628.7471848617,1423.79558125338,2031.70713799962,0,14
"1003266",15,1656.95688222986,1284.59323614825,2060.56118614118,0,15
"1003267",17,1684.78242192917,1260.54226915399,2113.95669457394,0,17
"1003268",12,1632.78388073325,1255.6288507522,1968.69006049611,0,12
"1003269",16,1674.21679900608,1378.01213064385,2087.92318348224,1,15
"1003270",10,1633.2476523296,1498.61038844342,1896.67490607898,2,8
"1003271",15,1582.61238885653,1211.39520670068,2060.56118614118,0,15
"1003272",10,1674.62376777482,1429.60386528009,1896.67490607898,2,8
"1003273",6,1575.89362503288,1358.89768568684,1708.62817714657,1,5
"1003274",6,1603.32514092396,1519.03093043537,1708.62817714657,2,4
"1003275",5,1580.49112338288,1518.77135667799,1646.12614877363,1,4
"1003276",7,1596.2473738543,1377.00811317488,1763.32076508842,1,6
"1003277",3,1387.60699582282,1384.2776428377,1482.92019466158,1,2
"1003278",39,2599.42314243449,2593.96135714784,2504.98447234734,8,31
"1003280",35,2516.49181799662,2344.68971701359,2450.1860183293,11,24
"1003281",28,2351.62397354974,2157.18214538319,2340.94327947849,6,22
"1003282",29,2464.4883646079,2355.20266603934,2357.79423966008,7,22
"1003283",32,2364.8507817237,2153.74321553444,2405.71569249515,7,25
"1003284",35,2532.97864671476,2611.36930007126,2450.1860183293,9,26
"1003285",35,2530.87691459948,2410.0274214715,2450.1860183293,6,29
"1003286",42,2557.54060457247,2387.87876980468,2543.21752514954,9,33
"1003287",35,2400.7629484452,2317.2002566644,2450.1860183293,8,27
"1003288",47,2784.98042378518,2752.24117157814,2602.36394728806,11,36
"1003289",33,2413.63770571857,2305.18628724813,2420.89448855093,8,25
"1003290",8,1667.45946380247,1516.15915000547,1812.11073017574,1,7
"1003291",34,2561.13719572092,2936.18078856014,2435.71163614839,5,29
"1003292",33,2533.97804565574,2362.1833649304,2420.89448855093,11,22
"1003629",33,2569.58938349731,2677.54727357372,2420.89448855093,9,24
"1003630",21,2243.91064218312,2392.4778087982,2207.26116887512,4,17
"1003631",28,2364.61648982158,2734.54962257901,2340.94327947849,7,21
"1003632",19,2139.88571142237,2413.62197734981,2162.56636020013,5,14
"1003633",34,2368.88365902195,2305.65635097987,2435.71163614839,7,27
"1003634",33,2309.28114110992,2141.86221833895,2420.89448855093,7,26
"1003635",28,2447.20059263555,2137.03173242287,2340.94327947849,5,23
"1003636",38,2340.06429993657,2206.90170981944,2491.71993967651,4,34
"1003637",33,2415.25867162178,2749.45149507925,2420.89448855093,5,28
"1003638",28,2348.87319718083,2700.6142411239,2340.94327947849,5,23
"1003639",31,2344.15793606863,2953.76987691809,2390.15469389133,6,25
"1003640",34,2437.06780045695,2499.5824778203,2435.71163614839,5,29
"1003641",30,2340.80328626336,2329.59365752132,2374.18906024059,5,25
"1003642",42,2499.51114830787,2694.11160440951,2543.21752514954,6,36
"1003643",37,2306.47154307044,2396.42642295739,2478.17471526668,6,31
"1003644",29,2232.23818748268,2549.59635590845,2357.79423966008,5,24
"1003645",28,2418.81128723172,2655.74271606891,2340.94327947849,5,23
"1003646",37,2396.50421975434,1720.92435785049,2478.17471526668,10,27
"1003647",35,2290.96102130184,1860.59008746348,2450.1860183293,5,30
"1003648",35,2294.50371235196,2244.05960103313,2450.1860183293,7,28
"1003649",36,2363.75167225217,1790.03990068694,2464.33502634194,8,28
"1003650",37,2416.61061153113,2428.05166220258,2478.17471526668,6,31
"1003651",36,2159.70793735488,2547.89721216479,2464.33502634194,4,32
"1003652",31,2463.04104872067,2985.07703387749,2390.15469389133,6,25
"1003653",28,2354.30354670168,2682.78467520489,2340.94327947849,5,23
"1003654",26,2558.94586740275,3087.86377074501,2305.75108410937,6,20
"1003655",23,2348.3300380793,2669.89538878165,2248.68783741607,4,19
"1003656",20,2284.70853147766,2488.18003291694,2185.35845629437,3,17
"1003657",20,2251.54287482032,2472.2344515784,2185.35845629437,2,18
"1003659",23,2458.50749482836,2600.49818388926,2248.68783741607,5,18
"1003660",25,2498.41922398817,2755.63351109446,2287.34065519221,6,19
"1003661",30,2583.69920239004,2646.55317143145,2374.18906024059,6,24
"1003662",29,2594.25524156462,3111.767589469,2357.79423966008,5,24
"1003663",28,2572.62780966433,3557.12591575516,2340.94327947849,4,24
"1003664",28,2469.94837409552,2765.76537490794,2340.94327947849,6,22
"1003665",31,2451.73225172032,2460.12108088264,2390.15469389133,5,26
"1003666",36,2471.22942971928,2966.32533430309,2464.33502634194,8,28
"1003667",39,2548.59281446504,2425.81152304255,2504.98447234734,8,31
"1003668",29,2555.36773762609,2951.84652958825,2357.79423966008,7,22
"1003669",35,2731.92288603869,2971.37372012113,2450.1860183293,11,24
"1003670",36,2412.44322316614,2761.55745589762,2464.33502634194,7,29
"1003671",28,2525.40713342215,2980.12744592969,2340.94327947849,4,24
"1003672",32,2379.26235170032,2808.55949900683,2405.71569249515,5,27
"1003673",35,2566.58484109583,2680.43922368677,2450.1860183293,7,28
"1003674",34,2465.04383976526,2442.96480184461,2435.71163614839,8,26
"1003675",44,2567.87607010656,2375.04760267798,2567.51523707907,9,35
"1003676",34,2508.91967784241,2704.94647810307,2435.71163614839,8,26
"1003677",37,2515.61435022753,2712.47976801594,2478.17471526668,7,30
"1003678",36,2298.04441962733,2321.39455655121,2464.33502634194,5,31
"1003679",42,2600.64532284612,2539.56713224526,2543.21752514954,10,32
"1003680",43,2469.95236639491,2065.38622971842,2555.47878346624,8,35
"1003681",23,2459.84235153874,2553.18063777931,2248.68783741607,5,18
"1003682",34,2708.38651033587,2707.63299341062,2435.71163614839,9,25
"1003683",34,2573.53848724014,2855.4459369831,2435.71163614839,7,27
"1003684",41,2616.75683716736,2830.78556679622,2530.72175773865,9,32
"1003685",35,2633.70937054913,2895.70597023904,2450.1860183293,7,28
"1003686",33,2685.55709691865,3427.07261519831,2420.89448855093,6,27
"1003687",27,2451.9053672332,2508.81892985803,2323.60649590586,6,21
"1003688",38,2669.44695471947,2774.05181240363,2491.71993967651,9,29
"1003689",31,2354.62396032077,2359.70716571983,2390.15469389133,8,23
"1003690",34,2544.40650557153,2865.96930034245,2435.71163614839,8,26
"1003691",24,2369.30234801728,2501.00240490365,2268.33468283819,4,20
"1003692",29,2353.49558423624,2207.19322049762,2357.79423966008,4,25
"1003693",28,2132.40321025858,2309.66980435008,2340.94327947849,3,25
"1003694",30,2504.55563112695,2940.32032232352,2374.18906024059,7,23
"1003695",31,2582.51426934081,3432.50675260249,2390.15469389133,8,23
"1003696",28,2568.5430301636,2716.46300775509,2340.94327947849,7,21
"1003697",29,2358.97324963464,2865.7285213028,2357.79423966008,6,23
"1003698",34,2528.93356846857,2946.3720477778,2435.71163614839,6,28
"1003699",31,2300.40549794101,2858.50384279877,2390.15469389133,8,23
"1003745",8,1555.2193063325,1230.50780454797,1812.11073017574,0,8
"1003746",12,1719.0115442953,1649.17811879899,1968.69006049611,0,12
"1003747",7,1610.203008296,1449.27146391782,1763.32076508842,0,7
"1003748",14,1644.88365890905,1326.47950131763,2031.70713799962,0,14
"1003749",13,1632.24842566319,1390.77562814139,2001.16379457045,0,13
"1003750",9,1576.27803850556,1227.39559324684,1856.26587460569,0,9
"1003752",18,1668.29782620052,1246.61360038131,2138.79896507223,0,18
"1003753",9,1624.51221922217,1381.9685376236,1856.26587460569,0,9
"1003754",8,1644.51914432814,1334.69202989091,1812.11073017574,0,8
"1003755",7,1544.87819161923,1381.21771895225,1763.32076508842,0,7
"1003756",1,1150.67276488192,1029.55590666055,1184.66451052022,1,0
"1003759",13,1714.39443232687,1360.34836740841,2001.16379457045,0,13
"1003760",10,1640.50834838406,1542.81263087775,1896.67490607898,1,9
"1003761",11,1615.9415287469,1361.13445376859,1933.98659929558,0,11
"1003762",15,1689.7809688184,1291.06232720146,2060.56118614118,1,14
"1003763",19,1660.50749246251,1330.76968351032,2162.56636020013,1,18
"1003764",11,1674.05533716266,1317.52654047685,1933.98659929558,0,11
"1003765",16,1651.59378274374,1170.92192469603,2087.92318348224,1,15
"1003766",18,1762.30976051701,1445.44864424878,2138.79896507223,0,18
"1003767",13,1704.78268323471,1512.22644775973,2001.16379457045,0,13
"1003768",10,1726.29097995115,1471.90714156252,1896.67490607898,0,10
"1003769",16,1703.00806198894,1288.21412012742,2087.92318348224,0,16
"1003770",19,1656.65561537282,1333.60700272318,2162.56636020013,0,19
"1003771",12,1627.87928973119,1341.33513782125,1968.69006049611,0,12
"1003772",7,1616.65356014194,1436.43853883176,1763.32076508842,2,5
"1003773",7,1610.91176393372,1376.6556665823,1763.32076508842,2,5
"1003774",5,1570.12035788643,1524.97594407382,1646.12614877363,2,3
"1003775",8,1588.02382636428,1169.82962797473,1812.11073017574,2,6
"1003776",2,1279.14294090708,1316.55622247663,1364.97646362037,2,0
"1003777",52,2442.17210291609,1889.75918236275,2656.6981055205,14,38
"1003778",55,2331.3458252082,1847.30582223099,2687.33120998132,15,40
"1003780",22,2301.32626332581,2102.86371747259,2228.3491786518,5,17
"1003781",28,2412.2425624265,2199.4168243752,2340.94327947849,7,21
"1003782",35,2741.58832982261,2598.14073493825,2450.1860183293,7,28
"1003783",30,2602.70317597014,2674.60436875852,2374.18906024059,9,21
"1003784",46,2393.8729028374,2131.28502338935,2590.94954296761,10,36
"1003785",42,2495.59110687558,2245.49393900356,2543.21752514954,12,30
"1003786",43,2578.96652662051,2233.32615075124,2555.47878346624,12,31
"1003787",32,2604.41244072265,2553.86537611415,2405.71569249515,11,21
"1003788",5,1578.7823856886,1477.47804494975,1646.12614877363,1,4
"1003793",49,2531.28689088782,1906.13727721653,2624.62502504328,13,36
"20003005",45,3186.43387128054,3521.60869524354,2579.33597919865,9,36
"20003006",51,3072.64764889739,3206.61826438646,2646.17454577679,10,41
"20003007",55,3373.87316682006,3237.56590728634,2687.33120998132,15,40
"20003008",49,3013.98362530378,3300.59492334254,2624.62502504328,11,38
"20003009",52,3506.59939398533,3547.80748769878,2656.6981055205,12,40
"20003010",54,3069.45363885355,3303.41025152185,2677.2712016452,12,42
"20003011",48,2910.54347426911,2779.99917319611,2613.58673801098,14,34
"20003012",57,3324.46931507967,2885.91071049482,2707.02236739438,11,46
"20003013",55,3273.83703416461,3463.24759473809,2687.33120998132,17,38
"20003014",75,3023.36654893458,3997.57337969592,2863.21031780169,19,56
"20003015",52,3291.03247083176,3517.94608714888,2656.6981055205,11,41
"20003016",53,3360.76510014607,3460.80652631287,2667.061866114,10,43
"20003017",41,2808.85927766438,2551.32700841106,2530.72175773865,10,31
"2000855",12,1831.03960630198,1674.00550514865,1968.69006049611,3,9
"2000856",15,1813.20415837695,1659.43023934817,2060.56118614118,2,13
"2000859",16,1885.32541407951,1643.01244318111,2087.92318348224,2,14
"2000860",15,1925.24658567902,1679.48774724797,2060.56118614118,5,10
"2000861",20,1839.85587597545,1388.61837142539,2185.35845629437,5,15
"2000862",23,1911.32549178039,1870.16480761282,2248.68783741607,8,15
"2000877",22,2091.11808674225,1981.10555782957,2228.3491786518,9,13
"2000883",16,1961.73663836444,1855.32237458633,2087.92318348224,5,11
"2000884",20,1956.7759654094,1942.36259511224,2185.35845629437,5,15
"2000886",9,1808.72217379731,1835.78633468756,1856.26587460569,4,5
"2000892",13,1986.32043731387,2066.06182727361,2001.16379457045,6,7
"2000907",21,1931.91384231554,1651.90933296129,2207.26116887512,7,14
"2000908",17,1859.50053368309,1254.1548722971,2113.95669457394,3,14
"2000923",14,1915.80915255643,1867.25559382999,2031.70713799962,3,11
"2000924",21,1793.5235720677,1882.68270224387,2207.26116887512,4,17
"2000925",20,1950.15137685518,2002.07269081344,2185.35845629437,6,14
"2000926",11,1872.83356928338,1707.2992060679,1933.98659929558,3,8
"2000927",17,1858.25477215727,1657.72495052538,2113.95669457394,4,13
"2000932",15,1962.85710799761,1778.73636853159,2060.56118614118,5,10
"2000937",22,1980.97148562706,2142.4143260603,2228.3491786518,8,14
"2000938",25,2295.68704055153,2351.74157217532,2287.34065519221,11,14
"2000939",17,2047.82054089468,2211.38673216048,2113.95669457394,8,9
"2000944",27,1927.91477784173,1870.41299356275,2323.60649590586,6,21
"2000947",39,2181.48333248281,2001.58410577686,2504.98447234734,12,27
"2000948",24,1960.02367839135,1957.74716625674,2268.33468283819,8,16
"2000949",47,2441.19446212598,2378.35071547046,2602.36394728806,15,32
"2000950",26,1837.02411918363,1383.81641807656,2305.75108410937,6,20
"2000951",24,1905.28207417844,1777.27880941354,2268.33468283819,3,21
"2000956",2,1320.74005598694,1178.4160261532,1364.97646362037,0,2
"2000962",18,2184.93732239914,2217.11019921157,2138.79896507223,7,11
"2000967",23,1936.70370196604,1341.07040972798,2248.68783741607,2,21
"2000968",22,1862.13665035943,1400.29633235974,2228.3491786518,6,16
"2000969",20,1882.34071302714,1492.8976740732,2185.35845629437,4,16
"2000970",24,1866.27201812582,1491.09536309912,2268.33468283819,1,23
"2000971",27,1816.90813071676,1405.01767859938,2323.60649590586,5,22
"2000972",21,1981.16842600969,1452.26235015859,2207.26116887512,4,17
"2000973",25,1912.92233517524,1479.74785982675,2287.34065519221,5,20
"2000977",18,1892.90198525689,1749.76951280234,2138.79896507223,5,13
"2000982",16,1971.57074229864,1753.3222871387,2087.92318348224,5,11
"2000999",18,1824.60913258601,1461.25575634458,2138.79896507223,4,14
"2001010",11,1867.03475393615,1826.11030295646,1933.98659929558,3,8
"2001011",15,1978.72531097672,2006.98554758911,2060.56118614118,4,11
"2001012",12,1926.62588863135,1924.98115292259,1968.69006049611,1,11
"2001021",22,1932.53238929216,1494.46280660631,2228.3491786518,5,17
"2001034",17,1847.0655374609,1517.56266600869,2113.95669457394,3,14
"2001035",15,1973.08048490353,1753.97830886315,2060.56118614118,2,13
"2001036",19,1966.24668590229,2092.42277657368,2162.56636020013,4,15
"2001037",28,2040.40865008721,1880.40143669154,2340.94327947849,10,18
"2001038",8,1704.08108851868,1548.94665804139,1812.11073017574,1,7
"2001039",7,1634.21870336394,1644.5784333672,1763.32076508842,1,6
"2001040",6,1537.05891325745,1381.16710582923,1708.62817714657,1,5
"2001086",16,1918.90369153943,1469.89549465236,2087.92318348224,3,13
"2001087",20,1920.08619398628,1550.6832272338,2185.35845629437,4,16
"2001099",13,1907.22195579225,1860.84168673792,2001.16379457045,1,12
"2001100",18,1826.79649046997,1751.21119210878,2138.79896507223,4,14
"2001101",8,1731.2391612929,1729.87519901392,1812.11073017574,2,6
"2001102",10,1764.27935178657,1879.79600649512,1896.67490607898,1,9
"2001107",20,1802.7711246854,1201.63196888868,2185.35845629437,4,16
"2001109",12,1802.65277764057,1651.36548465337,1968.69006049611,4,8
"2001110",22,1987.77503741329,1673.96805309819,2228.3491786518,7,15
"2001112",19,2038.58924122488,1877.32395080411,2162.56636020013,5,14
"2001113",16,1902.89061191258,1753.68810290787,2087.92318348224,4,12
"2001114",12,1792.19564364168,1749.87899958805,1968.69006049611,3,9
"2001115",17,1835.72627233996,1501.88476110537,2113.95669457394,5,12
"2001118",12,1866.83491617615,1571.16537034258,1968.69006049611,0,12
"2001119",23,1904.14498857156,1514.99746247666,2248.68783741607,4,19
"2001120",20,1895.42677757028,1585.88107076583,2185.35845629437,4,16
"2001121",18,1904.38356042023,1870.42945677092,2138.79896507223,4,14
"2001122",17,2020.69974896713,1707.73206658364,2113.95669457394,3,14
"2001129",15,1802.74862510933,1566.93987322887,2060.56118614118,2,13
"2001130",33,2091.61553673422,1826.00006424265,2420.89448855093,9,24
"2001131",29,2079.24296955353,1822.13165976376,2357.79423966008,7,22
"2001132",23,1943.04925811097,1456.06621705154,2248.68783741607,4,19
"2001143",26,2066.85953928684,1899.6816333077,2305.75108410937,9,17
"2001144",24,2282.56542902973,2122.58319911956,2268.33468283819,8,16
"2001162",17,1776.28675130636,1202.2887662866,2113.95669457394,4,13
"2001163",16,1911.50756969215,1765.5294427271,2087.92318348224,3,13
"2001164",19,1956.73679855625,1600.79140116984,2162.56636020013,4,15
"2001166",21,1710.74565676339,1198.43402337961,2207.26116887512,6,15
"2001167",24,1764.25642949754,1271.81704919972,2268.33468283819,10,14
"2001186",18,1781.64389132971,1238.4110413112,2138.79896507223,4,14
"2001187",14,1785.11832420549,1548.85665828202,2031.70713799962,1,13
"2001188",15,1804.25484036846,1755.98477067516,2060.56118614118,3,12
"2001189",9,1832.73981604943,1734.17731628789,1856.26587460569,1,8
"2001190",18,1846.04651827023,1855.4030782536,2138.79896507223,4,14
"2001191",14,1920.20904931445,1796.76244816883,2031.70713799962,2,12
"2001199",15,1924.13571869179,1883.10205931731,2060.56118614118,4,11
"2001200",14,1850.50775223354,1833.28321181757,2031.70713799962,2,12
"2001202",14,1941.80852968028,1672.25829632896,2031.70713799962,3,11
"2001208",9,1855.21829699257,1602.1434919915,1856.26587460569,2,7
"2001209",13,1800.13685281988,1499.22704392473,2001.16379457045,4,9
"2001232",24,2091.40120421489,1731.22577245585,2268.33468283819,6,18
"2001233",15,1773.50850471466,1782.63383457321,2060.56118614118,4,11
"2001234",18,1831.00028919844,1492.53035817326,2138.79896507223,3,15
"2001239",14,2002.6015465889,1990.99952554468,2031.70713799962,3,11
"2001240",29,1973.99054985728,1579.53122146605,2357.79423966008,8,21
"2001241",24,2155.0447317375,1966.40463279518,2268.33468283819,7,17
"2001247",12,1711.74987339218,1642.75050149804,1968.69006049611,2,10
"2001249",5,1492.31423629774,1355.31689966348,1646.12614877363,1,4
"2001250",20,1906.34830294643,1732.3262217059,2185.35845629437,5,15
"2001251",16,1965.16370319245,1955.05898656555,2087.92318348224,4,12
"2001252",11,1877.69812189983,1778.38375737687,1933.98659929558,3,8
"2001253",16,1940.72844015682,1666.90856760966,2087.92318348224,3,13
"2001254",16,1942.0374957135,1859.70510080292,2087.92318348224,3,13
"2001255",20,1962.65901380381,1814.78709789845,2185.35845629437,6,14
"2001256",21,1866.37172596229,1613.36115417639,2207.26116887512,5,16
"2001257",13,1921.64243216003,1711.6076501705,2001.16379457045,2,11
"2001258",29,2031.45284430728,1700.44338980917,2357.79423966008,4,25
"2001273",38,2034.31240528003,1346.42382296276,2491.71993967651,7,31
"2001274",18,1963.74824071913,1591.91204328043,2138.79896507223,6,12
"2001284",14,1963.83757674651,1620.3245226993,2031.70713799962,4,10
"2001285",12,1844.36819098565,1680.03877556346,1968.69006049611,2,10
"2001286",20,2018.18095130494,1721.83943037112,2185.35845629437,4,16
"2001289",26,1840.32872512475,1069.28372104381,2305.75108410937,4,22
"2001293",14,1785.03923789584,1519.98450982821,2031.70713799962,4,10
"2001307",25,2010.27010872025,1722.66642277391,2287.34065519221,5,20
"2001309",13,1843.2247145412,1713.27363219727,2001.16379457045,5,8
"2001310",17,1956.83489617104,2021.43889550263,2113.95669457394,6,11
"2001320",19,1923.32226262056,2036.71473806521,2162.56636020013,5,14
"2001351",27,1896.8746423047,1603.13699752647,2323.60649590586,4,23
"2001354",27,1974.37900785198,1738.9935371099,2323.60649590586,5,22
"2001355",25,1903.48112731767,1400.57404101713,2287.34065519221,4,21
"2001379",13,1841.07346493372,1457.95852709498,2001.16379457045,2,11
"2001396",8,1777.11608026464,1799.73979072055,1812.11073017574,2,6
"2001397",11,1801.48022781902,1730.73223776693,1933.98659929558,3,8
"2001398",61,2434.05252251878,2128.96871272599,2744.81051624266,18,43
"2001399",57,2456.1716052801,2123.92388480739,2707.02236739438,16,41
"2001400",47,2080.79476198508,1571.36326214114,2602.36394728806,14,33
"2001401",43,2216.2642413607,1648.28506596303,2555.47878346624,10,33
"2001402",11,1687.50460105239,1257.84037714241,1933.98659929558,2,9
"2001403",28,2015.57992470422,1770.91858157959,2340.94327947849,6,22
"2001406",23,1865.9620455936,1157.19409639311,2248.68783741607,4,19
"2001407",16,1936.26575977255,1586.51317863769,2087.92318348224,2,14
"2001408",20,1781.27205268579,924.166157548905,2185.35845629437,5,15
"2001409",20,1809.29772620175,1345.84174044019,2185.35845629437,5,15
"2001410",10,1678.09617102621,1317.57591821001,1896.67490607898,1,9
"2001411",20,1873.51207263471,1632.43576617569,2185.35845629437,5,15
"2001412",17,1953.77539188561,1824.86797661355,2113.95669457394,3,14
"2001413",17,1852.6788385735,1917.75243657577,2113.95669457394,2,15
"2001414",23,1789.75723947415,1403.75618593283,2248.68783741607,6,17
"2001415",25,1776.93756025582,1557.94336250772,2287.34065519221,6,19
"2001416",18,1812.95229972292,1719.61886623458,2138.79896507223,4,14
"2001417",13,1814.98091175983,1900.10612720774,2001.16379457045,4,9
"2001418",17,1771.36685691595,1604.17492452992,2113.95669457394,5,12
"2001419",12,1850.16451092533,1910.3893779655,1968.69006049611,1,11
"2001420",16,1815.07254733102,1744.80892485256,2087.92318348224,4,12
"2001421",15,1812.2888951688,1786.33446992463,2060.56118614118,3,12
"2001422",14,1867.80232175168,1752.80499233505,2031.70713799962,4,10
"2001423",18,1831.80939523932,1833.3106449371,2138.79896507223,4,14
"2001424",15,1813.79008273168,1992.32598501974,2060.56118614118,3,12
"2001425",9,1794.13160159059,1785.01905020643,1856.26587460569,2,7
"2001426",19,1942.85327581198,1931.02205373366,2162.56636020013,4,15
"2001427",8,1710.83846531384,1597.35986389792,1812.11073017574,1,7
"2001428",13,1896.02273372482,1957.31089126339,2001.16379457045,2,11
"2001429",10,1833.779687209,1790.6656130222,1896.67490607898,2,8
"2001430",19,2040.98673798613,1729.94158189741,2162.56636020013,3,16
"2001431",15,1961.37777154069,1873.45240437313,2060.56118614118,4,11
"2001432",19,1939.23254879587,1827.85191963978,2162.56636020013,5,14
"2001433",12,1980.47847002273,1926.07871910288,1968.69006049611,2,10
"2001434",23,1913.27409047008,1624.4273173873,2248.68783741607,6,17
"2001435",22,1854.72523615295,1456.40889807914,2228.3491786518,6,16
"2001436",10,1776.73113844324,1844.53321408403,1896.67490607898,4,6
"2001437",16,1837.86373635055,1764.91940726899,2087.92318348224,4,12
"2001438",14,1805.27953729213,1665.35113804487,2031.70713799962,4,10
"2001439",19,1905.85454682454,1970.84361649244,2162.56636020013,5,14
"2001440",14,1813.116441619,1658.28265773497,2031.70713799962,1,13
"2001441",24,1887.33042314332,1583.53749647244,2268.33468283819,7,17
"2001442",13,1878.95990029042,1835.83964570183,2001.16379457045,4,9
"2001443",18,1863.30366726107,1594.27368830924,2138.79896507223,5,13
"2001444",17,1756.67551939503,1810.39432953463,2113.95669457394,2,15
"2001459",14,1755.13541718875,1601.70895910468,2031.70713799962,2,12
"2001460",17,1942.95169415543,1842.47892012299,2113.95669457394,4,13
"2001470",25,1934.15775435383,1377.38635386658,2287.34065519221,6,19
"2001471",21,1876.53715825612,1333.37722477792,2207.26116887512,3,18
"2001472",27,1889.12571202857,1453.75330564705,2323.60649590586,7,20
"2001473",30,1894.66954708478,1404.01374213282,2374.18906024059,8,22
"2001478",26,2190.04335960192,1708.9437849768,2305.75108410937,5,21
"2001479",27,1941.09643178342,1406.20323544793,2323.60649590586,7,20
"2001480",31,2014.81642206637,1640.63606775565,2390.15469389133,8,23
"2001481",28,2082.44956430574,1725.19901355703,2340.94327947849,9,19
"2001482",25,1982.3043726294,1855.94238944587,2287.34065519221,9,16
"2001483",32,2068.77504652635,1707.40962189968,2405.71569249515,9,23
"2001484",43,1976.44464514204,1559.48192172647,2555.47878346624,11,32
"2001485",44,1940.95371263681,1014.13178089501,2567.51523707907,12,32
"2001517",32,1873.13520527403,1398.42285003984,2405.71569249515,9,23
"2001518",24,2139.33909681163,1821.18249477972,2268.33468283819,5,19
"2001519",22,1963.40331813004,1425.25831407478,2228.3491786518,5,17
"2001520",17,1820.86006614489,1498.24859082789,2113.95669457394,5,12
"2001546",13,1924.56025090571,1908.05369868189,2001.16379457045,4,9
"2001547",22,2112.86883538868,1911.03764517962,2228.3491786518,6,16
"2001548",12,1813.20974292719,1753.19929981582,1968.69006049611,2,10
"2001549",23,1809.9062595943,1484.17316914037,2248.68783741607,3,20
"2001562",33,2038.03765938189,1683.92393758476,2420.89448855093,5,28
"2001579",21,1909.22079047134,1895.36465348189,2207.26116887512,7,14
"2001580",15,1946.85743126169,1889.97031084712,2060.56118614118,5,10
"2001581",20,1971.72426277529,1757.6020951551,2185.35845629437,6,14
"2001582",18,2000.95876194884,1976.33679025156,2138.79896507223,3,15
"2001585",22,1973.2551281356,1702.06408524395,2228.3491786518,4,18
"2001588",12,1809.8999038729,1617.89374376698,1968.69006049611,2,10
"2001589",17,2340.19827495477,2520.0459254607,2113.95669457394,7,10
"2001590",28,1848.92638826454,1772.00762939165,2340.94327947849,6,22
"2001591",8,1755.0049988198,1713.01383104423,1812.11073017574,5,3
"2001749",19,2103.6480966006,1810.75884741559,2162.56636020013,11,8
"2001750",15,1908.89125996727,1743.16674656692,2060.56118614118,9,6
"2001751",21,1953.06603251395,1709.22352801664,2207.26116887512,10,11
"2001790",18,1931.39628265751,1668.9210699715,2138.79896507223,4,14
"2001791",15,1964.58933056931,2022.17521603888,2060.56118614118,2,13
"2001792",18,1752.36050882902,1666.31598934538,2138.79896507223,6,12
"2001798",13,1898.19738912239,1754.73383764286,2001.16379457045,3,10
"2001801",23,2100.37865766277,2042.12847723914,2248.68783741607,3,20
"2001802",12,1796.44532625787,1577.1429471117,1968.69006049611,2,10
"2001805",17,2098.00265278203,1864.78601144229,2113.95669457394,7,10
"2001806",14,2000.58178580796,1839.63045907271,2031.70713799962,5,9
"2001807",27,2291.67869365153,2221.35126006827,2323.60649590586,10,17
"2001808",15,2003.64797544478,1798.15521043845,2060.56118614118,7,8
"2001809",17,2005.07854233335,1820.24009526055,2113.95669457394,6,11
"2001810",23,2118.12590433902,1947.78698530856,2248.68783741607,7,16
"2001811",14,1907.66090505066,1831.89339072238,2031.70713799962,3,11
"2001812",18,2045.26008370428,1961.5786306684,2138.79896507223,6,12
"2001815",16,1825.18507177981,1461.53919962896,2087.92318348224,4,12
"2001816",15,1822.01443589833,1414.44048476374,2060.56118614118,4,11
"2001817",20,1937.85841105307,1531.3435743825,2185.35845629437,6,14
"2001818",14,1837.9989053706,1586.61297943989,2031.70713799962,3,11
"2001819",15,1773.25257007624,1610.91483746165,2060.56118614118,5,10
"2001820",16,1859.01561327986,1496.08814550033,2087.92318348224,4,12
"2001821",15,1833.51450054307,1345.06095397772,2060.56118614118,5,10
"2001822",19,1822.07679345699,1401.24566314042,2162.56636020013,6,13
"2001823",16,1861.39965225652,1300.18359644274,2087.92318348224,6,10
"2001824",18,1916.21197592557,1678.43811183767,2138.79896507223,4,14
"2001825",23,1918.27247799852,1644.41464106847,2248.68783741607,8,15
"2001826",18,1907.30966966369,1486.16086242499,2138.79896507223,5,13
"2001832",17,2113.36604706492,1902.3253365551,2113.95669457394,8,9
"2001833",16,1992.97959823886,1875.10459465497,2087.92318348224,8,8
"2001834",19,1919.84768038179,1861.80752418221,2162.56636020013,5,14
"2001835",19,1978.7057200311,2001.96286319297,2162.56636020013,7,12
"2001846",22,2081.09971247437,2026.91308907195,2228.3491786518,5,17
"2001847",19,2061.35298409999,1943.29393217925,2162.56636020013,7,12
"2001848",18,1998.69009701495,1801.22242039065,2138.79896507223,4,14
"2001849",20,1999.35427415369,1917.59806916398,2185.35845629437,6,14
"2001850",20,1881.06230896367,1555.69762956799,2185.35845629437,3,17
"2001851",21,1966.23129585499,1654.09618799948,2207.26116887512,5,16
"2001852",17,2028.17492549094,1884.18293770454,2113.95669457394,4,13
"2001853",15,1998.24197933807,2093.15749451267,2060.56118614118,1,14
"2001854",24,1968.37518673781,1618.79382739806,2268.33468283819,7,17
"2001855",11,1898.27655165233,1850.0373427732,1933.98659929558,3,8
"2001856",14,1774.19428513767,1771.12885265124,2031.70713799962,2,12
"2001857",14,1798.40401010596,1544.17705308246,2031.70713799962,3,11
"2001858",16,1849.46490180956,1724.31363658599,2087.92318348224,5,11
"2001859",29,1907.40005314082,1811.79744127524,2357.79423966008,6,23
"2001860",13,1864.48466879464,1649.35561346835,2001.16379457045,0,13
"2001861",23,2062.52351816535,2080.86393517943,2248.68783741607,7,16
"2001862",13,1844.95832634967,1952.02178589403,2001.16379457045,3,10
"2001863",13,1752.58091222434,1849.74056909732,2001.16379457045,3,10
"2001864",17,2010.18726817935,2098.51224676143,2113.95669457394,2,15
"2001865",30,2087.72014555174,1912.65884350847,2374.18906024059,9,21
"2001881",26,1743.25738744875,1319.18925970255,2305.75108410937,5,21
"2001882",10,1863.61867357124,2001.47197832463,1896.67490607898,4,6
"2001890",13,1995.06557838495,1869.89770401454,2001.16379457045,2,11
"2001892",20,1857.16317252708,1418.02243821278,2185.35845629437,3,17
"2001894",20,1792.79427042575,1729.58897449369,2185.35845629437,3,17
"2001896",16,1884.70834763844,1474.42362353276,2087.92318348224,3,13
"2001898",25,1842.54371737068,1449.26924002016,2287.34065519221,5,20
"2001899",14,1760.80573297787,1313.45642200598,2031.70713799962,2,12
"2001900",25,1922.74297381732,1242.66520621953,2287.34065519221,6,19
"2001901",25,1898.57645874561,1289.19207629346,2287.34065519221,7,18
"2001902",29,2201.94547496097,2292.41940840871,2357.79423966008,8,21
"2001903",25,1994.81459431632,1520.1569656719,2287.34065519221,6,19
"2001907",29,2314.15822051705,2202.25330818119,2357.79423966008,11,18
"2001908",30,2203.70496239966,1936.59478416132,2374.18906024059,11,19
"2001909",22,1731.26399896629,1634.09910027569,2228.3491786518,5,17
"2001910",13,1745.12320372865,1892.55613220192,2001.16379457045,2,11
"2001911",31,1972.27646347163,1415.88537002359,2390.15469389133,9,22
"2001912",24,1978.66270388225,1604.03142193203,2268.33468283819,5,19
"2001913",14,1822.45054406967,1449.89240043528,2031.70713799962,3,11
"2001914",20,1781.09715851848,1337.00009547263,2185.35845629437,5,15
"2001915",7,1645.48328829859,1453.78116654175,1763.32076508842,2,5
"2001916",15,1867.14163877214,1615.59395667168,2060.56118614118,3,12
"2001917",19,1888.57627436567,1777.81379727275,2162.56636020013,4,15
"2001918",6,1664.61596657728,1656.73612366143,1708.62817714657,3,3
"2001919",18,1942.0457130547,1845.53348305895,2138.79896507223,5,13
"2001920",19,1901.98024468136,1810.81547178212,2162.56636020013,4,15
"2001921",19,1964.35339556895,1632.81966461779,2162.56636020013,5,14
"2001922",12,1707.78674526252,1547.28906663124,1968.69006049611,3,9
"2001923",14,1892.35660800167,1783.38038371716,2031.70713799962,4,10
"2001924",13,1821.09359785257,1535.26050741956,2001.16379457045,3,10
"2001925",16,1956.40054445873,1688.25968873234,2087.92318348224,5,11
"2001926",9,1670.18128461884,1595.98135955919,1856.26587460569,3,6
"2001927",10,1798.29013316762,1727.62980225866,1896.67490607898,4,6
"2001928",9,1695.678344709,1516.40949210603,1856.26587460569,2,7
"2001929",5,1625.90989002697,1679.36902378816,1646.12614877363,1,4
"2001930",9,1712.58297346442,1562.74392465521,1856.26587460569,3,6
"2001931",22,1934.74588004594,1649.46162373463,2228.3491786518,9,13
"2001932",21,1880.17773154787,1864.13467287572,2207.26116887512,5,16
"2001933",22,1765.06557431939,1670.81476526878,2228.3491786518,7,15
"2002386",16,2029.14444465219,1887.0105430965,2087.92318348224,2,14
"2002389",23,1973.20860750776,1825.9142873252,2248.68783741607,5,18
"2002391",28,2157.88465784502,1695.78083039091,2340.94327947849,5,23
"2002399",16,1962.39082209828,1696.92813208425,2087.92318348224,3,13
"2002502",18,1878.05842790602,1517.96730552197,2138.79896507223,4,14
"2002503",17,1898.45743210111,1643.16606131445,2113.95669457394,3,14
"2002504",20,1894.88382311177,1749.52830931371,2185.35845629437,4,16
"2002505",15,1841.92290536398,1548.49486390053,2060.56118614118,3,12
"2002507",17,1821.55346646471,1808.19964257624,2113.95669457394,4,13
"2002508",17,1844.53739060084,1755.62123492355,2113.95669457394,4,13
"2002509",20,1775.2876631188,1353.43432829691,2185.35845629437,4,16
"2002510",17,1887.00121638778,1704.75668608281,2113.95669457394,5,12
"2002571",13,1904.60260309442,1745.4590216739,2001.16379457045,1,12
"2002573",15,1876.55502466975,1647.76272527243,2060.56118614118,1,14
"2002627",41,2607.7148245054,3062.49228611457,2530.72175773865,14,27
"2002629",18,1976.92854814635,1663.46454542108,2138.79896507223,6,12
"2002630",22,2046.84411374946,1632.3207612791,2228.3491786518,6,16
"2002631",33,2071.8258761166,1363.14854032316,2420.89448855093,9,24
"2002633",22,2166.88992552512,2374.68483351834,2228.3491786518,6,16
"2002634",33,2466.32673354642,2731.74748202663,2420.89448855093,9,24
"2002637",20,1995.39288494126,2011.49151664742,2185.35845629437,6,14
"2002649",36,2022.52804522446,1756.65512202169,2464.33502634194,10,26
"2002653",24,2197.01896539833,2245.47499687312,2268.33468283819,8,16
"2002665",35,1882.69170541553,1542.20095673624,2450.1860183293,8,27
"2002666",41,1827.41171696774,1726.13737944147,2530.72175773865,9,32
"2002667",33,2016.22923882605,1466.0466044533,2420.89448855093,8,25
"2002668",26,1937.06715525563,1452.18685533749,2305.75108410937,8,18
"2002669",20,2144.19695174541,1884.91261468067,2185.35845629437,6,14
"2002670",22,1915.00546137618,1763.89520804316,2228.3491786518,7,15
"2002671",25,1882.70622865635,1242.19274965504,2287.34065519221,5,20
"2002672",26,1868.65538012482,1882.95330133978,2305.75108410937,7,19
"2002673",32,1992.46327013206,1618.32446459595,2405.71569249515,8,24
"2002674",34,2128.95515152928,1691.26560823961,2435.71163614839,8,26
"2002675",29,2063.43522399098,1563.45188073009,2357.79423966008,7,22
"2002676",39,2015.69794668425,1881.81555971261,2504.98447234734,9,30
"2002677",33,2010.56686601891,1412.66726751988,2420.89448855093,11,22
"2002678",25,1967.99639648119,1538.58433849266,2287.34065519221,5,20
"2002679",21,2127.31218574547,2121.79110482608,2207.26116887512,7,14
"2002680",28,2091.99908223546,1433.98470799082,2340.94327947849,10,18
"2002681",39,1919.3576799191,1414.35844556901,2504.98447234734,10,29
"2002682",26,1835.3125927161,1461.74443499938,2305.75108410937,5,21
"2002683",48,1920.09351638405,1348.60522350086,2613.58673801098,11,37
"2002684",23,1892.71200242483,1398.52865757697,2248.68783741607,7,16
"2002685",21,1860.93542438746,1480.9219304604,2207.26116887512,4,17
"2002686",28,2105.04249180392,1867.03212224834,2340.94327947849,8,20
"2002687",13,1796.68354478021,1386.08261433068,2001.16379457045,1,12
"2002688",19,1855.03907399549,1387.45546577629,2162.56636020013,4,15
"2002689",25,2052.38086249338,1523.87962931597,2287.34065519221,7,18
"2002690",21,1939.41290213315,1803.2485205258,2207.26116887512,5,16
"2002691",18,2016.76761976697,1795.23267130523,2138.79896507223,3,15
"2002692",20,2033.68860629266,1651.14259708588,2185.35845629437,2,18
"2002693",43,1890.18636187277,1377.24641387035,2555.47878346624,10,33
"2002694",30,2047.03696171437,1489.89665285855,2374.18906024059,7,23
"2002695",39,2089.49433647928,1724.14179686093,2504.98447234734,9,30
"2002696",34,2025.02602472756,1534.94601795355,2435.71163614839,7,27
"2002697",30,2133.68129238562,1630.77956246279,2374.18906024059,6,24
"2002698",32,1894.71785320603,1263.44407534515,2405.71569249515,9,23
"2002699",29,1916.40432830063,1378.24505429411,2357.79423966008,5,24
"2002700",29,2057.90551075938,1408.65921129396,2357.79423966008,10,19
"2002701",24,2018.41017912825,1873.55706729777,2268.33468283819,5,19
"2002702",31,1801.86975917123,1862.95404172422,2390.15469389133,5,26
"2002703",31,1954.12233921973,1552.09083300737,2390.15469389133,10,21
"2002704",38,1744.99467323155,1119.36877565625,2491.71993967651,12,26
"2002705",15,1906.55558432528,1704.87807419607,2060.56118614118,2,13
"2002706",22,1946.76112545371,1849.94387152036,2228.3491786518,4,18
"2002707",27,2048.26519079601,1862.24846331763,2323.60649590586,6,21
"2002708",27,1905.41950160167,1776.03588397945,2323.60649590586,4,23
"2002709",26,1808.55538693085,1486.83999394537,2305.75108410937,5,21
"2002710",18,2018.58633266213,2057.32083033402,2138.79896507223,3,15
"2002711",19,1940.54151980386,1655.25952426173,2162.56636020013,5,14
"2002712",16,1856.82852774017,1586.67781250194,2087.92318348224,6,10
"2002713",37,2062.07098146704,2172.12934217435,2478.17471526668,7,30
"2002714",42,2046.16635904854,1409.95982166994,2543.21752514954,8,34
"2002715",27,2043.7565386075,1889.68348300242,2323.60649590586,6,21
"2002716",25,2069.48989462118,1797.42758076669,2287.34065519221,4,21
"2002717",37,1896.84942534186,1562.78029281104,2478.17471526668,11,26
"2002718",29,1872.50844630433,1303.99781334845,2357.79423966008,6,23
"2002719",25,1919.8504851537,1404.27271319367,2287.34065519221,6,19
"2002720",20,1883.50232504322,1602.76549610002,2185.35845629437,4,16
"2002721",32,2119.91483634652,1505.12485932268,2405.71569249515,6,26
"2002722",23,1950.23670385444,1485.72879817563,2248.68783741607,3,20
"2002723",38,2134.32415448481,1460.00427072866,2491.71993967651,8,30
"2002724",33,2163.5508611883,1655.84957371207,2420.89448855093,6,27
"2002725",19,1907.13758838391,1580.19911520173,2162.56636020013,5,14
"2002726",19,1946.08869072372,1682.03659583397,2162.56636020013,4,15
"2002727",19,2038.74008743066,1855.1772055177,2162.56636020013,4,15
"2002728",10,1851.09288735788,1591.98201893256,1896.67490607898,3,7
"2002729",9,1818.29571623637,1570.50290918211,1856.26587460569,1,8
"2002730",15,1887.25428035609,1811.66151982245,2060.56118614118,4,11
"2002731",21,1981.41437437739,1638.27074247343,2207.26116887512,5,16
"2002732",22,1922.79737496526,1864.0127407041,2228.3491786518,7,15
"2002733",25,2008.56941165688,1721.91101549857,2287.34065519221,7,18
"2002734",28,2122.81019807742,1641.26289116692,2340.94327947849,8,20
"2002735",24,2180.43670755522,1766.66929717796,2268.33468283819,7,17
"2002736",26,2066.43095902032,1754.81566658539,2305.75108410937,6,20
"2002738",18,1967.67976018846,2062.07157702221,2138.79896507223,3,15
"2002739",20,1917.40158007727,1829.02843250175,2185.35845629437,6,14
"2002754",21,1888.76231703298,1819.24733653353,2207.26116887512,3,18
"2002756",32,2251.00166994807,2283.9821148815,2405.71569249515,9,23
"2002757",24,2109.47214349814,1892.82504101048,2268.33468283819,5,19
"2002758",17,1968.09545142439,1914.45229618566,2113.95669457394,3,14
"2002783",14,1835.77167807294,1736.13773695127,2031.70713799962,3,11
"2002788",18,1988.29782193446,1998.04702717927,2138.79896507223,3,15
"2002790",37,1964.76810595134,1621.38104495967,2478.17471526668,10,27
"2002793",24,2222.86423172141,2148.9787463172,2268.33468283819,6,18
"2002794",32,2102.30917454027,2042.55575688504,2405.71569249515,8,24
"2002798",17,1875.49413860932,1942.30413937766,2113.95669457394,5,12
"2002799",23,1865.13435713015,1880.26354829911,2248.68783741607,6,17
"2002816",14,1858.71659287066,1869.63286367163,2031.70713799962,3,11
"2002817",14,1833.80123110486,1950.79128501481,2031.70713799962,3,11
"2002838",16,1879.19381400093,1868.46202449401,2087.92318348224,5,11
"2002839",27,2000.28149595903,1707.71193274765,2323.60649590586,8,19
"2002840",29,1964.63152414502,1612.8091621452,2357.79423966008,7,22
"3000001",7,1648.94030366525,1353.01614260517,1763.32076508842,4,3
"3000002",11,1686.81207138485,1198.47642067357,1933.98659929558,5,6
"3000003",7,1496.48404967252,1552.44576520533,1763.32076508842,4,3
"3000004",7,1558.75269824223,1473.38160083946,1763.32076508842,2,5
"3000005",4,1498.98854586128,1270.74127604337,1572.73281143487,3,1
"3000006",5,1504.60111985755,1551.69505881037,1646.12614877363,2,3
"3000007",16,1817.27937966134,1754.92633917542,2087.92318348224,5,11
"3000012",9,1688.00841905809,1772.90482875855,1856.26587460569,4,5
"3000013",1,1164.93329481912,1184.66451052022,1184.66451052022,1,0
"3000023",12,1904.68073641735,1798.93875979246,1968.69006049611,2,10
"3000024",10,1831.07556566537,1748.14426251689,1896.67490607898,3,7
"3000041",11,1800.56430335217,1679.11331728413,1933.98659929558,4,7
"3000044",10,1794.35941135919,1763.33664659701,1896.67490607898,4,6
"3000061",19,1693.44965307289,1408.72450004928,2162.56636020013,3,16
"3000077",5,1543.36277399861,1491.36460965774,1646.12614877363,2,3
"3000078",2,1294.80977874145,1343.73377081397,1364.97646362037,2,0
"3000079",5,1547.76664677445,1461.2521324717,1646.12614877363,3,2
"3000080",4,1514.30108035908,1438.99847017674,1572.73281143487,3,1
"3000090",4,1499.47933619621,1508.03006991746,1572.73281143487,2,2
"3000097",2,1381.98525396608,1369.39927457214,1364.97646362037,0,2
"3000100",3,1396.00720184862,1274.43342678345,1482.92019466158,2,1
"3000101",6,1625.98359718195,1415.59634433564,1708.62817714657,4,2
"3000102",3,1469.87140671085,1488.08179025022,1482.92019466158,1,2
"3000119",9,1609.52919115261,1387.80497062823,1856.26587460569,5,4
"3000123",6,1536.61392745394,1453.18879277454,1708.62817714657,3,3
"3000124",14,1835.24162898918,1670.13722663649,2031.70713799962,2,12
"3000125",16,1792.11497564256,1444.18840341855,2087.92318348224,3,13
"3000144",6,1660.13129041649,1651.98560659731,1708.62817714657,2,4
"3000145",5,1570.39784177141,1528.67539297135,1646.12614877363,1,4
"3000146",7,1682.43501111716,1628.88670687922,1763.32076508842,2,5
"3000149",4,1485.46716180636,1422.97878880207,1572.73281143487,2,2
"3000155",2,1351.56563118118,1305.79509610263,1364.97646362037,2,0
"3000156",5,1580.09003292914,1542.72904582004,1646.12614877363,3,2
"3000160",6,1643.700726409,1578.28644384762,1708.62817714657,2,4
"3000166",10,1801.46075760098,1691.45554901876,1896.67490607898,2,8
"3000167",9,1780.10723132026,1677.95535043197,1856.26587460569,2,7
"3000168",6,1688.06355415731,1790.61401868405,1708.62817714657,2,4
"3000172",5,1579.78078324694,1558.89889216797,1646.12614877363,2,3
"3000173",8,1667.0572249881,1674.84770414172,1812.11073017574,2,6
"3000175",13,1761.04351423812,1609.85668595019,2001.16379457045,2,11
"3000176",13,1757.55894522267,1665.35643063543,2001.16379457045,4,9
"3000178",7,1687.23819641463,1600.33447103026,1763.32076508842,2,5
"3000179",12,1634.41543203073,1788.57358482107,1968.69006049611,6,6
"3000182",4,1583.4242837517,1572.73281143487,1572.73281143487,1,3
"3000183",13,1784.05431245261,1571.33420791314,2001.16379457045,6,7
"3000184",8,1681.39068136267,1653.20572122611,1812.11073017574,3,5
"3000185",8,1694.82125139837,1563.37997532505,1812.11073017574,4,4
"3000190",13,1828.00184383931,1908.85761376027,2001.16379457045,4,9
"3000196",4,1509.4015330381,1522.18236460698,1572.73281143487,2,2
"3000197",3,1471.00277640079,1415.90434936504,1482.92019466158,3,0
"3000241",7,1706.39533520304,1643.09662561999,1763.32076508842,1,6
"3000242",7,1703.8606797693,1655.87449312599,1763.32076508842,2,5
"3000246",8,1744.72875536479,1660.5038270858,1812.11073017574,2,6
"3000249",7,1695.40597585627,1674.25869258505,1763.32076508842,1,6
"3002407",11,1651.55553455968,1539.26973194693,1933.98659929558,2,9
"3002408",5,1550.12248484554,1539.55983683811,1646.12614877363,2,3
"3002409",10,1766.46358746949,1752.58479557158,1896.67490607898,3,7
"3002412",16,1989.08090947999,1694.84061098673,2087.92318348224,3,13
"3002413",11,1722.03515850311,1787.09967572061,1933.98659929558,3,8
"3002414",13,1825.717092976,1631.14757659924,2001.16379457045,1,12
"3002520",8,1715.19240656183,1568.37821579337,1812.11073017574,1,7
"3002523",10,1748.68380389843,1588.54210505469,1896.67490607898,2,8
"3002525",12,1781.52708628929,1611.53697752383,1968.69006049611,2,10
"3002526",21,1771.95556588008,1369.37661962343,2207.26116887512,5,16
"3002528",13,1823.33658223104,1623.662406379,2001.16379457045,3,10
"3002530",21,1894.08332330245,1711.55518756085,2207.26116887512,6,15
"3002534",25,1799.15585089568,1239.41507215962,2287.34065519221,6,19
"3002535",20,1747.12529412477,1551.53786667031,2185.35845629437,3,17
"3002536",18,1905.20224644798,1889.22704101671,2138.79896507223,3,15
"3002537",17,1866.06256026293,1653.96634460625,2113.95669457394,2,15
"3002538",18,1870.46113369738,1613.8952727699,2138.79896507223,5,13
"3002539",15,1842.5365918784,1915.28654953364,2060.56118614118,4,11
"3002540",15,1793.9804291699,1505.07141886462,2060.56118614118,3,12
"3002541",16,1929.99249739833,1668.20386847739,2087.92318348224,2,14
"3002542",19,1841.72535101263,1560.87091663683,2162.56636020013,2,17
"3002543",16,1842.3980238007,1634.3459488558,2087.92318348224,3,13
"3002544",13,1786.16047815871,1531.8242288878,2001.16379457045,2,11
"3002545",15,1747.43324481979,1442.80603865636,2060.56118614118,3,12
"3002546",19,1900.53361219407,1674.84851753123,2162.56636020013,3,16
"3002547",17,1954.48041790013,1677.03913640265,2113.95669457394,3,14
"3002548",19,1940.36087212873,1626.76690605933,2162.56636020013,4,15
"3002549",17,1859.37872049828,1635.80452760479,2113.95669457394,4,13
"3002550",16,1797.54430772304,1297.1870830574,2087.92318348224,3,13
"3002551",19,1895.60949621213,1398.65494896899,2162.56636020013,4,15
"3002552",16,1855.48237814679,1475.69001714857,2087.92318348224,3,13
"3002553",23,1972.30734203224,1443.10508400753,2248.68783741607,6,17
"3002554",15,1934.24463809975,1631.36931998614,2060.56118614118,3,12
"3002555",14,1878.79235674309,1739.86999153742,2031.70713799962,2,12
"3002556",17,1838.84710742264,1542.22885780003,2113.95669457394,3,14
"3002557",17,1822.57922079578,1273.14268494913,2113.95669457394,3,14
"3002558",13,1779.40677618748,1336.20582756656,2001.16379457045,2,11
"3002559",18,1935.06496720878,1752.23269311582,2138.79896507223,3,15
"3002560",13,1715.58744357059,1581.15799347815,2001.16379457045,3,10
"3002561",11,1756.47361862566,1567.37848604365,1933.98659929558,1,10
"3002566",14,1820.29294346971,1502.75941693361,2031.70713799962,2,12
"3002567",19,1769.32637699433,1368.57690760564,2162.56636020013,3,16
"3002568",7,1660.41147836927,1578.3335219941,1763.32076508842,1,6
"3002572",6,1659.36897236299,1505.23264680443,1708.62817714657,0,6
"3002576",1,1164.93329481912,1184.66451052022,1184.66451052022,1,0
"3002616",21,1843.82872586147,1707.70379986572,2207.26116887512,6,15
"3002619",17,1814.52941772024,1371.00139287828,2113.95669457394,3,14
"3002620",8,1674.5929925653,1518.42985070562,1812.11073017574,2,6
"3002621",16,1777.49724573475,1606.86803694349,2087.92318348224,3,13
"3002622",14,1856.30802800723,1664.14066029657,2031.70713799962,3,11
"3002918",5,1527.53702138326,1308.54706101773,1646.12614877363,2,3
"3002919",6,1626.4905139732,1611.18481500103,1708.62817714657,3,3
"3002920",4,1536.30013891549,1437.22486818279,1572.73281143487,2,2
"3002921",5,1477.69274584854,1232.16064594746,1646.12614877363,4,1
"3002922",8,1658.60730047771,1170.42876726552,1812.11073017574,6,2
"3002925",6,1586.50596434624,1340.62535013759,1708.62817714657,2,4
"33003062",9,1722.92226868833,1544.02860617616,1856.26587460569,3,6
"33003063",16,1878.34392918758,1854.29480805194,2087.92318348224,6,10
"33003064",13,1746.46324147543,1689.41664902196,2001.16379457045,3,10
"33003065",13,1702.72031865378,1577.75811040067,2001.16379457045,3,10
"33003066",15,1792.17839712621,1620.508300451,2060.56118614118,4,11
"33003067",10,1741.38216488733,1779.39437646572,1896.67490607898,4,6
"33003068",13,1840.61559304716,1685.2422598365,2001.16379457045,4,9
"33003069",16,1778.36373977401,1701.0507248419,2087.92318348224,3,13
"33003070",4,1542.07460496898,1489.37650483321,1572.73281143487,3,1
"33003071",10,1717.90913462493,1724.18717454678,1896.67490607898,3,7
"33003072",15,1751.68183038152,1461.27434433732,2060.56118614118,3,12
"33003073",12,1812.22425115369,1612.52081917132,1968.69006049611,5,7
"33003074",13,1805.4372285306,1795.52295234438,2001.16379457045,3,10
"33003075",6,1620.52311048164,1656.67332132016,1708.62817714657,2,4
"33003917",10,1763.68667409368,1740.96530030462,1896.67490607898,3,7
"33003918",11,1815.47928607375,1818.45280650118,1933.98659929558,4,7
"33003919",13,1737.56682210196,1810.44980822735,2001.16379457045,2,11
"33003920",13,1708.47538523915,1380.73059880719,2001.16379457045,3,10
"33003921",9,1700.29461846628,1639.14910639377,1856.26587460569,3,6
"33003922",10,1753.47550702068,1716.1882514178,1896.67490607898,4,6
"33003923",14,1808.84268350657,1782.47512763095,2031.70713799962,5,9
"33003924",12,1641.69080498035,1417.55266068881,1968.69006049611,2,10
"33003925",5,1579.04894527817,1576.61399276385,1646.12614877363,3,2
"33003927",6,1608.08677855089,1607.59548485325,1708.62817714657,3,3
"33003928",15,1791.02665549132,1600.4538917602,2060.56118614118,4,11
"33003929",11,1709.75439423144,1552.61082964275,1933.98659929558,4,7
"34003018",10,1692.07153934837,1646.04200872659,1896.67490607898,3,7
"34003019",16,1807.26930937438,1777.12371840669,2087.92318348224,4,12
"34003020",13,1802.9873262906,1573.38293557528,2001.16379457045,3,10
"34003021",9,1751.57416052854,1725.39773428618,1856.26587460569,3,6
"34003022",16,1835.55182331154,1739.98486908715,2087.92318348224,5,11
"34003024",8,1787.20430450499,1957.52469919068,1812.11073017574,2,6
"34003025",11,1746.70188322494,1474.54567748759,1933.98659929558,2,9
"34003026",12,1936.05165462605,2074.84922743398,1968.69006049611,4,8
"34003027",14,1823.3045636394,1916.65454233432,2031.70713799962,3,11
"34003028",17,1833.7039817826,1548.62753338627,2113.95669457394,4,13
"34003029",12,1731.46107609026,1388.51239581,1968.69006049611,2,10
"34003030",10,1678.03442096955,1915.34899744779,1896.67490607898,0,10
"34003031",12,1754.68298070821,1681.56356886582,1968.69006049611,1,11
"34003926",13,1774.83167404396,1572.79453096422,2001.16379457045,3,10
"34003930",17,1807.94947946675,1677.78590039411,2113.95669457394,4,13
"34003931",14,1819.58109039657,1672.32533524712,2031.70713799962,3,11
"34003950",12,1816.05189188353,1663.78187052451,1968.69006049611,2,10
"34003951",12,1837.85501130201,2139.84558741037,1968.69006049611,3,9
"34003952",9,1745.50026892453,1515.74847865327,1856.26587460569,1,8
"34003953",11,1780.95574175486,1607.14530515554,1933.98659929558,4,7
"34003954",19,1889.21541978539,1916.54372396642,2162.56636020013,4,15
"34003955",8,1827.83757672792,1866.62074533858,1812.11073017574,2,6
"34003956",10,1758.68896131921,1896.71477780125,1896.67490607898,2,8
"34003957",11,1793.17035979082,1764.62950520223,1933.98659929558,2,9
"34003958",10,1828.51079742542,1965.31338236922,1896.67490607898,2,8
"34003959",16,1898.74582383332,1970.44613457259,2087.92318348224,3,13
"34003960",14,1736.64525039562,1447.70839907818,2031.70713799962,1,13
"34003961",14,1733.51264193402,1692.8093250499,2031.70713799962,1,13
"34003962",11,1730.23148854292,1815.50972094235,1933.98659929558,0,11
"39003127",7,1721.79494879223,1702.317933568,1763.32076508842,3,4
"39003128",9,1721.00567032468,1613.83060970772,1856.26587460569,3,6
"39003129",12,1799.6366886748,1802.97359340362,1968.69006049611,4,8
"39003130",11,1789.97792656304,1787.00353707154,1933.98659929558,2,9
"39003131",14,1857.35337984982,1807.1606330157,2031.70713799962,6,8
"39003132",17,1829.91993152004,1737.64060117768,2113.95669457394,5,12
"39003133",15,1774.27872108147,1598.45105803031,2060.56118614118,3,12
"39003134",12,1804.4250481927,1731.87853556006,1968.69006049611,3,9
"39003135",13,1875.6045289921,1705.27788715298,2001.16379457045,5,8
"39003908",14,1789.99654418249,1816.95714932096,2031.70713799962,4,10
"39003909",12,1823.20282698225,1670.30159523956,1968.69006049611,2,10
"39003910",14,1775.02104583068,1705.86355261552,2031.70713799962,4,10
"39003911",16,1791.41148219843,1619.60486883273,2087.92318348224,3,13
"39003912",12,1843.8076259034,1702.6066544511,1968.69006049611,4,8
"39003913",15,1829.16156376841,1593.56575064635,2060.56118614118,5,10
"39003914",14,1781.61817678216,1672.05241125176,2031.70713799962,4,10
"39003915",14,1785.75339653856,1675.08836601594,2031.70713799962,3,11
"39003916",13,1834.04946062906,1758.59852678261,2001.16379457045,3,10
"4000676",55,2563.64779838484,2151.03178927532,2687.33120998132,25,30
"4000677",48,2539.81092802607,1855.51771700968,2613.58673801098,23,25
"4000680",70,2899.03421372079,2304.97366926913,2823.11677003184,28,42
"4000681",58,2608.62407452034,2098.67202093882,2716.66249357165,20,38
"4000684",69,2912.27078175139,1965.68454015682,2814.82611826518,24,45
"4000685",70,2893.72549259479,2247.86551195587,2823.11677003184,28,42
"4000686",64,2889.37516695554,2722.24621726607,2771.87783482774,27,37
"4000687",68,3424.34161162107,3829.94418323174,2806.43931339586,33,35
"4000688",59,2901.25244579883,3043.79168371403,2726.17127719361,21,38
"4000689",59,3091.34946534848,3015.67226117484,2726.17127719361,22,37
"4000690",38,2405.70599179336,2392.81199584621,2491.71993967651,16,22
"4000691",58,2478.58592283936,2801.8550200174,2716.66249357165,23,35
"4000692",71,3230.33111718427,3167.42282537595,2831.31372136695,38,33
"4000693",59,2572.61657496568,2323.93130699774,2726.17127719361,24,35
"4000694",62,3068.05631258752,3318.03232525043,2753.94837323248,24,38
"4000695",46,3012.83366849943,2678.25480775597,2590.94954296761,21,25
"4000696",55,2776.58075890522,2732.05613638243,2687.33120998132,24,31
"4000697",66,3077.82406432717,2618.62022015554,2789.3669207067,29,37
"4000698",65,2692.84839224433,2543.56539625084,2780.67589681985,29,36
"4000699",73,3006.46590343806,3091.84174706723,2847.4358582506,30,43
"4000700",73,3007.88946994086,2519.41106609164,2847.4358582506,27,46
"4000701",84,3246.10806210673,3388.49311633321,2930.30814451558,35,49
"4000702",80,3595.26484811811,3387.39759826482,2901.2306171403,31,49
"4000703",84,3110.44604322351,2888.39530253689,2930.30814451558,34,50
"4000704",82,3155.4225278972,2847.52111788525,2915.91045786314,34,48
"4000705",84,2927.80310150279,2211.05227402174,2930.30814451558,33,51
"4000706",80,3386.59108143273,2977.07721681459,2901.2306171403,34,46
"4000707",30,2289.69503760667,1582.37160328497,2374.18906024059,9,21
"4000708",34,2205.1034770821,1597.33986346707,2435.71163614839,15,19
"4000709",39,2735.58667745719,2573.49330230313,2504.98447234734,19,20
"4000710",41,2592.46645637824,2450.94047531177,2530.72175773865,21,20
"4000711",31,2408.72445249918,2296.36134141954,2390.15469389133,16,15
"4000712",33,2647.12239152609,2384.58089745155,2420.89448855093,16,17
"4000713",47,2590.46343719188,2154.13513369908,2602.36394728806,19,28
"4000714",30,2293.62352512245,2227.32789524299,2374.18906024059,11,19
"4000715",58,3159.85918639065,2663.37458308971,2716.66249357165,23,35
"4000716",64,3116.79055761745,2681.49122716127,2771.87783482774,23,41
"4000717",84,3192.01858569313,2537.51691151438,2930.30814451558,35,49
"4000718",6,1729.4966520636,1637.13600851975,1708.62817714657,0,6
"4000719",5,1660.30108509915,1575.90216570461,1646.12614877363,1,4
"4000720",86,3037.85601077068,2751.9449492763,2944.43562859908,42,44
"4000721",82,3082.96706625589,2475.6123651069,2915.91045786314,33,49
"4000722",69,3146.74413180376,2942.40071908091,2814.82611826518,24,45
"4000723",78,2739.87567714287,2197.03891034723,2886.25582696583,25,53
"4000724",54,2310.29309583463,1607.31572183051,2677.2712016452,22,32
"4000725",66,2568.44708740102,1888.79783889404,2789.3669207067,30,36
"4000726",64,2565.04142067624,2132.52497036673,2771.87783482774,27,37
"4000727",81,2797.58755606543,1351.96375352026,2908.60658576875,29,52
"4000728",83,3344.5966532905,2772.1514203351,2923.1438046077,32,51
"4000729",66,2655.60727223459,2145.91142791163,2789.3669207067,21,45
"4000730",75,3045.68628764131,2746.08917758503,2863.21031780169,24,51
"4000731",77,2694.4943252576,2520.97457988332,2878.65357631343,24,53
"4000732",95,3034.14714051551,3170.50384601356,3004.94950458202,31,64
"4000733",89,3303.02011243717,2827.13160299366,2965.14449011489,33,56
"4000734",58,2765.66210216423,2154.5462961753,2716.66249357165,28,30
"4000735",58,2575.40191790251,1638.14083985729,2716.66249357165,21,37
"4000736",75,2994.96300401151,2474.20799378418,2863.21031780169,36,39
"4000737",68,2671.19448259762,2075.03539753896,2806.43931339586,28,40
"4000738",48,2467.09740430231,2300.77922572598,2613.58673801098,16,32
"4000739",49,2460.08005157733,2324.75936004625,2624.62502504328,20,29
"4000740",58,2670.14569385999,2090.12845598213,2716.66249357165,27,31
"4000741",43,2168.83694345879,1768.60723259322,2555.47878346624,21,22
"4000742",64,2713.33342266121,2795.47680167251,2771.87783482774,25,39
"4000743",50,2859.85957674895,3086.6593601324,2635.48551585152,13,37
"4000744",61,3046.37049619336,3052.73741808825,2744.81051624266,22,39
"4000745",55,2600.81737793293,2447.29302278055,2687.33120998132,18,37
"4000746",64,2297.2239654465,1475.17856745574,2771.87783482774,29,35
"4000747",51,2455.59720075432,1688.50470181981,2646.17454577679,26,25
"4000748",68,2645.29274189336,1954.46891985621,2806.43931339586,26,42
"4000749",40,2398.19745405046,2014.40732971977,2517.98110851286,12,28
"4000750",64,2609.38401407864,2492.86053563113,2771.87783482774,29,35
"4000751",60,2887.13940475346,2538.32583440049,2735.5526890818,22,38
"4000753",70,2137.55587683269,1439.74012857165,2823.11677003184,19,51
"4000754",66,2279.98085216871,1924.75795868918,2789.3669207067,23,43
"4000755",26,2179.60040777606,1956.01496351856,2305.75108410937,9,17
"4000756",29,2167.90440350954,1727.04584095691,2357.79423966008,11,18
"4000757",45,2085.28490364818,1408.97056124019,2579.33597919865,14,31
"4000758",37,2315.75253773597,2153.84570785854,2478.17471526668,8,29
"4000759",38,2388.64248339354,2221.54928695369,2491.71993967651,10,28
"4000760",24,2167.5375877797,2174.95579686178,2268.33468283819,9,15
"4000761",28,2037.16154578552,1489.85627810827,2340.94327947849,8,20
"4000762",20,2047.77882133916,1786.04760693773,2185.35845629437,4,16
"4000763",15,1912.36030462076,1631.83775313848,2060.56118614118,4,11
"4000764",21,2147.67941526788,2214.11607065159,2207.26116887512,6,15
"4000765",31,2226.50240230086,2261.82660932915,2390.15469389133,7,24
"4000766",19,2121.42107065164,1949.43724502034,2162.56636020013,6,13
"4000767",36,2294.91695186071,1979.37621922779,2464.33502634194,11,25
"4000768",31,2414.38317820184,2286.61731575436,2390.15469389133,6,25
"4000769",24,1920.77858180117,1750.15427870666,2268.33468283819,7,17
"4000770",20,1992.46102075913,1786.09328047008,2185.35845629437,4,16
"4000771",22,2034.4989941481,1824.5304456318,2228.3491786518,5,17
"4000772",22,1931.59738520215,1543.3208479993,2228.3491786518,8,14
"4000773",33,2031.88951642855,1555.25986653763,2420.89448855093,8,25
"4000774",35,2096.3748121294,1562.55553824826,2450.1860183293,10,25
"4000775",43,2599.08878348407,2707.08546822464,2555.47878346624,14,29
"4000776",47,2640.28116749742,2904.48632270798,2602.36394728806,13,34
"4000777",29,2289.06591764212,2141.79737835145,2357.79423966008,10,19
"4000778",47,2514.07198601368,2358.01077234377,2602.36394728806,15,32
"4000779",38,2459.95807129313,2059.35831225709,2491.71993967651,10,28
"4000780",26,2114.01331384161,1804.0161306009,2305.75108410937,6,20
"4000781",27,2175.38175388261,1885.49952393377,2323.60649590586,7,20
"4000782",26,2120.15921765788,1762.25996110076,2305.75108410937,10,16
"4000783",26,2156.27565175771,1783.35465988074,2305.75108410937,10,16
"4000784",28,2284.88780038435,2047.1785987538,2340.94327947849,13,15
"4000785",29,2054.97326210142,1677.52689806411,2357.79423966008,11,18
"4000786",36,2179.12700790272,1917.13333510181,2464.33502634194,13,23
"4000787",35,2317.91237788913,1675.35888786068,2450.1860183293,11,24
"4000788",30,2323.5461962916,2083.69055569837,2374.18906024059,13,17
"4000789",31,2253.93145784853,1870.76615830726,2390.15469389133,13,18
"4000790",55,2403.60005337511,1699.42583845387,2687.33120998132,19,36
"4000791",23,2076.62808557596,1649.0059527652,2248.68783741607,6,17
"4000792",24,2069.9908026741,1741.65393599233,2268.33468283819,8,16
"4000793",30,2230.60419942268,1778.16414535616,2374.18906024059,11,19
"4000794",25,2032.58269354045,1751.22040075986,2287.34065519221,10,15
"4000795",23,2123.48536732262,1851.61871474247,2248.68783741607,9,14
"4000797",61,2627.79603495354,2319.02826990382,2744.81051624266,28,33
"4000798",45,2558.4725765616,2322.02159443834,2579.33597919865,20,25
"4000799",83,2981.95028190121,2351.16476259562,2923.1438046077,37,46
"4000800",55,2570.98118035812,2073.49043682888,2687.33120998132,26,29
"4000801",50,2347.72390513827,2475.92051513888,2635.48551585152,20,30
"4000802",35,2312.63683245264,2310.64892963687,2450.1860183293,12,23
"4000803",30,2067.89745090546,1441.11253601386,2374.18906024059,6,24
"4000804",25,1988.7328168073,1557.54475162194,2287.34065519221,9,16
"4000807",63,2145.42031606134,1252.46768845011,2762.96971264875,20,43
"4000808",62,2204.46216601289,1407.08880548526,2753.94837323248,18,44
"4000809",27,1872.15030707431,1373.19683707105,2323.60649590586,7,20
"4000810",11,1751.53647885805,1528.27294394675,1933.98659929558,4,7
"4000811",41,2190.35121927345,2099.96486936871,2530.72175773865,15,26
"4000812",66,2179.25801805753,800.81425989229,2789.3669207067,18,48
"4000813",69,2216.14231126023,798.006218774535,2814.82611826518,23,46
"4000814",41,2363.82032864575,2333.92915142972,2530.72175773865,11,30
"4000815",49,2692.82493011343,2482.14380351244,2624.62502504328,11,38
"4000816",17,1925.94977236426,1795.84471379269,2113.95669457394,5,12
"4000817",17,1838.0664092281,1546.64480644268,2113.95669457394,4,13
"4000818",24,2122.92967730258,2007.91609899427,2268.33468283819,11,13
"4000819",20,2162.14957439533,2049.86325433249,2185.35845629437,7,13
"4000820",25,2033.63614081828,1604.62232612027,2287.34065519221,9,16
"4000821",32,2246.98934073276,1662.90725987594,2405.71569249515,13,19
"4000822",29,2416.18875455824,2108.88836172942,2357.79423966008,13,16
"4000823",26,2293.80005746924,2196.22338644287,2305.75108410937,13,13
"4000824",25,2048.92721861327,1861.74881864527,2287.34065519221,11,14
"4000825",23,2235.70111289033,2264.06795088131,2248.68783741607,10,13
"4000826",19,1934.15410668297,1795.00474924369,2162.56636020013,5,14
"4000827",21,2159.13874946743,1980.66092696628,2207.26116887512,10,11
"4000828",17,2007.71235432166,1844.71964896259,2113.95669457394,8,9
"4000829",16,2098.61131210134,1881.13037391165,2087.92318348224,6,10
"4000830",34,2305.0089963903,2100.11304867725,2435.71163614839,11,23
"4000831",29,2191.04389325194,2170.39173060679,2357.79423966008,12,17
"4000832",44,2147.74263109074,1552.13447013912,2567.51523707907,21,23
"4000833",48,2166.49759027298,1501.64228170002,2613.58673801098,17,31
"4000834",23,2176.07173309727,2017.83425436375,2248.68783741607,9,14
"4000835",25,2201.50535152811,2088.18186549903,2287.34065519221,8,17
"4000836",37,2117.42987684155,1426.57574806316,2478.17471526668,11,26
"4000837",26,2158.09193174694,1879.30972144716,2305.75108410937,9,17
"4000838",23,2230.54128497528,2009.53324378293,2248.68783741607,8,15
"4000839",30,2085.62094647562,2013.29012194381,2374.18906024059,14,16
"4000840",18,1924.3355800941,1977.92576275704,2138.79896507223,7,11
"4000841",17,1899.37359974345,1602.60400113106,2113.95669457394,7,10
"4000843",19,1828.26854468687,1557.6821065749,2162.56636020013,5,14
"4000844",37,2388.39140529469,1954.69082910106,2478.17471526668,14,23
"4000845",53,2287.44393167457,1332.86204516975,2667.061866114,23,30
"4000846",43,2362.05743651044,2200.0291883224,2555.47878346624,14,29
"4000847",41,2598.87484178704,2734.05667390128,2530.72175773865,16,25
"4000848",47,2532.67128952848,2045.9623535464,2602.36394728806,17,30
"4000849",44,2552.13747680466,1884.93907530912,2567.51523707907,21,23
"4000850",36,2287.27795372788,1817.13854337817,2464.33502634194,11,25
"4000851",40,2404.23235357153,1485.66818640283,2517.98110851286,13,27
"4000852",41,2429.70359899232,2094.06470417059,2530.72175773865,14,27
"4000853",35,2326.22698226955,1577.54186820332,2450.1860183293,11,24
"44003076",4,1458.02190815782,1373.26426074397,1572.73281143487,0,4
"44003077",5,1494.51521031093,1416.58178615648,1646.12614877363,1,4
"44003078",5,1512.42001933626,1279.53182487465,1646.12614877363,0,5
"44003079",3,1420.37779869852,1384.21552422131,1482.92019466158,0,3
"44003080",6,1502.30537189586,1253.37963147084,1708.62817714657,0,6
"44003081",6,1531.85514338146,1383.49596713374,1708.62817714657,0,6
"44003082",2,1331.51545503893,1229.10847296354,1364.97646362037,0,2
"44003083",9,1567.04610911596,1436.79593530047,1856.26587460569,2,7
"44003084",4,1475.32921963527,1416.05026502347,1572.73281143487,0,4
"44003085",3,1406.83968306322,1349.57854189715,1482.92019466158,0,3
"44003936",4,1458.02190815782,1240.77958768908,1572.73281143487,0,4
"44003937",7,1551.84919822023,1426.51509587934,1763.32076508842,1,6
"44003938",5,1492.20230643646,1490.89251817002,1646.12614877363,1,4
"44003939",4,1451.78371852132,1464.38520935046,1572.73281143487,0,4
"44003940",5,1485.6154530084,1352.52702701673,1646.12614877363,0,5
"44003941",4,1447.93083861015,1270.77035955504,1572.73281143487,0,4
"44003942",6,1553.67446969423,1450.71099216945,1708.62817714657,2,4
"44003943",4,1501.58233223708,1388.96350732358,1572.73281143487,0,4
"44003944",9,1600.94472785611,1394.34201032374,1856.26587460569,1,8
"44003945",7,1572.39889314209,1412.37339002055,1763.32076508842,2,5
"44003946",9,1550.99430003738,1337.14839963989,1856.26587460569,2,7
"44003947",4,1463.03696639655,1267.99432376364,1572.73281143487,0,4
"44003948",4,1463.03696639655,1431.75652831369,1572.73281143487,0,4
"5000250",20,1708.07762092195,1465.91647069794,2185.35845629437,3,17
"5000251",15,1843.81662093584,1828.88715730808,2060.56118614118,4,11
"5000254",18,1950.16341533212,1548.59666660935,2138.79896507223,5,13
"5000255",23,1995.40023583971,1723.92099604081,2248.68783741607,5,18
"5000258",17,1900.7939631807,1623.05310561391,2113.95669457394,2,15
"5000259",14,1758.18555162792,1439.33210458814,2031.70713799962,3,11
"5000262",23,1828.54960218028,1423.66229487268,2248.68783741607,4,19
"5000263",9,1691.28629886051,1658.82169219091,1856.26587460569,2,7
"5000264",8,1695.33189806287,1674.82911215341,1812.11073017574,1,7
"5000265",12,1800.31596406735,1680.98461555679,1968.69006049611,4,8
"5000266",1,1171.61160668803,1175.6015583259,1184.66451052022,0,1
"5000267",2,1317.90000378705,1310.016289266,1364.97646362037,1,1
"5000268",10,1759.66937013235,1724.37606535247,1896.67490607898,2,8
"5000269",7,1664.41742282007,1597.50792345919,1763.32076508842,2,5
"5000270",10,1682.97023223131,1547.44657792725,1896.67490607898,3,7
"5000271",6,1588.3342954546,1197.87219876336,1708.62817714657,3,3
"5000272",16,1638.70165616619,980.650473392834,2087.92318348224,6,10
"5000273",16,1684.89250150986,1163.91084346379,2087.92318348224,4,12
"5000274",11,1751.45777916724,1645.3136554191,1933.98659929558,3,8
"5000275",18,1819.58674778839,1537.51564498794,2138.79896507223,7,11
"5000276",18,1907.03722255197,1624.00071871115,2138.79896507223,6,12
"5000277",18,1814.23668056507,1318.63911046601,2138.79896507223,7,11
"5000278",15,1766.21182331788,1282.37795038686,2060.56118614118,6,9
"5000279",13,1676.78531664582,1263.96360151998,2001.16379457045,6,7
"5000285",13,1757.7828112313,1674.65789085647,2001.16379457045,2,11
"5000286",18,1800.11513506555,1553.89466031001,2138.79896507223,3,15
"5000287",19,1904.53364461924,1829.54501294424,2162.56636020013,2,17
"5000288",23,1891.02631957001,1609.33337332345,2248.68783741607,5,18
"5000292",15,1779.71022371862,1602.32599797344,2060.56118614118,2,13
"5000293",15,1836.69703577241,1902.17474854922,2060.56118614118,2,13
"5000294",17,1803.19294254435,1333.47277167469,2113.95669457394,2,15
"5000295",12,1834.20914202301,1670.25151746424,1968.69006049611,3,9
"5000296",9,1718.09095615796,1569.06134975551,1856.26587460569,2,7
"5000297",3,1387.88806230072,1469.15265900163,1482.92019466158,2,1
"5000298",7,1586.26987191025,1472.49921968999,1763.32076508842,1,6
"5000299",4,1477.99458165694,1514.029128223,1572.73281143487,1,3
"5000301",9,1734.60873574253,1548.7422026265,1856.26587460569,2,7
"5000302",11,1736.3408466469,1582.65348102159,1933.98659929558,2,9
"5000303",19,1991.00304227165,1745.11156643553,2162.56636020013,5,14
"5000304",16,1804.40355933262,1597.10063747066,2087.92318348224,3,13
"5000305",18,1851.18818019771,1521.20595764147,2138.79896507223,4,14
"5000306",16,1739.79045401311,1676.270592785,2087.92318348224,3,13
"5000307",17,1866.36678508755,1669.1710439636,2113.95669457394,2,15
"5000308",19,1892.74287741967,1690.46798369501,2162.56636020013,3,16
"5000309",12,1748.36550587057,1581.59158482901,1968.69006049611,2,10
"5000310",23,1925.15105526587,1600.99993095479,2248.68783741607,6,17
"5000311",17,1781.0208482488,1701.86147024884,2113.95669457394,4,13
"5000312",8,1639.86666370834,1566.03809337085,1812.11073017574,1,7
"5000313",20,1975.90025106303,1611.25552826669,2185.35845629437,5,15
"5000314",12,1814.23892737532,1596.83903209011,1968.69006049611,3,9
"5000315",15,1818.28945786096,1659.63884704502,2060.56118614118,2,13
"5000316",9,1734.60873574253,1593.59698187128,1856.26587460569,2,7
"5000317",12,1820.13823339072,1565.32624362804,1968.69006049611,3,9
"5000318",12,1778.55781015664,1655.24659365187,1968.69006049611,3,9
"5000319",18,1868.44231473784,1706.63606377692,2138.79896507223,4,14
"5000320",17,1838.88056409552,1506.15925505488,2113.95669457394,4,13
"5000321",16,1811.41016618436,1522.41585104308,2087.92318348224,4,12
"5000322",23,1883.2654645882,1440.65926941682,2248.68783741607,5,18
"5000323",20,1903.4142876405,1547.6313985894,2185.35845629437,4,16
"5000324",17,1767.68380859659,1552.3166877949,2113.95669457394,3,14
"5000325",14,1778.92178752467,1490.36685201432,2031.70713799962,3,11
"5000326",14,1846.87902180966,1635.39069811205,2031.70713799962,2,12
"5000327",8,1740.39427860581,1544.25543633359,1812.11073017574,1,7
"5000328",15,1726.84233308791,1243.21442947725,2060.56118614118,4,11
"5000329",14,1761.66406607992,1266.41587187845,2031.70713799962,4,10
"5000330",11,1815.2073298145,1695.76442315926,1933.98659929558,4,7
"5000331",20,1782.28933397276,1441.34735106562,2185.35845629437,2,18
"5000332",21,1873.10326631908,1609.9530060964,2207.26116887512,5,16
"5000333",23,1923.60230215291,1500.1161062923,2248.68783741607,4,19
"5000334",19,1828.15420520823,1551.58430883654,2162.56636020013,2,17
"5000335",16,1924.07793471754,1801.1219348623,2087.92318348224,3,13
"5000336",6,1597.06324745739,1552.35722002849,1708.62817714657,3,3
"5000337",2,1323.54986415138,1349.17760985963,1364.97646362037,1,1
"5000338",2,1327.45292752921,1340.02077931755,1364.97646362037,1,1
"5000339",4,1506.07354882368,1533.88274694471,1572.73281143487,1,3
"5000340",2,1359.78854841344,1336.75162357519,1364.97646362037,1,1
"5000341",2,1312.20988091708,1268.98256937291,1364.97646362037,2,0
"5000342",15,1926.3895387837,1697.10209788468,2060.56118614118,7,8
"5000343",15,1838.01918740944,1460.36688652408,2060.56118614118,4,11
"5000344",5,1498.2508867287,1376.17193529632,1646.12614877363,1,4
"5000345",4,1518.95236578798,1513.07046556758,1572.73281143487,1,3
"5000346",4,1488.03872126135,1492.57633378484,1572.73281143487,1,3
"5000347",8,1639.06244291351,1505.89672858783,1812.11073017574,1,7
"5000348",8,1645.45426706211,1629.60826613099,1812.11073017574,1,7
"5000372",8,1655.67351210688,1570.88645358998,1812.11073017574,3,5
"5000373",16,1881.08125994702,1731.79815768718,2087.92318348224,3,13
"5000374",7,1686.81046210167,1494.45699388084,1763.32076508842,2,5
"5000375",7,1686.81046210167,1524.02200362506,1763.32076508842,2,5
"5000376",4,1530.0469885413,1435.58845978584,1572.73281143487,2,2
"5000377",3,1432.71993393725,1424.87565157849,1482.92019466158,1,2
"5000378",4,1511.93311907923,1531.66666259905,1572.73281143487,1,3
"5000379",16,1882.47993021103,1632.1856320459,2087.92318348224,5,11
"5000380",18,1880.19795274953,1801.8789876016,2138.79896507223,4,14
"5000381",18,1714.71509762005,1581.0117942266,2138.79896507223,5,13
"5000382",9,1706.19956731143,1573.74774061432,1856.26587460569,3,6
"5000383",7,1660.15232510063,1531.83166863629,1763.32076508842,2,5
"5000384",9,1718.62514941283,1721.80207878592,1856.26587460569,3,6
"5000385",10,1694.59503091279,1609.9165548738,1896.67490607898,1,9
"5000386",2,1323.54986415138,1333.56161916416,1364.97646362037,1,1
"5000387",5,1541.53919627144,1536.22363727142,1646.12614877363,2,3
"5000388",2,1323.54986415138,1340.02077931755,1364.97646362037,1,1
"5000389",14,1772.6352829636,1666.67049337216,2031.70713799962,2,12
"5000390",9,1749.96874885318,1685.16783470946,1856.26587460569,1,8
"5000391",7,1639.78982975056,1603.48381507501,1763.32076508842,1,6
"5000392",11,1704.66324537423,1593.35518068152,1933.98659929558,2,9
"5000393",15,1773.29446665232,1478.53417611062,2060.56118614118,4,11
"5000394",9,1714.11283664474,1650.44853989624,1856.26587460569,2,7
"5000395",9,1712.63209800818,1738.24860887337,1856.26587460569,2,7
"5000396",10,1810.85419710645,1734.06524233034,1896.67490607898,2,8
"5000397",10,1738.12969241893,1690.48024657356,1896.67490607898,2,8
"5000398",13,1769.33736715418,1875.59134858495,2001.16379457045,2,11
"5000399",8,1695.91502994156,1645.81278309173,1812.11073017574,1,7
"5000400",20,1760.49538540118,1701.2616371431,2185.35845629437,2,18
"5000401",11,1769.77842621654,1620.98094649872,1933.98659929558,3,8
"5000402",10,1735.3261539481,1717.11272608272,1896.67490607898,2,8
"5000403",14,1811.07501754594,1663.37333411476,2031.70713799962,3,11
"5000404",12,1773.78775578843,1606.52959275378,1968.69006049611,2,10
"5000405",15,1714.40954780304,1620.6033221709,2060.56118614118,4,11
"5000406",6,1552.64467818512,1450.11145955286,1708.62817714657,1,5
"5000407",7,1572.45862528671,1399.10899851406,1763.32076508842,2,5
"5002348",21,1934.16320810081,1714.52912270675,2207.26116887512,4,17
"5002349",20,1874.50163751559,1680.5533916222,2185.35845629437,3,17
"5002363",7,1541.28913873151,1302.51500268385,1763.32076508842,3,4
"5002364",10,1677.94933941297,1543.64444985556,1896.67490607898,2,8
"506002951",35,2070.33344110862,1313.80350593451,2450.1860183293,10,25
"506002952",25,2288.96601898328,2110.87399703391,2287.34065519221,5,20
"506002953",29,2521.09289431918,2804.19352855217,2357.79423966008,8,21
"506002956",26,2379.59657315962,2492.32201243901,2305.75108410937,10,16
"506002957",28,2449.35158660677,2466.64610905519,2340.94327947849,9,19
"506002958",24,2476.57390523968,2556.09921449123,2268.33468283819,5,19
"506002959",27,2424.08593095913,2649.54303803674,2323.60649590586,9,18
"506002960",31,2319.94384894235,2363.24102553557,2390.15469389133,7,24
"506002961",32,2174.68016748165,1941.68190455481,2405.71569249515,8,24
"506002962",26,2412.70471178537,2257.0080100206,2305.75108410937,6,20
"506002963",31,2392.01046805575,2436.36942930834,2390.15469389133,7,24
"506002964",26,2230.27967945605,1780.38154049178,2305.75108410937,8,18
"506002965",21,2183.41187352151,2229.83629795241,2207.26116887512,6,15
"506002966",17,2247.5529873231,2125.93465757584,2113.95669457394,6,11
"506002967",32,2281.06059862827,1793.0730352707,2405.71569249515,9,23
"506002968",30,2374.27218775566,2255.03597911469,2374.18906024059,9,21
"506002969",30,2436.05116082488,2175.50752307827,2374.18906024059,9,21
"506002970",22,2129.60226136051,2165.71598685475,2228.3491786518,6,16
"506002971",28,2512.9698312163,2285.45929471204,2340.94327947849,9,19
"506002972",32,2213.6685061498,2279.7828199326,2405.71569249515,6,26
"506002973",28,2080.60730484425,1781.30892856361,2340.94327947849,9,19
"506002974",24,2249.25668248667,2053.04654700571,2268.33468283819,8,16
"506002975",31,2419.36678058166,2188.14871363694,2390.15469389133,9,22
"506002976",34,2480.75588370601,2383.21823941823,2435.71163614839,9,25
"506002977",20,2147.62003806688,1965.09822676655,2185.35845629437,5,15
"506002979",11,1930.60214463641,1800.45767360833,1933.98659929558,2,9
"506002980",17,2016.9266587468,2032.5097403521,2113.95669457394,2,15
"506002981",17,1982.15545409161,1897.98377708583,2113.95669457394,3,14
"506002982",22,1942.93321485153,2111.46056564763,2228.3491786518,4,18
"506002983",8,1792.3364495442,1833.67461429843,1812.11073017574,1,7
"506002984",14,1898.65102664499,2059.56213867398,2031.70713799962,3,11
"506002985",7,1720.8686367796,1756.43927801725,1763.32076508842,1,6
"506002986",14,1952.97554635031,1984.26053386318,2031.70713799962,2,12
"506002987",22,2098.91880037555,2021.3206318656,2228.3491786518,4,18
"506002988",17,1925.62375969925,2141.66351187287,2113.95669457394,1,16
"506002989",16,1781.07635407698,1700.58624385591,2087.92318348224,3,13
"506002991",22,2007.6951712102,1607.87420454793,2228.3491786518,6,16
"506002993",16,1939.29343300782,1704.14614084685,2087.92318348224,2,14
"506002994",33,2220.69997221109,1846.50750522184,2420.89448855093,12,21
"506002995",31,2394.24006521674,2089.26279749772,2390.15469389133,8,23
"506002996",30,2187.09975002799,1643.77728461628,2374.18906024059,6,24
"506002997",23,2208.44409968969,1780.67693413073,2248.68783741607,3,20
"506002998",22,2216.72185967903,1909.18837845028,2228.3491786518,5,17
"506002999",34,2297.9714097832,1571.47129614355,2435.71163614839,9,25
"506003000",33,2339.26286627439,1875.89020871114,2420.89448855093,8,25
"506003001",31,2062.13026957897,1127.18951832586,2390.15469389133,10,21
"506003002",26,2080.89445267935,1486.54265461591,2305.75108410937,7,19
"506003003",28,2250.0128928818,1911.71437535444,2340.94327947849,5,23
"506003004",30,2109.47802365565,1566.76901530731,2374.18906024059,6,24
"506003335",23,2522.79660573719,2685.55649498444,2248.68783741607,9,14
"506003336",26,2547.06553744995,2581.52427580929,2305.75108410937,10,16
"506003351",27,2339.19611909243,2401.60767201951,2323.60649590586,8,19
"506003353",31,2212.84776115662,1918.7525999487,2390.15469389133,11,20
"506003712",31,2469.5059650069,2748.00241235504,2390.15469389133,12,19
"506003797",35,2183.265937599,1533.52916335161,2450.1860183293,9,26
"506003805",28,2480.79760202968,2442.38048838109,2340.94327947849,10,18
"506003807",34,2646.93600798115,2568.06324026122,2435.71163614839,11,23
"506003808",28,2541.26407721161,2506.11145044091,2340.94327947849,9,19
"506003809",33,2697.71709834223,2763.32735135024,2420.89448855093,10,23
"506003810",27,2317.34704975229,2401.38555225215,2323.60649590586,10,17
"506003815",26,2219.30147105502,1719.04648818811,2305.75108410937,8,18
"506003816",23,2379.35210731313,2414.45542062349,2248.68783741607,7,16
"506003817",22,2409.66455431571,2460.00475694536,2228.3491786518,8,14
"506003818",29,2336.13349798621,2397.3362438742,2357.79423966008,7,22
"506003820",28,2439.21704420256,2288.37475281401,2340.94327947849,8,20
"506003821",33,2423.79244418344,2134.42837941414,2420.89448855093,10,23
"506003822",31,2083.71048537945,1763.14159025069,2390.15469389133,10,21
"506003823",13,1930.45918921967,1857.48199521967,2001.16379457045,0,13
"506003824",16,2035.24052308566,2122.85930642394,2087.92318348224,2,14
"506003825",12,1951.74710654761,2050.19248100019,1968.69006049611,1,11
"506003826",15,1910.31066859409,1819.50804844907,2060.56118614118,1,14
"506003827",21,2013.75437566374,1679.65332877602,2207.26116887512,3,18
"506003828",14,1891.30472542869,1868.92415144594,2031.70713799962,1,13
"506003829",18,2062.06840000053,2142.44696541232,2138.79896507223,3,15
"506003832",13,1803.93211420999,1877.40991462529,2001.16379457045,4,9
"506003833",12,1844.79225236071,1814.42062079189,1968.69006049611,2,10
"506003834",32,1999.65400796475,1500.06481138948,2405.71569249515,7,25
"506003835",18,2132.28941162037,2140.6457515269,2138.79896507223,4,14
"506003836",16,2176.51580937669,2285.85880737404,2087.92318348224,3,13
"506003837",15,1800.52970246458,1481.69883153784,2060.56118614118,3,12
"506003838",21,2161.13112867289,2169.36008282068,2207.26116887512,3,18
"506003839",25,2438.4804153103,2149.57518423481,2287.34065519221,6,19
"506003840",27,2192.24271996015,1704.9305590136,2323.60649590586,6,21
"506003841",27,2333.22266493817,2025.61351034097,2323.60649590586,7,20
"506003842",31,2368.38926271066,1939.63132020724,2390.15469389133,8,23
"506003844",31,2647.18829744003,2642.14400635293,2390.15469389133,9,22
"506003845",30,2370.00813801172,2266.14926612991,2374.18906024059,9,21
"506003846",22,2023.08602972958,1704.02918378759,2228.3491786518,5,17
"507003166",36,2285.34272440787,2430.85005704704,2464.33502634194,5,31
"507003167",36,2320.18619863905,2003.99126992476,2464.33502634194,7,29
"507003168",26,2296.6497604179,2329.60056463003,2305.75108410937,5,21
"507003169",23,2398.6687999709,2362.47281755136,2248.68783741607,3,20
"507003170",30,2141.89800174033,1787.54429510228,2374.18906024059,7,23
"507003171",27,2076.65642346622,1660.63775887637,2323.60649590586,5,22
"507003172",36,2164.56068722711,1792.18220222889,2464.33502634194,9,27
"507003173",20,2232.61069815299,2278.10780446188,2185.35845629437,3,17
"507003174",26,2021.68130284102,1611.62286952457,2305.75108410937,4,22
"507003175",30,1994.48421113999,1498.26155832901,2374.18906024059,5,25
"507003176",35,2106.45566577265,1632.52450318223,2450.1860183293,8,27
"507003177",44,1981.88531032834,1703.02462816531,2567.51523707907,12,32
"507003178",29,2374.04844569506,2444.47556053459,2357.79423966008,6,23
"507003179",28,2281.36740487673,2161.70703775358,2340.94327947849,4,24
"507003180",33,2223.97232467444,1823.47074419398,2420.89448855093,8,25
"507003181",24,2394.16213808521,1971.73997784682,2268.33468283819,6,18
"507003182",28,2212.111694384,1960.37591939466,2340.94327947849,6,22
"507003183",23,2154.71351859075,1910.24998933646,2248.68783741607,4,19
"507003184",23,2154.97124790067,2011.20319159447,2248.68783741607,4,19
"507003185",20,2181.52366164712,2030.2444040549,2185.35845629437,5,15
"507003186",12,1846.07228350318,1771.06503692679,1968.69006049611,1,11
"507003187",25,2310.07599784236,2238.20977506691,2287.34065519221,4,21
"507003189",16,2161.60732698355,2192.5772505834,2087.92318348224,1,15
"507003190",28,2407.76101208947,2249.57989211693,2340.94327947849,4,24
"507003191",31,2323.08878275147,2040.68977346387,2390.15469389133,8,23
"507003192",20,2193.86867268624,1964.99487108479,2185.35845629437,5,15
"507003193",27,2293.73864674979,2072.6665444789,2323.60649590586,6,21
"507003194",28,2337.05970121323,2060.00553410775,2340.94327947849,7,21
"507003195",37,2253.94007328048,1775.61860029629,2478.17471526668,7,30
"507003196",32,2208.38688828282,2069.82056319221,2405.71569249515,5,27
"507003197",23,1951.50042865903,1354.71191885215,2248.68783741607,9,14
"507003198",29,2352.51443404905,1839.35628888156,2357.79423966008,7,22
"507003199",30,2324.45203033995,1962.00040925339,2374.18906024059,6,24
"507003200",25,2212.16902608213,2259.31426153462,2287.34065519221,5,20
"507003201",30,2291.35025182349,2002.07554062889,2374.18906024059,6,24
"507003202",27,2079.13260869656,1584.22660832869,2323.60649590586,3,24
"507003203",34,2243.37454728689,1996.49598568545,2435.71163614839,6,28
"507003204",25,2074.92593600236,1654.76781202669,2287.34065519221,3,22
"507003205",32,2300.58276024744,1812.40597603473,2405.71569249515,3,29
"507003206",31,2253.88030985442,2243.14436115926,2390.15469389133,7,24
"507003207",39,2092.71718928125,1985.93594523237,2504.98447234734,6,33
"507003208",33,2435.7056058532,2072.97589541722,2420.89448855093,7,26
"507003209",9,1915.14842000393,1977.60788039656,1856.26587460569,1,8
"507003210",28,2343.70218987458,2168.90444423303,2340.94327947849,6,22
"507003211",30,2311.07760870477,1832.92143506726,2374.18906024059,7,23
"507003212",18,2148.02887714829,1897.97310324004,2138.79896507223,3,15
"507003213",27,2374.56727755805,2343.70574451879,2323.60649590586,8,19
"507003214",37,2171.56576157507,1786.75161885072,2478.17471526668,10,27
"507003215",32,2413.21261562038,2358.35356604404,2405.71569249515,11,21
"507003216",22,2254.55506901989,2077.69779133614,2228.3491786518,7,15
"507003217",26,2237.79748595525,2168.06896311789,2305.75108410937,7,19
"507003218",32,2245.99041240621,1584.61256333463,2405.71569249515,9,23
"507003219",34,2607.60261347851,2694.21681003519,2435.71163614839,8,26
"507003220",34,2323.26931607136,1962.31551488025,2435.71163614839,9,25
"507003221",29,2366.55035308798,2140.87013812055,2357.79423966008,4,25
"507003222",23,2354.49896565808,2181.0580777,2248.68783741607,3,20
"507003223",24,2238.25519646015,2096.80500991018,2268.33468283819,1,23
"507003224",36,2012.6184812687,1471.21279341794,2464.33502634194,7,29
"507003225",30,2282.40087834397,2311.527148923,2374.18906024059,6,24
"507003226",35,2315.36863718222,2142.58620424837,2450.1860183293,4,31
"507003227",34,2062.71396647546,1799.61373736767,2435.71163614839,7,27
"507003228",24,2254.48584860703,2243.79472973286,2268.33468283819,5,19
"507003229",29,2395.01299155851,2345.79174238244,2357.79423966008,6,23
"507003230",30,2295.41064247291,2094.82920418129,2374.18906024059,8,22
"507003231",23,2144.02357573643,2031.36809270542,2248.68783741607,4,19
"507003232",36,2112.62852782766,1656.23561192516,2464.33502634194,6,30
"507003233",23,2085.07303312374,2059.58989121905,2248.68783741607,6,17
"507003234",27,2292.14708053395,2237.51540875124,2323.60649590586,5,22
"507003235",21,2188.32445032427,2171.18294061216,2207.26116887512,4,17
"507003236",34,2187.60908282324,1876.76575952323,2435.71163614839,6,28
"507003237",29,2138.72467359931,2135.58767136845,2357.79423966008,8,21
"507003238",30,2099.70020504707,1495.03747975943,2374.18906024059,6,24
"507003524",21,2168.90794057576,2044.73923709169,2207.26116887512,4,17
"507003528",22,2197.53543610091,2417.20558813198,2228.3491786518,1,21
"507003532",26,2538.67119964136,2351.0988342328,2305.75108410937,7,19
"507003536",26,2539.45227407606,2608.43140175994,2305.75108410937,8,18
"507003539",27,2300.05959370366,2304.49168800247,2323.60649590586,5,22
"507003541",25,2332.0310414432,2356.23345447293,2287.34065519221,3,22
"507003548",19,2321.76693197134,2544.5117706261,2162.56636020013,5,14
"507003552",25,2467.1136546546,2435.43441699363,2287.34065519221,7,18
"507003556",22,2385.06699280716,2467.13955829712,2228.3491786518,4,18
"507003562",26,2426.54818441207,2218.47386313487,2305.75108410937,3,23
"507003573",18,2241.05346765554,2291.15249813361,2138.79896507223,6,12
"507003574",26,2395.41506844124,2383.46486306597,2305.75108410937,6,20
"507003577",24,2218.74752601665,2023.93209453103,2268.33468283819,6,18
"507003580",32,2236.83090125368,2031.43355565495,2405.71569249515,8,24
"507003585",16,1994.31763414216,1771.9860185924,2087.92318348224,4,12
"507003587",27,2297.84113352547,1900.45035692308,2323.60649590586,6,21
"507003590",24,2152.44049389572,2165.349648687,2268.33468283819,4,20
"507003591",29,2340.56399888671,1850.40699704035,2357.79423966008,7,22
"507003594",21,2376.85942385511,2253.8516450749,2207.26116887512,6,15
"507003595",30,2430.13864366924,2110.28361997206,2374.18906024059,7,23
"507003596",18,2034.76105077943,1776.18988634641,2138.79896507223,6,12
"507003597",26,2332.17670183916,2076.4116244989,2305.75108410937,7,19
"507003598",20,2247.3158415147,2134.41518943598,2185.35845629437,3,17
"507003599",23,2285.4626859451,2307.76066522242,2248.68783741607,4,19
"507003600",20,2263.96864667864,2127.51353506344,2185.35845629437,3,17
"507003601",24,2307.7287052603,2362.44404530974,2268.33468283819,7,17
"507003602",22,2070.80300820732,1933.70546963399,2228.3491786518,7,15
"507003603",26,2158.79300616383,2211.81136936157,2305.75108410937,7,19
"507003607",31,2435.41967638341,2315.19481037944,2390.15469389133,7,24
"507003609",25,2290.41057174022,1965.51006869985,2287.34065519221,8,17
"507003610",24,2360.01656031012,2293.01312746363,2268.33468283819,7,17
"507003611",22,2203.02738291095,1935.0269951435,2228.3491786518,3,19
"507003613",30,2175.01740083307,1967.09481020873,2374.18906024059,4,26
"507003614",25,2194.38709091306,2071.53470748563,2287.34065519221,7,18
"507003615",32,2532.2866555204,2530.48009833502,2405.71569249515,8,24
"507003616",17,2055.86649033942,2036.71064193471,2113.95669457394,1,16
"507003617",27,2334.73215557748,2245.6581464496,2323.60649590586,4,23
"507003618",22,2296.47477366714,2254.9289259611,2228.3491786518,4,18
"507003619",41,2466.02439902337,2192.00335731349,2530.72175773865,11,30
"507003621",26,2284.40319351084,2019.98281760731,2305.75108410937,2,24
"507003794",19,2066.32346914525,2265.68608112757,2162.56636020013,2,17
"507003795",20,2110.42235460262,2210.53591351325,2185.35845629437,4,16
"507003796",32,2181.62580210569,1991.12748394238,2405.71569249515,8,24
"507003798",22,2362.72622747944,2318.8789671253,2228.3491786518,3,19
"507003799",24,2414.70784874999,2404.67509498227,2268.33468283819,2,22
"507003803",29,2327.70521014515,2235.90430994768,2357.79423966008,6,23
"507003804",31,2479.39456903629,2550.50315455636,2390.15469389133,7,24
"507003847",28,2420.38138558004,2309.0322820666,2340.94327947849,6,22
"507003848",21,2040.31445046161,1685.83946613345,2207.26116887512,5,16
"507003849",24,2254.97247601584,2110.40458001795,2268.33468283819,3,21
"507003850",19,2111.90598513274,2134.94071352254,2162.56636020013,2,17
"507003851",20,2125.30018272227,2330.75854569662,2185.35845629437,5,15
"507003852",26,2358.78679988497,2306.09942688484,2305.75108410937,5,21
"507003854",23,2387.64111405046,2531.06072954537,2248.68783741607,3,20
"507003855",32,2312.05713103519,2526.46306313582,2405.71569249515,7,25
"507003856",28,2434.35829145653,2519.20996084086,2340.94327947849,6,22
"507003857",27,2389.94776032827,2295.03470765496,2323.60649590586,7,20
"507003858",28,2329.52751736758,1964.37619484078,2340.94327947849,7,21
"507003859",34,2322.05318014317,1847.76686904164,2435.71163614839,8,26
"507003860",30,2390.90259282249,2231.08612910611,2374.18906024059,7,23
"507003861",22,2385.31548872666,2674.32853765495,2228.3491786518,3,19
"507003862",26,2190.794662335,1785.37835684724,2305.75108410937,9,17
"507003863",30,2341.8373613021,2080.80354803261,2374.18906024059,7,23
"507003864",30,2452.01544573972,2275.71788402112,2374.18906024059,5,25
"507003865",30,2222.0286807949,1967.112722829,2374.18906024059,7,23
"507003866",26,2349.33013329911,2203.74318960279,2305.75108410937,5,21
"507003867",26,2055.58937772228,1606.53695952875,2305.75108410937,6,20
"507003868",30,2504.54403563162,2548.39655461895,2374.18906024059,8,22
"507003869",23,2302.38504329187,2169.0005328321,2248.68783741607,5,18
"507003870",26,2244.22186640261,2204.37218442726,2305.75108410937,3,23
"507003871",24,2326.13179302294,2301.85733925042,2268.33468283819,7,17
"507003872",46,2254.86568144862,1978.62558935951,2590.94954296761,9,37
"507003873",35,2295.62034324816,2157.7017942241,2450.1860183293,7,28
"507003874",6,1792.52801117538,1772.83349411489,1708.62817714657,0,6
"507003875",10,1965.98245380872,1818.74625484999,1896.67490607898,0,10
"507003876",30,2427.51865058061,2394.73321795137,2374.18906024059,10,20
"507003877",31,2279.90279084696,2111.77653570629,2390.15469389133,7,24
"507003878",14,2035.54023798268,1742.7831656116,2031.70713799962,5,9
"507003879",24,2281.2154085826,2163.8676234221,2268.33468283819,7,17
"507003880",31,2123.05546529635,1680.34838813759,2390.15469389133,10,21
"507003881",25,2344.91222948741,2266.31095955258,2287.34065519221,7,18
"507003882",27,2258.48593485293,1947.77847881136,2323.60649590586,6,21
"507003883",28,2341.2009158869,1967.01811664436,2340.94327947849,10,18
"507003884",26,2265.33545663787,1727.01611913892,2305.75108410937,9,17
"507003885",26,2393.67755238244,2635.85683080899,2305.75108410937,4,22
"507003886",28,2381.90256764564,2145.2316626338,2340.94327947849,6,22
"507003889",23,2298.18029607249,2129.60656185618,2248.68783741607,5,18
"507003890",24,2096.0934747298,2118.98564115804,2268.33468283819,3,21
"507003891",28,2256.43762978875,2210.80240006296,2340.94327947849,8,20
"507003892",29,2167.61542377657,1756.37737409989,2357.79423966008,3,26
"507003893",31,2176.0581679906,1968.60899645296,2390.15469389133,6,25
"507003894",28,2313.65298027829,2219.57784554959,2340.94327947849,5,23
"507003895",35,2362.69105590336,1851.33235442682,2450.1860183293,6,29
"507003896",31,2186.68582238678,1883.98816599598,2390.15469389133,4,27
"507003897",25,2294.27213815596,2559.7453408704,2287.34065519221,7,18
"507003898",13,2045.9612985565,2235.68236473257,2001.16379457045,2,11
"507003899",25,2294.58263662394,2269.31317475784,2287.34065519221,7,18
"507003900",16,2090.2696703338,2091.37200335784,2087.92318348224,3,13
"507003902",27,2330.37808344669,2261.61071896475,2323.60649590586,5,22
"507003903",28,2185.90141055852,1722.6743498627,2340.94327947849,6,22
"507003904",27,2204.04451180614,1974.43255913173,2323.60649590586,4,23
"507003906",26,2123.30987405962,1846.22460245501,2305.75108410937,6,20
"507003907",34,1998.86049669518,1349.61441504517,2435.71163614839,8,26
"56002942",1,1182.48225129826,1184.66451052022,1184.66451052022,0,1
"56002943",2,1301.85735685794,1279.51129589671,1364.97646362037,1,1
"56002944",1,1156.7137837883,1153.99347681632,1184.66451052022,0,1
"56002945",1,1156.7137837883,1184.66451052022,1184.66451052022,0,1
"56002948",1,1156.7137837883,1184.66451052022,1184.66451052022,0,1
"56003790",1,1156.7137837883,1184.66451052022,1184.66451052022,0,1
"56003791",1,1159.73743327293,1184.66451052022,1184.66451052022,0,1
"593003365",20,1954.50570253014,1934.66184992292,2185.35845629437,5,15
"593003366",19,1971.16642293298,1655.89038788005,2162.56636020013,7,12
"593003367",16,1916.43443598459,1638.26815268685,2087.92318348224,4,12
"593003368",23,1851.36449286469,1231.04715853615,2248.68783741607,8,15
"593003369",20,1844.63520842433,1962.86562025371,2185.35845629437,7,13
"593003370",12,1696.67852053605,1485.74763474833,1968.69006049611,2,10
"593003371",15,1747.84458662381,1696.45652813548,2060.56118614118,5,10
"593003372",26,1912.56613005136,1509.0799697336,2305.75108410937,7,19
"593003373",14,1830.13209405027,1660.16285151744,2031.70713799962,2,12
"593003374",19,1928.49428458452,1562.1082537209,2162.56636020013,6,13
"593003375",28,1945.91917327027,1484.13400523295,2340.94327947849,9,19
"593003376",29,1927.81286990145,1395.7062693823,2357.79423966008,10,19
"593003377",19,2043.0155805117,1661.75212757805,2162.56636020013,9,10
"593003378",20,1892.29867643663,1321.00294029653,2185.35845629437,8,12
"593003379",23,2010.93786676842,1537.51511582731,2248.68783741607,7,16
"593003380",20,2059.2884698792,1691.38025822683,2185.35845629437,9,11
"593003381",17,1766.78782142659,1747.36410334476,2113.95669457394,6,11
"593003382",12,1726.32523446398,1498.88132910084,1968.69006049611,3,9
"593003383",16,1941.76513775533,1881.6202249623,2087.92318348224,7,9
"593003384",17,1911.14623715211,1596.11956463867,2113.95669457394,6,11
"593003385",18,1882.18218485879,2112.5463765517,2138.79896507223,3,15
"593003386",13,1974.92289153843,2005.13892581612,2001.16379457045,3,10
"593003387",19,1925.09231377747,1914.03231161281,2162.56636020013,4,15
"593003388",16,1984.73015628565,1687.09023759449,2087.92318348224,4,12
"593003389",20,1926.15927042483,1784.66365647685,2185.35845629437,6,14
"593003390",16,1922.28673366731,1663.8009831277,2087.92318348224,6,10
"593003391",14,1782.87616446973,1631.32917748649,2031.70713799962,3,11
"593003392",19,1957.97903524556,1657.18127595291,2162.56636020013,4,15
"593003393",21,1950.66611228733,1826.76080784894,2207.26116887512,7,14
"593003394",20,2032.30414868299,1664.7842335584,2185.35845629437,7,13
"593003395",24,1825.17232348619,1822.50702260699,2268.33468283819,7,17
"593003396",18,2040.73293736018,1670.72627764358,2138.79896507223,8,10
"593003397",15,1901.99687298154,1744.18909045121,2060.56118614118,6,9
"593003398",14,1902.01716869102,1489.14796520101,2031.70713799962,5,9
"593003399",20,2025.05076302043,1773.18107016962,2185.35845629437,7,13
"593003400",21,1911.28915262443,1082.74897633501,2207.26116887512,8,13
"593003401",21,1956.37424273068,1973.44267664369,2207.26116887512,6,15
"593003402",20,1860.08974633854,1504.99869578935,2185.35845629437,9,11
"593003403",15,1968.25160109415,1900.77982753508,2060.56118614118,5,10
"593003404",23,1949.08472913285,1497.61222661006,2248.68783741607,5,18
"593003405",21,1968.01327165594,1650.46713035643,2207.26116887512,5,16
"593003406",20,2004.24577276405,1575.10556787476,2185.35845629437,5,15
"593003407",14,2018.50686022026,1908.96029496565,2031.70713799962,4,10
"593003408",19,1874.88897491676,1776.08864108871,2162.56636020013,7,12
"593003409",18,1927.54182480637,1680.78069450104,2138.79896507223,7,11
"593003410",8,1680.20329501896,1476.06216120297,1812.11073017574,1,7
"593003411",17,1902.14215529625,1949.79127587751,2113.95669457394,4,13
"593003412",16,1908.93874793686,1893.97101576679,2087.92318348224,5,11
"593003413",15,1913.82713347096,1780.67517381321,2060.56118614118,5,10
"593003414",21,1984.04369627754,1485.70476114446,2207.26116887512,7,14
"593003415",17,2011.65772147051,1712.30617419742,2113.95669457394,6,11
"593003416",13,1926.16618552287,1584.17857922779,2001.16379457045,3,10
"593003417",17,2031.92704547092,1646.67430033344,2113.95669457394,4,13
"593003418",16,1948.75109913199,1882.99081322187,2087.92318348224,5,11
"593003419",13,1861.24506166917,1657.00003221666,2001.16379457045,4,9
"593003420",21,1890.77456919749,1700.39446725208,2207.26116887512,5,16
"593003421",13,1827.15587205114,1503.06209147199,2001.16379457045,5,8
"593003422",16,1968.96172719485,1675.01838407846,2087.92318348224,5,11
"593003423",23,2180.47797487798,1974.92914491929,2248.68783741607,5,18
"593003424",25,2252.04005540505,2002.05685192085,2287.34065519221,8,17
"593003425",20,2091.97767083822,1782.05235103836,2185.35845629437,4,16
"593003426",18,2088.81201888341,1594.18990905784,2138.79896507223,5,13
"593003427",9,1855.46335685265,1842.47010672728,1856.26587460569,0,9
"593003428",20,2074.72972986446,1712.04030356986,2185.35845629437,4,16
"593003429",29,2129.71159122256,1949.7794740612,2357.79423966008,8,21
"593003430",30,2097.34349440352,1416.41281757166,2374.18906024059,8,22
"593003431",21,2100.92553265615,2122.9795369677,2207.26116887512,7,14
"593003432",14,1968.28127110789,1866.73088883641,2031.70713799962,2,12
"593003433",22,2006.58480554739,1804.62946921484,2228.3491786518,6,16
"593003434",26,2116.92361948801,1599.42036370469,2305.75108410937,7,19
"593003435",23,2026.79507216377,1444.43995140077,2248.68783741607,5,18
"593003436",18,1881.33767244681,1256.29212498791,2138.79896507223,5,13
"593003437",22,1980.01812895676,1604.28216840192,2228.3491786518,6,16
"593003438",22,1923.78219002354,1501.10748293613,2228.3491786518,7,15
"593003439",35,2123.75807428965,1264.08418161353,2450.1860183293,10,25
"593003440",32,2004.55114323329,1460.30372576364,2405.71569249515,9,23
"593003441",25,1992.84889180591,1767.76325233795,2287.34065519221,8,17
"593003442",26,1978.58536461773,1298.38158495961,2305.75108410937,9,17
"593003443",22,2005.87412949788,1711.44045636594,2228.3491786518,4,18
"593003444",28,1940.15349414701,1268.28687778878,2340.94327947849,9,19
"593003447",27,2107.12347308913,1580.08099692616,2323.60649590586,6,21
"593003448",28,2162.36448526436,2026.69648497471,2340.94327947849,7,21
"593003449",23,2122.86150168166,1678.18440779606,2248.68783741607,7,16
"593003454",30,2036.08365591561,1736.15701031841,2374.18906024059,11,19
"593003455",20,2078.06474941983,1904.13796025871,2185.35845629437,5,15
"593003456",18,2008.83736179179,1756.81059224932,2138.79896507223,5,13
"593003457",32,2295.61724420315,1748.77337755958,2405.71569249515,10,22
"593003458",17,2051.66686779621,1859.36295514995,2113.95669457394,6,11
"593003459",30,2054.22358922157,1283.01338630541,2374.18906024059,8,22
"593003460",30,2054.26516720326,1569.45813249504,2374.18906024059,9,21
"593003461",26,1901.07707284457,1171.21260170907,2305.75108410937,8,18
"593003462",26,1909.92301589458,1335.4420441733,2305.75108410937,7,19
"593003463",34,1818.00728063152,1322.10630544842,2435.71163614839,10,24
"593003464",20,2322.42329817357,2064.03178903676,2185.35845629437,7,13
"593003465",26,2399.67473669187,2198.71104546153,2305.75108410937,6,20
"593003466",25,2379.32240215645,2102.02224037551,2287.34065519221,6,19
"593003467",24,2200.6256910553,2126.48182835764,2268.33468283819,8,16
"593003468",26,2410.03914146205,2330.26308527569,2305.75108410937,9,17
"593003469",24,2368.50743520057,2089.4264050664,2268.33468283819,8,16
"593003470",23,2342.46060325812,2159.43120856838,2248.68783741607,7,16
"593003471",24,2362.75302679693,2146.29266357984,2268.33468283819,8,16
"593003472",24,2177.74356711663,2301.62126892367,2268.33468283819,8,16
"593003473",29,2255.92055499593,2518.45127259609,2357.79423966008,8,21
"593003474",27,2336.36688528396,2315.5496488837,2323.60649590586,7,20
"593003475",24,2287.5396594662,2439.79352997078,2268.33468283819,7,17
"593003476",35,2320.8461134765,2688.8347846814,2450.1860183293,13,22
"593003478",17,2195.56130526506,1881.63942646384,2113.95669457394,6,11
"593003479",25,2344.78857464763,2011.79533688892,2287.34065519221,9,16
"593003482",21,2200.61578442097,1877.13371540269,2207.26116887512,6,15
"593003483",24,2190.70886776336,2386.53085707971,2268.33468283819,8,16
"593003484",23,2315.7250775478,2147.71005299639,2248.68783741607,8,15
"593003485",26,2006.09578561557,1468.36859386703,2305.75108410937,6,20
"593003486",31,2182.62148095103,1476.56539510543,2390.15469389133,8,23
"593003487",21,2183.81915131172,2077.15062508394,2207.26116887512,3,18
"593003488",18,2087.17041311781,2128.49586198589,2138.79896507223,4,14
"593003489",22,1975.78700716612,1397.97808805078,2228.3491786518,6,16
"593003490",23,2356.2202873172,2288.37331650803,2248.68783741607,6,17
"593003491",25,2096.64646977233,1619.62091565947,2287.34065519221,7,18
"593003492",20,2147.40802427085,1983.44386051709,2185.35845629437,5,15
"593003493",25,2252.8324067259,2044.53220361916,2287.34065519221,7,18
"593003494",26,2378.578779238,2378.07756970707,2305.75108410937,8,18
"593003495",31,2067.55704149013,1544.54423808448,2390.15469389133,9,22
"593003496",20,1974.97864782384,1710.92067125812,2185.35845629437,4,16
"593003497",31,2079.82339106697,1414.22926599469,2390.15469389133,8,23
"593003498",20,2113.85374101018,1781.64197101783,2185.35845629437,6,14
"593003503",26,2083.18680515718,1754.88773904457,2305.75108410937,5,21
"593003505",18,2011.84452526117,1961.21693968872,2138.79896507223,2,16
"593003507",24,1848.29258578519,1598.82816853842,2268.33468283819,4,20
"593003508",20,2025.44783682453,1668.81487933167,2185.35845629437,4,16
"593003509",27,2150.20071154658,1613.37609490622,2323.60649590586,7,20
"593003510",23,2076.38854547199,1876.46540891399,2248.68783741607,4,19
"593003511",18,2210.91876246443,1876.36232759183,2138.79896507223,2,16
"593003512",24,2041.50484510737,1605.63203980857,2268.33468283819,4,20
"593003513",24,2001.0206907369,1675.38892105343,2268.33468283819,4,20
"593003514",27,2194.43197576728,1905.09455516488,2323.60649590586,4,23
"593003515",31,2102.61310331786,1586.31199034579,2390.15469389133,6,25
"593003516",18,1998.75496423534,1943.8761758519,2138.79896507223,1,17
"593003517",29,1977.59337786455,1547.93155826403,2357.79423966008,5,24
"593003518",22,2033.68277921438,1901.34856073598,2228.3491786518,3,19
"593003519",18,2040.22361884483,2052.22813955263,2138.79896507223,5,13
"593003520",29,2046.28935560687,1890.7555540948,2357.79423966008,7,22
"593003521",26,2015.8829883678,1862.22875615075,2305.75108410937,5,21
"593003522",27,2087.52016150841,1895.69246679512,2323.60649590586,5,22
"593003523",8,1838.70513763569,1809.46408727847,1812.11073017574,1,7
"6001975",17,2001.36086036578,1993.55683609661,2113.95669457394,4,13
"6001976",24,1831.47581894709,1325.62491683926,2268.33468283819,7,17
"6001977",23,1902.2932444483,1457.96510770586,2248.68783741607,5,18
"6001989",47,2852.68887595557,3679.49151709869,2602.36394728806,20,27
"6001990",29,1936.9961186651,1842.55391707053,2357.79423966008,4,25
"6001991",19,1870.15589904927,1526.8467139908,2162.56636020013,3,16
"6001992",18,1878.75710482881,1771.02481385961,2138.79896507223,5,13
"6001993",22,1810.07658696177,1412.93797872669,2228.3491786518,3,19
"6002003",34,2713.46129935517,3276.73313896052,2435.71163614839,15,19
"6002004",28,2394.78837786341,2499.09214832362,2340.94327947849,9,19
"6002005",18,1883.07137803971,1424.78742055929,2138.79896507223,2,16
"6002006",16,1895.95560239438,1758.02598569182,2087.92318348224,1,15
"6002007",21,1818.31154530601,1418.64870501844,2207.26116887512,1,20
"6002008",14,1834.84423930567,1529.78578655514,2031.70713799962,2,12
"6002009",17,1831.0288578377,1427.91569679992,2113.95669457394,3,14
"6002018",22,1869.33201570862,1655.19366797385,2228.3491786518,2,20
"6002019",13,1838.99234886704,1844.44662886958,2001.16379457045,2,11
"6002020",15,1843.61909881599,1727.67271942887,2060.56118614118,1,14
"6002021",18,1926.69368262306,1727.40776779226,2138.79896507223,1,17
"6002026",55,2821.19529623536,3932.00680972792,2687.33120998132,25,30
"6002027",30,2032.25470076608,1391.2729300393,2374.18906024059,5,25
"6002028",21,1983.68569516262,1338.90770776841,2207.26116887512,5,16
"6002037",24,1963.41195708644,1481.52136018936,2268.33468283819,4,20
"6002038",29,2084.37230200014,1559.72163563794,2357.79423966008,7,22
"6002039",28,1986.60198002138,1389.53804741538,2340.94327947849,5,23
"6002040",36,1967.58893286351,1104.15584689562,2464.33502634194,4,32
"6002050",13,1781.18338422993,1545.12915751657,2001.16379457045,3,10
"6002051",21,1994.97911804572,1496.81299599698,2207.26116887512,4,17
"6002052",28,2101.18609039711,1382.99613047049,2340.94327947849,5,23
"6002060",20,1968.51051915039,1377.2827452385,2185.35845629437,5,15
"6002061",17,1898.49724420652,1551.77122398983,2113.95669457394,3,14
"6002062",21,1955.30959597604,1636.96510344119,2207.26116887512,4,17
"6002063",16,1793.90418633654,1786.79096566945,2087.92318348224,3,13
"6002064",27,2122.38419324058,1698.35668962953,2323.60649590586,6,21
"6002065",19,1961.18342770214,1520.5139926983,2162.56636020013,3,16
"6002081",23,2165.50968577799,1487.32211994313,2248.68783741607,7,16
"6002082",25,2125.19439425321,1467.11240401625,2287.34065519221,9,16
"6002083",16,1859.17701892101,1716.73535729272,2087.92318348224,3,13
"6002084",14,1971.22141337172,2083.03054070338,2031.70713799962,4,10
"6002085",13,1887.12902070589,1968.07830757673,2001.16379457045,3,10
"6002086",25,2075.80196950135,2069.93076383574,2287.34065519221,4,21
"6002087",21,2153.05980905512,1965.25539427492,2207.26116887512,4,17
"6002088",27,1815.61624065335,1538.16547128847,2323.60649590586,3,24
"6002089",24,1962.04365853847,1752.33743549908,2268.33468283819,3,21
"6002090",23,1923.19933758181,1599.66703194489,2248.68783741607,5,18
"6002091",26,2121.0431351933,1728.64446545411,2305.75108410937,5,21
"6002092",26,2056.13986882353,1641.12918832014,2305.75108410937,3,23
"6002093",20,1970.71885656759,1765.74692727055,2185.35845629437,2,18
"6002094",24,1915.70727130932,1434.55908524728,2268.33468283819,4,20
"6002095",24,1969.97301971176,1658.33177295958,2268.33468283819,3,21
"6002096",32,1896.3147616197,1410.17452245211,2405.71569249515,5,27
"6002097",14,1736.57396867915,1430.42720212573,2031.70713799962,2,12
"6002104",27,2016.80170626197,1779.13236413303,2323.60649590586,3,24
"6002105",25,1943.38905573809,1925.39425946427,2287.34065519221,4,21
"6002108",56,2991.59232727856,3541.17656713907,2697.24673169728,24,32
"6002109",43,2669.50392544914,2846.82447054316,2555.47878346624,20,23
"6002110",28,2284.00437385592,2376.78389972226,2340.94327947849,13,15
"6002111",16,1895.65342295404,1748.1460523582,2087.92318348224,7,9
"6002112",10,1785.69701763073,1621.80599638542,1896.67490607898,4,6
"6002113",9,1766.77992197458,1661.0110217134,1856.26587460569,2,7
"6002114",9,1766.04678856544,1610.82842596342,1856.26587460569,1,8
"6002115",46,2291.84576738749,1681.1375857195,2590.94954296761,13,33
"6002116",44,2402.20589517423,2025.51156988743,2567.51523707907,14,30
"6002117",44,2182.6181230593,1896.89997265542,2567.51523707907,15,29
"6002118",47,2398.49793399337,1430.55624532598,2602.36394728806,17,30
"6002119",30,2117.3523341228,1617.36883030312,2374.18906024059,6,24
"6002120",37,2332.24647669882,2157.4148499191,2478.17471526668,14,23
"6002121",26,2087.03952003088,1958.07844527984,2305.75108410937,6,20
"6002122",38,2217.73685816991,1714.88474993185,2491.71993967651,13,25
"6002123",27,1940.81968473439,1788.84745676575,2323.60649590586,6,21
"6002124",36,2179.11214301789,1703.46069681605,2464.33502634194,14,22
"6002125",33,2152.35370131183,1656.45687287006,2420.89448855093,10,23
"6002126",39,2165.07425453522,1824.59651887457,2504.98447234734,12,27
"6002127",39,2191.31310423231,1722.19293639093,2504.98447234734,18,21
"6002128",23,1964.89439454148,1732.81201389701,2248.68783741607,6,17
"6002129",23,1953.27951320893,1758.77884278251,2248.68783741607,7,16
"6002130",49,2172.80906413359,1359.09656572021,2624.62502504328,22,27
"6002131",35,2211.20953315874,1583.36843463605,2450.1860183293,12,23
"6002132",33,2072.32027702168,1658.90955194324,2420.89448855093,9,24
"6002133",36,2281.06286620508,1792.93133112931,2464.33502634194,9,27
"6002134",36,2469.91689083339,2013.78085453667,2464.33502634194,15,21
"6002135",41,2070.99691447052,1552.81912200774,2530.72175773865,16,25
"6002136",18,1962.14149829889,1758.68001875339,2138.79896507223,5,13
"6002137",21,1923.52882384808,1635.92188041448,2207.26116887512,7,14
"6002138",43,2119.84471310921,1351.87970318386,2555.47878346624,16,27
"6002139",38,2196.31681913203,1377.00892201173,2491.71993967651,18,20
"6002140",27,2052.9898845028,1831.58962730733,2323.60649590586,7,20
"6002141",28,1907.09824027751,2031.39756878033,2340.94327947849,9,19
"6002142",29,2165.65536898878,1826.59853506217,2357.79423966008,7,22
"6002143",40,2191.13490547604,1647.60890416363,2517.98110851286,12,28
"6002144",23,2098.0718238782,1796.92678374788,2248.68783741607,8,15
"6002145",17,1991.1977084492,1833.41757070881,2113.95669457394,5,12
"6002146",20,2076.62426769069,1847.767854174,2185.35845629437,7,13
"6002147",32,2083.54460925803,1848.86207594468,2405.71569249515,11,21
"6002148",31,1998.72324039834,1626.51864276101,2390.15469389133,11,20
"6002153",18,1981.68480045638,1953.48676114177,2138.79896507223,4,14
"6002154",27,2283.43841136089,2247.33502495495,2323.60649590586,11,16
"6002155",27,2435.42731660048,2353.47421227744,2323.60649590586,11,16
"6002156",23,2266.04105784511,2131.10579160519,2248.68783741607,11,12
"6002157",32,2428.12081616203,2432.7316368997,2405.71569249515,15,17
"6002158",17,2134.67258974497,2106.67396667226,2113.95669457394,7,10
"6002159",23,2273.34094328893,2166.40962191011,2248.68783741607,13,10
"6002160",25,2357.99417544363,2361.50894930779,2287.34065519221,13,12
"6002161",21,2198.72825628272,2058.7446692622,2207.26116887512,11,10
"6002162",24,2411.967008118,2391.13143018892,2268.33468283819,13,11
"6002163",15,1951.05179012715,1667.05062140055,2060.56118614118,7,8
"6002164",16,2080.45066107061,1898.77336104425,2087.92318348224,8,8
"6002166",39,2737.1676939518,3289.77823813322,2504.98447234734,16,23
"6002167",42,2878.38800316372,3276.66439572942,2543.21752514954,21,21
"6002170",44,2778.21017100121,3550.28205361465,2567.51523707907,20,24
"6002171",39,2960.78891439163,4042.3134914168,2504.98447234734,18,21
"6002172",32,2549.7633027793,2846.56809497869,2405.71569249515,14,18
"6002173",52,2596.57000031355,1934.60802954393,2656.6981055205,17,35
"6002174",73,2983.60543981729,2604.17772036841,2847.4358582506,30,43
"6002175",67,2917.45309688778,2419.56609828128,2797.95380131742,30,37
"6002176",63,2614.8074190648,2155.18612274478,2762.96971264875,26,37
"6002184",47,3146.34451538994,3902.21189120102,2602.36394728806,20,27
"6002185",39,2390.85528274344,3033.31376361532,2504.98447234734,16,23
"6002193",57,2945.70896603227,3271.52767406938,2707.02236739438,22,35
"6002199",7,1673.61910632172,1664.26392061918,1763.32076508842,1,6
"6002205",17,1850.25777736197,1552.58847799341,2113.95669457394,3,14
"6002212",18,1843.89889940247,1845.51546038317,2138.79896507223,4,14
"6002219",12,1885.01772774955,1838.31646873928,1968.69006049611,0,12
"6002220",12,1863.57313155998,1722.79863754767,1968.69006049611,0,12
"6002221",17,1979.5910367336,2012.15080256119,2113.95669457394,0,17
"6002222",11,1830.88282644667,1562.28343271765,1933.98659929558,2,9
"6002226",12,2028.08655119742,1824.89269711701,1968.69006049611,3,9
"6002227",32,1982.10788994451,1902.01219382145,2405.71569249515,9,23
"6002228",39,2528.30059711525,2222.77512432545,2504.98447234734,11,28
"6002243",48,2550.15593736395,2470.15478208478,2613.58673801098,21,27
"6002244",8,1797.81285557063,1870.32374230615,1812.11073017574,3,5
"6002245",10,1733.74099579695,1794.44644620057,1896.67490607898,2,8
"6002246",22,2093.02658882752,1574.0609901508,2228.3491786518,11,11
"6002247",14,1837.1503904403,1496.06116043472,2031.70713799962,5,9
"6002248",14,1886.75750456129,1417.0150765856,2031.70713799962,5,9
"6002249",15,1989.26016140191,1888.94326389374,2060.56118614118,2,13
"6002250",18,1922.09721458682,1703.58932980482,2138.79896507223,4,14
"6002251",18,1810.97579790441,1514.40355071605,2138.79896507223,4,14
"6002252",20,1860.34127844868,1737.57595171917,2185.35845629437,3,17
"6002253",19,1900.31978305499,1927.95133678749,2162.56636020013,2,17
"6002254",13,1874.52102139324,1826.34181131127,2001.16379457045,1,12
"6002255",14,1904.5286766936,1639.25821646218,2031.70713799962,6,8
"6002256",13,1839.40091594389,1486.50488128946,2001.16379457045,4,9
"6002257",25,1944.44005571929,1922.40968937003,2287.34065519221,5,20
"6002258",26,1907.60868106342,1839.2986601035,2305.75108410937,4,22
"6002259",12,1823.29930857497,1779.51590956626,1968.69006049611,2,10
"6002260",18,1963.32292747915,1672.49443655343,2138.79896507223,3,15
"6002261",19,1988.34480466087,1931.0156477209,2162.56636020013,3,16
"6002262",21,1948.62699717656,1692.14647481574,2207.26116887512,4,17
"6002263",13,1927.45378113742,1818.13429634214,2001.16379457045,2,11
"6002268",26,1895.21728676926,1537.90841676119,2305.75108410937,3,23
"6002269",22,2047.79071044133,1876.30265692307,2228.3491786518,7,15
"6002270",21,2080.71107292064,1854.05526295737,2207.26116887512,5,16
"6002271",9,1715.54049876722,1681.22142473864,1856.26587460569,1,8
"6002272",11,1897.99143282426,1813.64706177852,1933.98659929558,1,10
"6002273",12,1792.89846080916,1612.4222068237,1968.69006049611,3,9
"6002274",15,1837.31897809631,1767.3236933588,2060.56118614118,1,14
"6002275",16,1979.15667845614,1784.38999339012,2087.92318348224,4,12
"6002276",23,1876.01787911469,1823.67253852592,2248.68783741607,5,18
"6002277",22,1969.68889642599,1779.67235402322,2228.3491786518,5,17
"6002278",19,1812.6035470859,1877.938776248,2162.56636020013,4,15
"6002279",4,1538.15149286756,1476.88611315889,1572.73281143487,0,4
"6002280",16,1941.93648621315,1804.80933306905,2087.92318348224,3,13
"6002281",18,1944.74244396044,1556.99555624054,2138.79896507223,4,14
"6002282",30,2429.08998757056,1921.78450911952,2374.18906024059,10,20
"6002283",14,1857.22413192524,1647.75695725112,2031.70713799962,1,13
"6002284",16,1835.86991395012,1796.01781040395,2087.92318348224,2,14
"6002285",7,1577.1080630278,1542.66337841084,1763.32076508842,1,6
"6002286",9,1834.41330388698,1738.81053872209,1856.26587460569,0,9
"6002287",19,1907.37580018965,2059.11501087273,2162.56636020013,4,15
"6002288",16,1859.21684258952,1571.40884858262,2087.92318348224,5,11
"6002289",28,1907.23075720115,1257.17763033651,2340.94327947849,3,25
"6002290",29,1783.49091839323,1193.68889042327,2357.79423966008,3,26
"6002291",11,1836.92342685476,2042.46399246192,1933.98659929558,2,9
"6002292",19,2020.65524164974,2223.5389140292,2162.56636020013,5,14
"6002293",17,2023.99817707107,2209.37877121308,2113.95669457394,5,12
"6002294",21,2136.94691293409,2216.669232117,2207.26116887512,5,16
"6002295",25,2108.37602792429,2215.81729061316,2287.34065519221,9,16
"6002296",15,1968.82364875731,1924.95050079828,2060.56118614118,1,14
"6002297",33,2320.16255458774,2342.96101860243,2420.89448855093,12,21
"6002298",42,2079.72855797805,1332.8446645062,2543.21752514954,10,32
"6002299",48,2307.899504225,2161.30901789201,2613.58673801098,16,32
"6002300",37,2340.51013632308,2237.91109123426,2478.17471526668,10,27
"6002301",30,2336.9273689064,2055.79637633671,2374.18906024059,5,25
"6002302",25,2083.67584946905,1736.14088046148,2287.34065519221,2,23
"6002309",25,1949.11440517527,2011.15669184312,2287.34065519221,4,21
"6002316",23,1942.16486895344,1671.90177117657,2248.68783741607,2,21
"6002317",20,1970.43439069703,1602.62340346591,2185.35845629437,4,16
"6002318",13,1953.95001483419,1941.63816193921,2001.16379457045,4,9
"6002322",25,1968.99613222467,1589.97705251022,2287.34065519221,4,21
"6002324",18,2002.1458329597,1952.92994313468,2138.79896507223,1,17
"6002325",23,1796.49402905986,1284.26974370705,2248.68783741607,3,20
"6002330",27,1880.64406647535,1674.14311342642,2323.60649590586,4,23
"6002332",5,1486.83696297037,1330.24773518911,1646.12614877363,1,4
"6002333",22,2183.88700374092,1870.47854024198,2228.3491786518,4,18
"6002334",14,1631.23529306243,1174.94130787349,2031.70713799962,1,13
"6002337",17,1925.13656416816,1709.05417354648,2113.95669457394,3,14
"6002338",14,1783.66561708418,1597.89103393031,2031.70713799962,1,13
"6002339",19,1954.77168269881,1867.85498566993,2162.56636020013,3,16
"6002340",13,1990.67044781035,1819.33663440389,2001.16379457045,1,12
"6002341",27,1990.10126983209,1652.26730431719,2323.60649590586,5,22
"6002343",17,1897.91844396235,1313.37891496672,2113.95669457394,5,12
"6002344",14,1795.11164058225,1738.8437099252,2031.70713799962,0,14
"6002861",12,1835.52410799324,1749.73058857462,1968.69006049611,1,11
"6002862",8,1651.50590183165,1408.99993452548,1812.11073017574,1,7
"6002863",20,2059.78921541698,1614.26111689991,2185.35845629437,3,17
"6002864",11,1810.47536803259,1690.62194469737,1933.98659929558,0,11
"6002865",18,1866.88744429966,1772.95543372924,2138.79896507223,2,16
"6002866",22,1939.05356295581,1385.91566360454,2228.3491786518,2,20
"6002872",21,2061.21431905518,1784.43190171019,2207.26116887512,3,18
"6002875",18,2040.06822340987,1985.06270765062,2138.79896507223,2,16
"6002876",16,1822.59121218833,1537.07349001636,2087.92318348224,5,11
"6002877",18,1907.24920652652,1464.4648562264,2138.79896507223,4,14
"6002878",18,1968.05833781666,1534.55391689494,2138.79896507223,2,16
"6002879",22,2041.93469138442,1691.09875038338,2228.3491786518,5,17
"6002880",20,1917.30437226199,1672.86477483119,2185.35845629437,5,15
"6002881",14,1861.85668945918,1739.16448325348,2031.70713799962,2,12
"6002926",22,1772.20839559281,1571.98387708111,2228.3491786518,3,19
"6003293",70,2918.78717208163,2221.34971662912,2823.11677003184,19,51
"6003294",70,3181.68019870683,1798.78078207736,2823.11677003184,17,53
"6003295",84,2799.76773261228,1646.56008738429,2930.30814451558,25,59
"6003296",60,2893.36377696181,2614.06435892484,2735.5526890818,19,41
"6003297",75,2888.06481422048,2435.34942477972,2863.21031780169,22,53
"6003298",71,3060.52792516322,2836.98835192484,2831.31372136695,26,45
"6003299",64,3249.13551973269,2991.64479555982,2771.87783482774,21,43
"6003300",78,2581.8380128206,2171.33481489676,2886.25582696583,22,56
"6003301",72,3111.42396472102,2474.32328115752,2839.4193288992,18,54
"6003302",62,2539.76997415888,2018.7125007681,2753.94837323248,18,44
"6003303",56,2907.9457421116,3206.61349471946,2697.24673169728,16,40
"6003304",64,2904.44738577421,2192.49215329547,2771.87783482774,16,48
"62003087",41,3162.65964659282,3226.88024159333,2530.72175773865,14,27
"62003088",55,3398.62278128121,4324.26786214297,2687.33120998132,18,37
"62003089",61,3340.71366147487,3486.26619514622,2744.81051624266,20,41
"62003090",58,3047.36713602901,3027.80320155879,2716.66249357165,22,36
"62003091",42,2399.42768527461,2172.87725416358,2543.21752514954,9,33
"62003092",52,3146.47521026412,2583.95094582482,2656.6981055205,22,30
"62003093",63,3298.10018881915,2950.75789297064,2762.96971264875,22,41
"62003094",49,3302.07800021586,3607.69415778525,2624.62502504328,17,32
"62003095",66,3142.98667248394,3895.91359173191,2789.3669207067,22,44
"62003096",50,3264.39560947592,3680.10059262321,2635.48551585152,17,33
"62003097",74,3138.5894533598,2874.73689188463,2855.36548874306,22,52
"62003098",55,3314.44967786566,3349.84271553903,2687.33120998132,21,34
"62003099",49,2739.13653448956,2788.34844183921,2624.62502504328,18,31
"62003100",52,2418.30014910322,1839.31863300448,2656.6981055205,14,38
"62003101",76,3272.51914287636,3186.15623274615,2870.97236507783,22,54
"62003102",71,3791.77566800573,3584.75029653546,2831.31372136695,24,47
"62003103",73,3464.91448429906,2775.42955778262,2847.4358582506,25,48
"62003104",69,3407.373999001,2713.38456302354,2814.82611826518,26,43
"62003105",55,3062.8909448369,2960.70493132661,2687.33120998132,16,39
"62003106",68,3507.6944587954,3855.46019560551,2806.43931339586,21,47
"62003107",94,3863.85999956917,3036.70169444069,2998.45695239283,33,61
"62003108",69,3777.13886470376,2998.68779286607,2814.82611826518,28,41
"62003109",67,3418.21544966122,3920.71117426767,2797.95380131742,20,47
"62003110",64,3128.54424564261,3238.16072591215,2771.87783482774,20,44
"62003111",78,3499.68186971742,3885.90135004634,2886.25582696583,24,54
"62003112",67,3925.12180377677,3228.63930366719,2797.95380131742,25,42
"62003113",64,3421.93376971864,3834.11632805368,2771.87783482774,21,43
"62003114",87,3515.41121148105,3795.73956405226,2951.40156710974,31,56
"62003115",75,3625.94567055407,3410.25210860659,2863.21031780169,30,45
"62003116",63,2577.99030932869,2255.21088221019,2762.96971264875,27,36
"62003117",77,3022.22353107277,2853.69927200905,2878.65357631343,26,51
"62003118",78,2875.59630547123,2003.30462245562,2886.25582696583,24,54
"62003119",86,2892.79417978097,2290.09975237569,2944.43562859908,29,57
"62003120",87,2482.98148532328,1436.20672910314,2951.40156710974,27,60
"62003121",92,2894.31072389609,2475.58724552738,2985.30521778333,29,63
"62003122",107,2770.39566965428,1630.08261977249,3078.90571391637,29,78
"62003123",78,3067.03170897387,2075.35132380389,2886.25582696583,24,54
"62003713",52,3231.897034063,3700.53819637403,2656.6981055205,14,38
"62003714",68,3413.31761823897,3950.85367477898,2806.43931339586,28,40
"62003715",49,3093.18723285609,3768.31603081379,2624.62502504328,20,29
"62003716",51,3378.91200933241,3379.33965599638,2646.17454577679,17,34
"62003717",67,3597.49050901521,3268.23380229465,2797.95380131742,22,45
"62003718",62,2970.79077239399,2450.07612971123,2753.94837323248,22,40
"62003719",51,3426.54234327512,4143.92427405587,2646.17454577679,13,38
"62003720",66,3746.73272694453,4504.57006554185,2789.3669207067,25,41
"62003721",72,3700.64803880276,3282.6452130872,2839.4193288992,30,42
"62003722",83,3559.47967250204,3262.86675664723,2923.1438046077,27,56
"62003723",77,3537.64420129082,3784.15351746043,2878.65357631343,27,50
"62003724",89,3414.56275453569,3305.17976032726,2965.14449011489,28,61
"62003725",60,3035.23577605767,2488.88440114977,2735.5526890818,19,41
"62003726",71,3315.13527169727,3472.11812599105,2831.31372136695,23,48
"62003727",39,2723.50896024832,3473.22413855433,2504.98447234734,14,25
"62003728",60,3281.75965987126,3040.53397027347,2735.5526890818,22,38
"62003729",70,3922.59764225662,4150.53562653348,2823.11677003184,23,47
"62003730",76,3627.61681564261,4211.30626884789,2870.97236507783,31,45
"62003731",85,3419.11015166899,2875.46664135844,2937.40494579778,26,59
"62003732",66,3680.93325822343,3118.39258138611,2789.3669207067,29,37
"62003733",68,3379.38014761508,2958.32696947172,2806.43931339586,29,39
"62003737",70,2821.24615578344,2949.55742848409,2823.11677003184,17,53
"64003158",15,1637.96682806838,1132.77322736606,2060.56118614118,2,13
"64003159",13,1646.09245133077,1422.73305833113,2001.16379457045,1,12
"64003161",16,1680.71558337867,1176.42736420931,2087.92318348224,4,12
"64003162",12,1648.52752961007,1305.68778831321,1968.69006049611,1,11
"64003163",9,1583.30795742301,1169.14839219777,1856.26587460569,2,7
"64003164",14,1689.23204501024,1161.98454180918,2031.70713799962,5,9
"64003165",9,1602.8791847333,1365.49113461395,1856.26587460569,0,9
"64003734",9,1646.32613486643,1388.84048782069,1856.26587460569,2,7
"64003935",11,1604.62524452931,1402.17275028459,1933.98659929558,0,11
"676003239",56,2983.73759118757,3117.48954295305,2697.24673169728,24,32
"676003240",55,3188.81932661707,3491.61403462968,2687.33120998132,25,30
"676003241",40,2815.55021796223,2991.72794288365,2517.98110851286,16,24
"676003242",48,3158.97022423315,3396.26277608317,2613.58673801098,23,25
"676003243",71,3470.02663146456,3431.9970954159,2831.31372136695,31,40
"676003244",60,3085.75926464176,2943.8870902961,2735.5526890818,27,33
"676003245",59,2944.25699000377,2529.61311078314,2726.17127719361,25,34
"676003247",56,2850.90643556081,3076.06755709709,2697.24673169728,30,26
"676003248",46,3216.7636683262,3207.00169298646,2590.94954296761,22,24
"676003249",43,2824.34089459172,2966.61537447234,2555.47878346624,15,28
"676003250",63,3361.65191275439,3341.226533419,2762.96971264875,27,36
"676003251",53,3165.9761115819,3708.03150744985,2667.061866114,23,30
"676003252",65,3341.45446953053,3435.08630697251,2780.67589681985,29,36
"676003741",40,3069.1878995653,3342.84045185282,2517.98110851286,19,21
"676003742",45,2985.25553479501,2873.3202369972,2579.33597919865,23,22
"682002937",58,3431.01511712019,3339.96684679046,2716.66249357165,17,41
"682002938",46,2929.100365396,2802.50013731851,2590.94954296761,15,31
"682002939",40,2374.68252642176,1948.42010997495,2517.98110851286,7,33
"682002940",57,2989.72558095157,3266.0166556202,2707.02236739438,15,42
"683003147",44,2899.3406969222,3376.85345297668,2567.51523707907,20,24
"683003148",43,2902.42428008852,3231.25401699899,2555.47878346624,16,27
"683003149",41,2622.52100003419,2483.96876956192,2530.72175773865,17,24
"683003150",58,2870.51969763839,3270.13136920271,2716.66249357165,27,31
"683003151",38,2908.33176899607,2930.69439375489,2491.71993967651,12,26
"683003152",42,2941.0946289182,2731.89236233462,2543.21752514954,18,24
"683003153",37,2901.14901447225,3022.05184365554,2478.17471526668,16,21
"683003932",32,2433.8846819142,2486.25508742032,2405.71569249515,15,17
"683003933",32,2708.14445629617,2798.01235035762,2405.71569249515,16,16
"683003934",36,2672.02793554668,2946.02600270983,2464.33502634194,10,26
"689003033",46,2559.12612193816,2552.16005501499,2590.94954296761,17,29
"689003034",41,2302.3575663452,2072.86150439115,2530.72175773865,16,25
"689003035",44,2488.65510878841,2221.77151852067,2567.51523707907,15,29
"689003036",53,2597.40166921821,2335.88247474572,2667.061866114,18,35
"689003037",50,2770.93589631744,2657.44391547522,2635.48551585152,15,35
"689003038",40,2408.28617810913,2459.70323979424,2517.98110851286,13,27
"689003039",45,2558.44485147592,2666.87565957331,2579.33597919865,16,29
"689003040",59,3439.5331299413,3679.45914487443,2726.17127719361,21,38
"689003041",69,2618.36734365132,2099.31548093914,2814.82611826518,21,48
"689003042",38,2828.82163504309,3310.10344518903,2491.71993967651,11,27
"689003043",67,2871.98369713821,2754.01179477817,2797.95380131742,18,49
"689003044",55,2774.42758425061,3398.79632328581,2687.33120998132,15,40
"689003045",32,2802.77276524658,3062.25005341863,2405.71569249515,12,20
"689003046",43,2816.51225581927,2285.96073019491,2555.47878346624,11,32
"689003047",38,2993.54297293342,3225.28282101161,2491.71993967651,11,27
"689003048",52,3097.61180835452,4063.22412365405,2656.6981055205,12,40
"689003049",50,3151.22166680285,3359.95810856134,2635.48551585152,13,37
"689003050",47,3042.07458478169,2830.4449622197,2602.36394728806,17,30
"689003051",65,2836.50877010905,3066.85263493358,2780.67589681985,23,42
"689003052",43,3268.71360712966,3354.71624729433,2555.47878346624,14,29
"689003053",68,2953.57174013543,2719.69146746957,2806.43931339586,15,53
"689003054",51,2931.46542620706,2736.14984777479,2646.17454577679,16,35
"689003055",50,3291.314641069,3473.18611874292,2635.48551585152,17,33
"689003056",40,3548.41874429056,3644.77275984987,2517.98110851286,15,25
"689003057",48,3264.35938035187,3475.64021813687,2613.58673801098,18,30
"689003058",45,3084.0725459376,3339.87272537336,2579.33597919865,17,28
"689003059",47,3176.16334470704,3631.20620726926,2602.36394728806,15,32
"689003060",54,3205.0895167884,3516.79714320099,2677.2712016452,21,33
"689003061",33,2560.10329655599,2671.6731929857,2420.89448855093,7,26
"689003735",42,2472.89338260497,2491.92468514025,2543.21752514954,15,27
"689003736",46,2666.29671807279,2921.885458847,2590.94954296761,16,30
"689003738",34,3127.06219595489,3291.65086734131,2435.71163614839,11,23
"689003739",49,3145.18456893607,3050.13271215383,2624.62502504328,15,34
"689003740",55,3039.00016674443,3281.35069398706,2687.33120998132,21,34
"7000408",10,1560.05632903307,1265.51450457562,1896.67490607898,1,9
"7000409",3,1406.99805338328,1332.43272099425,1482.92019466158,1,2
"7000410",3,1416.46020967524,1322.87721038144,1482.92019466158,1,2
"7000412",9,1676.37320624112,1339.65327041088,1856.26587460569,2,7
"7000413",6,1559.81633274625,1264.48403642175,1708.62817714657,2,4
"7000414",3,1393.46849933746,1336.26874965972,1482.92019466158,1,2
"7000415",11,1728.36594293287,1329.85636103319,1933.98659929558,3,8
"7000416",9,1687.60783319822,1428.12356916827,1856.26587460569,2,7
"7000417",10,1670.42029844608,1341.10946684569,1896.67490607898,3,7
"7000418",4,1517.90441175392,1484.07268702879,1572.73281143487,1,3
"7000419",6,1585.6979191218,1456.14957663846,1708.62817714657,1,5
"7000420",2,1317.02858264606,1246.65727725171,1364.97646362037,0,2
"7000421",1,1150.39487184796,1184.66451052022,1184.66451052022,0,1
"7000422",4,1513.84116223386,1388.54077705685,1572.73281143487,0,4
"7000423",2,1332.37374290201,1240.48629206267,1364.97646362037,0,2
"7000424",5,1475.30135656731,1357.96552273159,1646.12614877363,1,4
"7000425",6,1671.89842622277,1386.13422112816,1708.62817714657,3,3
"7000426",4,1465.15064699177,1233.78303523289,1572.73281143487,1,3
"7000427",10,1719.48532489007,1568.85903925627,1896.67490607898,3,7
"7000429",9,1640.257576195,1575.4872131453,1856.26587460569,1,8
"7000430",9,1616.24571554909,1485.44558174957,1856.26587460569,2,7
"7000431",9,1688.91676702688,1511.88968562745,1856.26587460569,3,6
"7000432",11,1745.4679642787,1422.55205123154,1933.98659929558,1,10
"7000433",11,1618.95689870285,1292.01649860617,1933.98659929558,3,8
"7000434",17,1689.56841431337,1454.87528434684,2113.95669457394,5,12
"7000435",7,1574.89829892637,1379.74042262473,1763.32076508842,2,5
"7000436",14,1628.56043894315,1535.02718116453,2031.70713799962,3,11
"7000437",10,1679.46053033338,1617.968280546,1896.67490607898,4,6
"7000438",6,1574.37159080095,1380.07253437993,1708.62817714657,2,4
"7000439",7,1619.68379031854,1362.21244677854,1763.32076508842,1,6
"7000440",6,1558.82559489236,1439.28460229752,1708.62817714657,3,3
"7000441",5,1573.93869483475,1564.95286064414,1646.12614877363,2,3
"7000442",7,1565.29739185982,1466.2731519497,1763.32076508842,1,6
"7000443",4,1476.53645308229,1348.99714981938,1572.73281143487,1,3
"7000444",9,1674.4968092478,1539.50541917926,1856.26587460569,2,7
"7000445",8,1619.50951018614,1207.2150404899,1812.11073017574,3,5
"7000446",8,1624.72569235644,1301.32471588346,1812.11073017574,3,5
"7000447",8,1543.72699186296,1352.84233926686,1812.11073017574,3,5
"7000448",10,1655.10812588954,1653.31002869324,1896.67490607898,1,9
"7000449",10,1584.91931563222,1332.66899396666,1896.67490607898,1,9
"7000450",10,1667.91602676641,1458.82331771323,1896.67490607898,3,7
"7000451",8,1679.28395112751,1405.86918576784,1812.11073017574,2,6
"7000452",9,1615.52108624219,1407.19673365345,1856.26587460569,2,7
"7000453",6,1595.62794296153,1143.08118038907,1708.62817714657,2,4
"7000456",6,1608.80564085617,1368.33056024817,1708.62817714657,1,5
"7000457",6,1662.57251128446,1487.60020345829,1708.62817714657,2,4
"7000458",4,1546.42529441697,1319.31684907925,1572.73281143487,2,2
"7000459",4,1470.61401680656,1383.8239526465,1572.73281143487,2,2
"7000460",9,1628.01018379427,1612.06158181192,1856.26587460569,3,6
"7000461",7,1679.51339566554,1442.25223256903,1763.32076508842,1,6
"7000462",6,1621.10498827205,1487.88384467929,1708.62817714657,2,4
"7000463",4,1548.77371748562,1358.67365375021,1572.73281143487,0,4
"7000464",3,1465.31196335162,1415.44705505279,1482.92019466158,1,2
"7000465",5,1507.9206547468,1548.11708773103,1646.12614877363,1,4
"7000466",7,1635.91210147362,1381.46849407256,1763.32076508842,1,6
"7000467",5,1594.04954646098,1424.71557520198,1646.12614877363,1,4
"7000468",3,1415.64735506394,1352.50100668279,1482.92019466158,0,3
"7000470",11,1690.49668871387,1515.91646596531,1933.98659929558,3,8
"7000471",5,1532.10070748217,1495.8643669904,1646.12614877363,2,3
"7000472",16,1689.90132550959,1338.99457110534,2087.92318348224,3,13
"7000473",8,1657.09305791436,1695.13217009582,1812.11073017574,1,7
"7000474",7,1621.67752590386,1522.64690407329,1763.32076508842,1,6
"7000475",6,1534.97274378436,1272.16861106703,1708.62817714657,1,5
"7000476",6,1586.78474888834,1449.38501993458,1708.62817714657,2,4
"7000479",11,1627.33570269819,1289.96181020325,1933.98659929558,2,9
"7000480",12,1767.27168236699,1312.54015354432,1968.69006049611,2,10
"7000481",5,1531.40519102698,1318.98267952882,1646.12614877363,2,3
"7000482",5,1558.46689914608,1306.17198841308,1646.12614877363,1,4
"7000483",8,1550.86452570752,1227.32705518494,1812.11073017574,2,6
"7000484",8,1595.24533864928,1140.44636043476,1812.11073017574,3,5
"7000485",7,1597.62462777022,1529.80987601973,1763.32076508842,1,6
"7000486",13,1681.39904180396,1313.89459422853,2001.16379457045,3,10
"7000487",5,1493.91140485895,1212.80311801081,1646.12614877363,1,4
"7000488",7,1529.02835819692,1202.97338662037,1763.32076508842,1,6
"7000489",7,1608.95974822642,1422.67188906417,1763.32076508842,1,6
"7000490",8,1600.68346718542,1410.78826345149,1812.11073017574,3,5
"7000491",4,1454.67395374325,1317.99929054507,1572.73281143487,1,3
"7000492",4,1438.69823695747,1369.8833176011,1572.73281143487,1,3
"7000493",4,1464.67260245347,1447.05164690124,1572.73281143487,2,2
"7000494",6,1521.62154924816,1440.7513723723,1708.62817714657,3,3
"7000495",8,1606.32518058813,1383.35227438114,1812.11073017574,3,5
"7000496",8,1720.04188617842,1459.64946288174,1812.11073017574,3,5
"7000497",1,1152.96854186554,1055.33386412021,1184.66451052022,0,1
"7000498",1,1152.96854186554,1075.77332688375,1184.66451052022,0,1
"7000499",5,1513.40128313707,1204.28110077463,1646.12614877363,1,4
"7000500",5,1513.40128313707,1207.33581589741,1646.12614877363,1,4
"7000501",5,1505.35934935989,1240.22067222378,1646.12614877363,1,4
"7000502",3,1398.81499134469,1197.51373201843,1482.92019466158,1,2
"7000503",3,1402.99471060815,1186.04143470735,1482.92019466158,0,3
"7000504",4,1495.82387422336,1271.73764690417,1572.73281143487,1,3
"7000505",3,1414.51452124508,1296.43399121432,1482.92019466158,1,2
"7000506",4,1450.55997849077,1333.74886344438,1572.73281143487,1,3
"7000507",3,1414.51452124508,1277.07144579679,1482.92019466158,1,2
"7000508",3,1414.51452124508,1298.51406426602,1482.92019466158,1,2
"7000509",6,1569.63643711877,1435.59265021768,1708.62817714657,4,2
"7000510",4,1494.90777499937,1409.26986108347,1572.73281143487,2,2
"7000511",4,1458.82475945823,1435.83039277985,1572.73281143487,2,2
"7000512",7,1539.67683972461,1314.53079184833,1763.32076508842,3,4
"7000513",4,1538.80880093802,1407.8744718854,1572.73281143487,2,2
"7000514",5,1535.79221002487,1464.30111352198,1646.12614877363,3,2
"7000516",8,1731.0663734918,1525.04495768253,1812.11073017574,1,7
"7000517",9,1790.2124758956,1812.36138321026,1856.26587460569,2,7
"7000518",7,1593.73865572535,1405.32576831587,1763.32076508842,3,4
"7000519",10,1654.90034711069,1412.74412733008,1896.67490607898,3,7
"7000520",9,1709.97210495274,1420.10495784203,1856.26587460569,2,7
"7000521",7,1597.81123286215,1400.66366069675,1763.32076508842,2,5
"7000522",6,1575.96147792361,1401.57541865035,1708.62817714657,1,5
"7000523",6,1544.65649664664,1292.92954419921,1708.62817714657,2,4
"7000524",5,1531.44316582577,1285.91464362686,1646.12614877363,1,4
"7000525",10,1713.71603110686,1387.18555867234,1896.67490607898,2,8
"7000526",7,1541.45989014972,1344.84663921544,1763.32076508842,2,5
"7000527",7,1633.71661302473,1341.91010588488,1763.32076508842,2,5
"7000528",7,1562.88614836352,1184.2839497768,1763.32076508842,1,6
"7000529",11,1664.92579074297,1400.00107523094,1933.98659929558,3,8
"7000530",5,1540.72732112379,1349.56513307205,1646.12614877363,2,3
"7000531",7,1637.293196351,1284.09128554538,1763.32076508842,2,5
"7000532",5,1473.38005126996,1331.51687074604,1646.12614877363,3,2
"7000533",5,1499.21151301478,1321.7532093228,1646.12614877363,2,3
"7000534",9,1680.41221318419,1422.60263498526,1856.26587460569,2,7
"7000535",5,1492.0068047636,1376.36946755123,1646.12614877363,2,3
"7000536",5,1522.46388878526,1344.0422907827,1646.12614877363,2,3
"7000537",7,1596.15278610614,1501.53825228941,1763.32076508842,2,5
"7000538",4,1466.77264867687,1288.39282110352,1572.73281143487,2,2
"7000539",6,1551.61177753892,1256.03904016219,1708.62817714657,2,4
"7000540",6,1577.26997966436,1407.21666052708,1708.62817714657,2,4
"7000541",5,1492.0068047636,1305.38864111582,1646.12614877363,2,3
"7000542",6,1594.96968542456,1295.91675094949,1708.62817714657,3,3
"7000543",5,1645.48094477482,1515.24183426042,1646.12614877363,2,3
"7000544",5,1496.04361217223,1365.30402167002,1646.12614877363,2,3
"7000545",6,1593.30741288523,1638.61209945417,1708.62817714657,2,4
"7000546",8,1606.76673572386,1377.69720713464,1812.11073017574,2,6
"7000547",6,1560.58427448569,1562.33147022309,1708.62817714657,4,2
"7000548",6,1567.59853728975,1324.13151205729,1708.62817714657,2,4
"7000549",10,1660.84399614864,1455.98549611946,1896.67490607898,2,8
"7000550",6,1584.13379031777,1412.26200962108,1708.62817714657,2,4
"7000551",6,1524.77912035017,1260.45574091734,1708.62817714657,2,4
"7000552",8,1586.00099831606,1405.82174882243,1812.11073017574,2,6
"7000553",8,1623.66526819005,1518.36533811622,1812.11073017574,2,6
"7000554",9,1633.86153585872,1396.89894124658,1856.26587460569,2,7
"7000555",8,1595.32046925062,1406.49431233132,1812.11073017574,2,6
"7000556",6,1545.16272194931,1380.5821044519,1708.62817714657,2,4
"7000557",7,1523.02401176987,1343.37638828703,1763.32076508842,2,5
"7000558",4,1444.79684493553,1257.18763908715,1572.73281143487,2,2
"7000559",6,1564.24118580589,1357.95619957456,1708.62817714657,2,4
"7000560",10,1627.26436260041,1286.22004710902,1896.67490607898,3,7
"7000561",7,1613.59179133349,1463.88083799307,1763.32076508842,3,4
"7000562",7,1622.38287382539,1437.57664241231,1763.32076508842,3,4
"7000563",5,1507.37943513393,1307.27234875656,1646.12614877363,2,3
"7000564",5,1507.37943513393,1210.14247026316,1646.12614877363,2,3
"7000565",15,1784.52724187043,1451.9014818954,2060.56118614118,5,10
"7000566",18,1824.58225876138,1595.26635624016,2138.79896507223,4,14
"7000567",15,1844.40131883018,1517.30208528567,2060.56118614118,5,10
"7000568",15,1827.66957404727,1617.38145509365,2060.56118614118,5,10
"7000569",12,1762.33183879573,1347.81016132275,1968.69006049611,4,8
"7000570",15,1782.2627264945,1635.46248593528,2060.56118614118,3,12
"7000571",15,1787.68194228481,1292.29356518212,2060.56118614118,3,12
"7000572",15,1877.98541994177,1490.57144199641,2060.56118614118,2,13
"7000573",19,1932.17786511664,1694.89484675673,2162.56636020013,5,14
"7000574",10,1742.15706664576,1682.05006473565,1896.67490607898,4,6
"7000575",15,1768.4596026812,1345.14711643384,2060.56118614118,3,12
"7000576",19,1897.95630034305,1520.11773067828,2162.56636020013,4,15
"7000577",15,1834.83535304927,1708.00844950181,2060.56118614118,2,13
"7000578",25,1744.36367226428,760.139864816483,2287.34065519221,5,20
"7000579",15,1753.45325863539,1383.20171059754,2060.56118614118,4,11
"7000580",10,1703.33589621189,1543.55278444714,1896.67490607898,3,7
"7000581",14,1759.13973377392,1500.88189875567,2031.70713799962,4,10
"7000582",9,1725.46014412731,1511.33890394118,1856.26587460569,4,5
"7000583",16,1921.85930377512,1734.28608177958,2087.92318348224,3,13
"7000584",18,1775.54601639102,1289.62639793587,2138.79896507223,3,15
"7000587",1,1190.61798322693,1188.78796850099,1184.66451052022,0,1
"7000588",6,1575.45712780882,1338.07724234808,1708.62817714657,1,5
"7000589",3,1446.54366037126,1399.12781180335,1482.92019466158,1,2
"7000592",6,1613.98564117795,1567.29469424689,1708.62817714657,2,4
"7000593",4,1488.26337712723,1563.34284357235,1572.73281143487,2,2
"7000594",7,1607.95038318391,1637.41872766728,1763.32076508842,3,4
"7000595",5,1591.79401613319,1533.74261283775,1646.12614877363,2,3
"7000596",5,1506.94725596362,1258.8284257304,1646.12614877363,1,4
"7000597",13,1695.5992551315,1500.73324335516,2001.16379457045,3,10
"7000598",5,1567.14310750819,1465.29534268947,1646.12614877363,3,2
"7000599",6,1567.29490802072,1461.38656992674,1708.62817714657,2,4
"7000600",4,1479.02302087455,1382.39385054336,1572.73281143487,0,4
"7000601",5,1596.51340682959,1609.55451077179,1646.12614877363,1,4
"7000602",7,1603.77405959133,1522.40369844676,1763.32076508842,3,4
"7000603",4,1485.74361728606,1487.33646056206,1572.73281143487,1,3
"7000604",12,1741.04972883229,1604.34055392109,1968.69006049611,2,10
"7000605",10,1602.57374587671,1513.0712080892,1896.67490607898,3,7
"7000606",7,1660.63623676414,1734.71102112403,1763.32076508842,2,5
"7000607",10,1739.76966630018,1558.26818528065,1896.67490607898,2,8
"7000608",9,1637.06770232272,1590.57782910236,1856.26587460569,3,6
"7000609",13,1748.00123612931,1815.1745000062,2001.16379457045,2,11
"7000610",10,1726.29289537392,1642.49176290606,1896.67490607898,2,8
"7000611",12,1798.7837976307,1625.51158316425,1968.69006049611,3,9
"7000612",9,1676.72396006446,1713.81865486753,1856.26587460569,2,7
"7000613",3,1447.71539452128,1441.44853125314,1482.92019466158,1,2
"7000614",5,1526.18158632822,1493.90307602331,1646.12614877363,1,4
"7000615",11,1752.64705580797,1741.65485536151,1933.98659929558,3,8
"7000616",11,1664.24603688766,1294.58211304709,1933.98659929558,3,8
"7000617",4,1459.2645515752,1238.42017793758,1572.73281143487,1,3
"7000618",2,1308.5559367426,1258.65124288322,1364.97646362037,0,2
"7000619",4,1503.93545007341,1479.5685969821,1572.73281143487,0,4
"7000620",5,1569.57453930668,1584.08334367688,1646.12614877363,1,4
"7000621",4,1485.99455133838,1494.91792563121,1572.73281143487,1,3
"7000622",3,1421.03618234532,1453.40144607302,1482.92019466158,1,2
"7000623",3,1434.50771780513,1440.99297778091,1482.92019466158,1,2
"7000624",2,1306.33006493936,1282.34681965324,1364.97646362037,1,1
"7000625",5,1534.55068109414,1621.55889187245,1646.12614877363,1,4
"7000626",2,1330.16905362641,1304.2900235211,1364.97646362037,0,2
"7000627",3,1421.03618234532,1386.58441227688,1482.92019466158,1,2
"7000628",3,1421.03618234532,1394.21706274215,1482.92019466158,1,2
"7000629",6,1560.59489598902,1569.68372971716,1708.62817714657,1,5
"7000630",3,1421.03618234532,1384.44201782654,1482.92019466158,1,2
"7000631",4,1501.7599981793,1505.20466875607,1572.73281143487,1,3
"7000632",4,1461.15204635162,1509.45774578252,1572.73281143487,1,3
"7000633",1,1195.9515544427,1184.66451052022,1184.66451052022,0,1
"7000634",1,1168.82968057459,1184.66451052022,1184.66451052022,0,1
"7000635",5,1522.01498056957,1306.4950737559,1646.12614877363,2,3
"7000636",8,1585.51729351264,1296.93185849926,1812.11073017574,4,4
"7000637",7,1605.52685703791,1393.61420412863,1763.32076508842,2,5
"7000638",5,1568.65648309091,1243.03656768099,1646.12614877363,2,3
"7000639",4,1504.25520108427,1513.39164280947,1572.73281143487,1,3
"7000640",7,1638.0048185175,1623.45036561414,1763.32076508842,1,6
"7000641",5,1573.04600758867,1625.37551921297,1646.12614877363,2,3
"7000642",6,1636.28872909944,1611.48830640435,1708.62817714657,1,5
"7000643",5,1517.14977507467,1322.85744932218,1646.12614877363,1,4
"7000644",10,1640.89377418538,1298.52788648058,1896.67490607898,3,7
"7000645",7,1597.6115492334,1336.6147076187,1763.32076508842,2,5
"7000646",4,1487.19679591011,1479.52887773648,1572.73281143487,3,1
"7000647",7,1670.78841689554,1538.0408668444,1763.32076508842,3,4
"7000648",4,1449.97950909676,1449.54753875771,1572.73281143487,2,2
"7002373",5,1563.67160026071,1528.91202727241,1646.12614877363,1,4
"7002374",3,1460.7326554039,1435.23721706449,1482.92019466158,1,2
"7002375",12,1730.58155341774,1242.9671122941,1968.69006049611,2,10
"7002376",8,1598.38665361643,1206.23726621662,1812.11073017574,2,6
"7002377",5,1558.14948150325,1549.5904601572,1646.12614877363,2,3
"7002378",4,1501.05259631998,1438.530343445,1572.73281143487,1,3
"7002843",10,1727.84563624545,1620.36582862343,1896.67490607898,2,8
"7002844",9,1679.60529142801,1662.48096233074,1856.26587460569,3,6
"7002845",10,1652.00297662979,1606.80254891806,1896.67490607898,2,8
"7002846",7,1629.20923421443,1656.88778046703,1763.32076508842,3,4
"7002848",12,1682.00056641988,1451.4742219396,1968.69006049611,2,10
"7002849",9,1696.2154435265,1584.83620760404,1856.26587460569,2,7
"7002850",4,1506.58391500451,1495.62303714564,1572.73281143487,3,1
"7002851",5,1573.93869483475,1546.90202836509,1646.12614877363,2,3
"7002852",9,1690.59507088347,1716.03817766538,1856.26587460569,3,6
"7002853",4,1524.13625270263,1574.70132147942,1572.73281143487,2,2
"7002854",8,1762.48883919923,1826.75431886022,1812.11073017574,1,7
"7002855",3,1399.3763106936,1488.49545553011,1482.92019466158,1,2
"7002856",6,1577.48805030043,1578.52790562977,1708.62817714657,2,4
"7002857",5,1594.56923323894,1585.42726830216,1646.12614877363,1,4
"7002858",8,1573.46992970906,1482.04191802888,1812.11073017574,2,6
"7002859",3,1393.86981137524,1484.88074608785,1482.92019466158,0,3
"7002860",12,1729.93513196272,1547.82746091142,1968.69006049611,4,8
"8000651",10,1869.2344317717,1949.73657458552,1896.67490607898,5,5
"8000655",10,1993.81212105823,1938.82004156907,1896.67490607898,4,6
"8000656",15,2086.2685640875,2160.19495302046,2060.56118614118,8,7
"8000657",15,2127.59925853353,2150.69321656851,2060.56118614118,8,7
"8000658",18,2180.24412469852,2251.94982020743,2138.79896507223,8,10
"8000659",7,1752.52955421955,1847.63426705023,1763.32076508842,3,4
"8000660",18,2071.13026801919,1997.09518062253,2138.79896507223,7,11
"8000661",41,2835.42245216588,3462.03011741949,2530.72175773865,18,23
"8000662",45,3023.08066549827,3527.32798612492,2579.33597919865,16,29
"8000663",44,2819.35713053369,2851.47701727693,2567.51523707907,21,23
"8000665",16,2066.49058005838,2136.01520896379,2087.92318348224,8,8
"8000666",10,1998.66672568015,1983.42469274222,1896.67490607898,3,7
"8000672",16,2157.31031804159,1908.05536415002,2087.92318348224,7,9
"8000673",7,1839.47106134302,1822.6450477031,1763.32076508842,4,3
"8000674",11,1975.94794842675,1916.44905474904,1933.98659929558,4,7
"855003140",38,2036.54208586597,1219.52216944265,2491.71993967651,11,27
"855003141",28,2064.61886505229,1904.47476486492,2340.94327947849,14,14
"855003142",35,2322.39377920679,1586.89186476154,2450.1860183293,17,18
"855003143",34,2170.76586571764,1894.26010293627,2435.71163614839,16,18
"855003144",27,2160.30466517275,2130.0813705029,2323.60649590586,13,14
"855003145",34,2159.27010726472,1921.50325229156,2435.71163614839,14,20
"855003146",25,2051.31737843425,1790.81032838818,2287.34065519221,11,14
"912340005",2,1313.98244587047,1364.97646362037,1364.97646362037,0,2
"912340006",3,1493.18769523061,1365.39917698357,1482.92019466158,0,3
"912340007",3,1477.54143400874,1405.17374870386,1482.92019466158,1,2
"912340008",4,1451.4587455041,1555.82116851105,1572.73281143487,2,2
"912340009",2,1298.92922272858,1231.84276972069,1364.97646362037,0,2
"912340011",50,2932.10197179415,2713.52885561612,2635.48551585152,26,24
"912340012",56,2848.01662809067,2711.32430327821,2697.24673169728,22,34
"912340013",69,2707.35748451019,2432.06290763537,2814.82611826518,26,43
"912340014",52,2614.92968774006,2443.97810850904,2656.6981055205,23,29
"912340015",54,2395.43325614538,2366.89474137777,2677.2712016452,23,31
"912340016",53,2582.0730744245,2785.44512845189,2667.061866114,19,34
"912340017",62,2553.71857275,2850.04655317528,2753.94837323248,22,40
"912340018",61,2905.73227074961,3298.12310446746,2744.81051624266,23,38
"912340019",60,2865.49023702681,3128.04435738913,2735.5526890818,22,38
"912340020",71,3292.9417631475,2226.21979088575,2831.31372136695,29,42
"912340021",67,2952.16140685992,3006.60361925512,2797.95380131742,28,39
"912340022",68,3059.97010096747,2839.30895022669,2806.43931339586,29,39
"912340023",48,2491.66001326952,2011.50147525965,2613.58673801098,20,28
"912340024",51,2757.65530867574,2562.86272896044,2646.17454577679,21,30
"912340025",68,3107.09915508311,3040.17013237673,2806.43931339586,21,47
"912340026",60,2535.04171937852,1975.32486682499,2735.5526890818,24,36
"912340027",68,3227.72760464829,3433.67542690227,2806.43931339586,24,44
"912340028",67,2658.96158722093,2635.82809222053,2797.95380131742,29,38
"912340029",61,2725.74206113376,2782.72831796443,2744.81051624266,23,38
"912340030",62,3101.64475292247,2696.72460785506,2753.94837323248,26,36
"912340031",38,2506.59936868271,2143.42404202208,2491.71993967651,16,22
"912340032",53,2522.82188007654,2342.39841912666,2667.061866114,17,36
"912340033",61,2897.54401382107,3072.06972325621,2744.81051624266,21,40
"912340034",70,2993.28760636045,2914.3848997361,2823.11677003184,28,42
"912340035",46,2715.59937170891,2628.78727124159,2590.94954296761,16,30
"912340036",41,2472.22229565137,2551.65338726216,2530.72175773865,22,19
"912340037",10,1680.06348492739,1486.22830846601,1896.67490607898,3,7
"912340038",6,1579.59105610343,1580.12534426375,1708.62817714657,3,3
"912340039",12,1707.57329914375,1547.01659856867,1968.69006049611,4,8
"912340040",8,1666.97152722898,1612.83134002695,1812.11073017574,3,5
"912340041",11,1656.0965169961,1317.67680949624,1933.98659929558,3,8
"912340042",10,1567.84100311504,1108.6302435035,1896.67490607898,3,7
"912340043",10,1597.55905482046,1409.34574226465,1896.67490607898,2,8
"912340044",12,1583.96089552399,1413.79580061425,1968.69006049611,3,9
"912340045",9,1604.21828538887,1460.88819998548,1856.26587460569,2,7
"912340046",11,1602.92411174406,1453.50158619712,1933.98659929558,2,9
"912340047",13,1687.54365582336,1259.80897282405,2001.16379457045,3,10
"912340048",6,1587.73016789638,1403.37007333786,1708.62817714657,2,4
"912340141",21,1854.18706425395,1365.18052082037,2207.26116887512,4,17
"912340142",15,1906.8203270189,1402.64024093985,2060.56118614118,3,12
"912340143",21,1942.10336139985,1287.927291208,2207.26116887512,4,17
"912340144",18,1890.34704166978,1579.82630147784,2138.79896507223,4,14
"912340145",9,1733.87999464619,1436.54673700606,1856.26587460569,3,6
"912340146",12,1784.76106475317,1585.94076327575,1968.69006049611,4,8
"912340147",13,1867.59638646329,1791.90733005107,2001.16379457045,4,9
"912340148",19,1878.46434793378,1788.95614132509,2162.56636020013,5,14
"912340149",9,1802.62431481518,1711.06238265552,1856.26587460569,2,7
"912340150",14,1840.93924137576,1627.53595137974,2031.70713799962,2,12
"912340151",16,1874.83830958623,1846.0557313045,2087.92318348224,4,12
"912340152",14,1925.68682843803,1966.97779374665,2031.70713799962,3,11
"912340153",8,1742.66039865906,1722.98964660148,1812.11073017574,1,7
"912340154",12,1874.03841203915,1867.473706079,1968.69006049611,3,9
"912340155",9,1875.34242594493,1898.00474541988,1856.26587460569,3,6
"912340156",8,1782.00375202826,1790.17575086536,1812.11073017574,2,6
"912340157",12,1942.45175281215,1991.87064132878,1968.69006049611,2,10
"912340158",6,1749.18458190747,1741.91090625114,1708.62817714657,1,5
"912340159",24,2026.67855729314,1779.05841070529,2268.33468283819,5,19
"912340160",24,2069.12561107862,1707.14382036593,2268.33468283819,6,18
"912340161",13,1898.82780140659,1803.80303383832,2001.16379457045,3,10
"912340162",14,1890.47366141589,1862.3748503193,2031.70713799962,3,11
"912340163",12,1940.34331250953,2039.55746558567,1968.69006049611,1,11
"912340164",14,1907.2386064364,1986.03074024306,2031.70713799962,3,11
"912340165",16,1816.21630287354,1545.32599695592,2087.92318348224,4,12
"912340166",9,1873.94914726746,1862.46745076827,1856.26587460569,2,7
"912340167",12,1773.05924920267,1702.61729326854,1968.69006049611,4,8
"912340168",15,1884.26285733976,2182.66777008864,2060.56118614118,3,12
"912340169",14,1768.16700026518,1672.92921545881,2031.70713799962,4,10
"912340170",10,1875.26617873596,1966.5829436566,1896.67490607898,4,6
"912340171",18,1812.82440935528,1734.91155287336,2138.79896507223,3,15
"912340172",16,1878.69025342251,1749.67261634365,2087.92318348224,3,13
"912340173",17,1878.55279675962,1801.44747727674,2113.95669457394,3,14
"912340174",19,1806.73884663949,1836.06434764127,2162.56636020013,4,15
"912340175",16,1810.47105960747,1585.6753114842,2087.92318348224,3,13
"912340176",12,1869.02438236252,1862.81726827502,1968.69006049611,3,9
"912340177",21,1764.28409235289,1496.69661238968,2207.26116887512,4,17
"912340178",13,1801.57150612665,1671.67827883006,2001.16379457045,2,11
"912340179",19,1841.56848305617,1706.11957144058,2162.56636020013,4,15
"912340180",23,1771.77254409436,1654.56026489183,2248.68783741607,7,16
"912340181",23,1922.40036695849,2043.34213719443,2248.68783741607,6,17
"912340182",20,1931.91328834523,1753.54517421939,2185.35845629437,4,16
"912340183",15,1921.87681700528,1474.54983382921,2060.56118614118,3,12
"912340184",15,1771.80746858727,1320.09307743212,2060.56118614118,2,13
"912340185",8,1739.4513652012,1706.05521053436,1812.11073017574,3,5
"912340186",17,1952.27708930195,1544.95323363818,2113.95669457394,4,13
"912340187",9,1735.93139516297,1627.83046133932,1856.26587460569,2,7
"912340188",15,1950.24363098537,1709.66010535658,2060.56118614118,2,13
"912340189",12,1812.21388821621,1485.3690141953,1968.69006049611,3,9
"912340190",11,1863.00511974263,1602.99540700608,1933.98659929558,2,9
"912340192",10,1814.66079491404,1711.15898060845,1896.67490607898,2,8
"912340193",12,1908.63341577365,1746.58890452251,1968.69006049611,3,9
"912340194",12,1989.00596803293,2009.33417652243,1968.69006049611,4,8
"912340195",6,1694.38532590119,1654.11303491783,1708.62817714657,0,6
"912340196",9,1843.02472673876,1782.13417649839,1856.26587460569,3,6
"912340197",9,1843.89219950787,1888.29189185036,1856.26587460569,2,7
"912340198",7,1757.26003301524,1810.39964772108,1763.32076508842,0,7
"912340199",10,1920.09747218503,1859.81717881745,1896.67490607898,2,8
"912340200",9,1824.08391937313,1736.89704208298,1856.26587460569,0,9
"912340201",15,1928.85568058539,1974.89227116571,2060.56118614118,4,11
"912340202",13,1902.67954361827,1614.78310119096,2001.16379457045,4,9
"912340203",11,1828.91897364488,1775.37658749608,1933.98659929558,3,8
"912340204",12,1870.16579787699,1880.01980229506,1968.69006049611,4,8
"912340205",7,1733.80238732165,1793.6512900442,1763.32076508842,1,6
"912340206",9,1835.32865741721,1843.42141406767,1856.26587460569,1,8
"912340207",14,1888.5020815943,1835.21770809903,2031.70713799962,3,11
"912340209",11,1932.74377451127,2050.38476715624,1933.98659929558,3,8
"912340210",11,1941.43581295459,2086.110540788,1933.98659929558,4,7
"912340211",13,1886.5314693242,1951.22186688548,2001.16379457045,3,10
"912340212",12,1906.6185643751,1875.67287531328,1968.69006049611,4,8
"912340213",14,1769.84691977169,1218.74658156418,2031.70713799962,3,11
"912340214",15,1817.01745889681,1832.51578005611,2060.56118614118,2,13
"912340216",15,1814.50711345124,1868.78459441119,2060.56118614118,4,11
"912340217",12,1926.09806777226,1885.26781027361,1968.69006049611,4,8
"912340218",15,1916.51161941142,1888.17374652493,2060.56118614118,4,11
"912340219",12,1917.00124687218,1785.85489899142,1968.69006049611,3,9
"912340220",11,1804.47501941617,1613.98336397777,1933.98659929558,2,9
"912340221",13,1901.28989617472,1772.92004680924,2001.16379457045,2,11
"912340222",16,1996.26636366555,1785.188939491,2087.92318348224,3,13
"912340223",15,1855.59181035298,1733.66842265236,2060.56118614118,4,11
"912340224",15,1860.50222946042,1708.3205988887,2060.56118614118,4,11
"912340226",13,1941.98532037673,1881.86306525203,2001.16379457045,2,11
"912340227",24,1848.99759337784,1833.03665491885,2268.33468283819,2,22
"912340234",23,2022.11359573139,1975.60525315237,2248.68783741607,5,18
"912340235",30,1862.65476502249,1615.24503284385,2374.18906024059,7,23
"912340236",27,1755.09925889562,1474.23852417997,2323.60649590586,6,21
"912340237",21,1805.44078586931,1797.29191664023,2207.26116887512,4,17
"912340239",37,2110.23589529148,1893.12331389615,2478.17471526668,10,27
"912340240",23,1818.39133586597,1611.79120229782,2248.68783741607,7,16
"912340242",32,2201.44507388167,2215.58908835256,2405.71569249515,9,23
"912340248",26,2029.5876235311,1678.39184493865,2305.75108410937,6,20
"912340251",28,1905.53045832758,1692.12633918985,2340.94327947849,7,21
"912340252",40,1857.00562522304,1667.17295414266,2517.98110851286,12,28
"912340253",15,1979.01733589656,2111.37071070359,2060.56118614118,4,11
"912340254",45,1961.95938413184,1547.97115634837,2579.33597919865,11,34
"912340257",21,2010.68609424169,1659.93906350102,2207.26116887512,4,17
"912340259",15,2113.02758950159,2201.80319664801,2060.56118614118,3,12
"912340260",32,1933.23751168581,1567.76933613962,2405.71569249515,9,23
"912340262",11,1787.13757867595,1643.39823230293,1933.98659929558,1,10
"912340263",24,2099.84523112048,1845.01495178114,2268.33468283819,5,19
"912340264",26,2147.53047605973,2321.06194674496,2305.75108410937,8,18
"912340265",32,2113.26700913249,1948.90374983439,2405.71569249515,6,26
"912340266",39,2159.56979117493,2606.0694997426,2504.98447234734,9,30
"912340270",16,1994.75967856403,2047.87898977368,2087.92318348224,4,12
"912340272",16,1968.86923939447,2101.62137691536,2087.92318348224,4,12
"912340273",27,2105.91624430044,1984.8230235,2323.60649590586,6,21
"912340274",7,1701.34452905211,1693.57488116844,1763.32076508842,2,5
"912340275",23,1793.87206566106,1378.32298940199,2248.68783741607,6,17
"912340277",19,1711.42792401543,1477.90294273061,2162.56636020013,5,14
"912340278",29,1890.58576377332,1188.54672496597,2357.79423966008,5,24
"912340279",27,1859.42288039627,1568.16759184386,2323.60649590586,5,22
"912340280",7,1599.95242110329,1596.97288752118,1763.32076508842,3,4
"912340281",5,1585.60340914,1569.47618946909,1646.12614877363,3,2
"912340282",15,1916.354633838,1664.36327591986,2060.56118614118,5,10
"912340283",17,1928.99631521686,1896.47863377052,2113.95669457394,6,11
"912340284",18,2041.92346959756,1754.26709285429,2138.79896507223,3,15
"912340285",15,1884.79744597475,1867.26675315428,2060.56118614118,2,13
"912340286",22,1923.82833265129,1671.4928117161,2228.3491786518,2,20
"912340287",23,1915.75994968958,1576.85991705523,2248.68783741607,3,20
"912340294",8,1719.06033502245,1579.48107042836,1812.11073017574,2,6
"912340295",33,2428.35255830081,2482.92419131608,2420.89448855093,10,23
"912340296",21,2020.44899042521,1985.95556257901,2207.26116887512,5,16
"912340297",34,2020.64539392517,2027.94563365297,2435.71163614839,10,24
"912340298",30,2063.80156123929,1677.05232289532,2374.18906024059,6,24
"912340301",29,2123.49981477976,1940.92491496535,2357.79423966008,7,22
"912340302",15,1951.66998574365,1816.63874287405,2060.56118614118,3,12
"912340303",17,2012.62637756199,2151.37525304136,2113.95669457394,4,13
"912340306",22,1959.02583066931,1927.1812362623,2228.3491786518,7,15
"912340307",23,2020.67409976444,2130.36991841086,2248.68783741607,6,17
"912340308",33,2216.71361557438,1588.55973834419,2420.89448855093,8,25
"912340309",34,2054.13088934951,1700.06416692804,2435.71163614839,7,27
"912340311",36,2057.96680010977,1916.92518031088,2464.33502634194,10,26
"912340317",48,2108.22719397792,1519.13104853002,2613.58673801098,16,32
"912340319",10,1710.32072345563,1603.27080626952,1896.67490607898,3,7
"912340320",10,1711.24675445478,1634.35514575527,1896.67490607898,3,7
"912340321",9,1707.14348975715,1510.37260338767,1856.26587460569,2,7
"912340322",8,1675.02325642023,1558.72582981513,1812.11073017574,3,5
"912340323",17,1840.50584491156,1658.15731800013,2113.95669457394,4,13
"912340324",13,1758.17646458671,1535.93713615541,2001.16379457045,4,9
"912340325",22,1765.30458042273,1131.04375803829,2228.3491786518,5,17
"912340326",22,1897.71494822448,1405.63592858619,2228.3491786518,4,18
"912340327",24,1912.02951216511,1548.63468966021,2268.33468283819,7,17
"912340328",15,1928.66121107045,1674.0596006707,2060.56118614118,4,11
"912340329",18,1944.26430281959,1530.40148544394,2138.79896507223,5,13
"912340330",19,1966.85956889762,1849.62295037539,2162.56636020013,3,16
"912340331",17,1925.34645298715,1873.90756530313,2113.95669457394,4,13
"912340332",14,1824.87805315859,1870.87169898706,2031.70713799962,5,9
"912340333",21,1787.43584107962,1687.68715199176,2207.26116887512,5,16
"912340334",7,1587.56137605625,1338.86382018158,1763.32076508842,4,3
"912340335",11,1787.69443425683,1709.68266157541,1933.98659929558,3,8
"912340336",10,1629.45746437422,1541.60414697279,1896.67490607898,3,7
"912340337",9,1632.95151758806,1519.42473605175,1856.26587460569,2,7
"912340338",16,1761.26933457314,1355.07742474414,2087.92318348224,5,11
"912340339",12,1701.35022831547,1522.88894270055,1968.69006049611,4,8
"912340340",11,1664.84653494004,1844.87758543088,1933.98659929558,2,9
"912340341",9,1685.91666722484,1484.36442197663,1856.26587460569,3,6
"912340342",13,1877.87142387585,1630.80786421859,2001.16379457045,4,9
"912340343",6,1595.89383468912,1459.6973956188,1708.62817714657,2,4
"912340344",9,1741.76694519641,1511.11284015268,1856.26587460569,3,6
"912340346",18,1827.5470675197,1601.87874102017,2138.79896507223,4,14
"912340348",11,1867.04875314168,1854.20794566739,1933.98659929558,4,7
"912340349",22,1885.65813780414,1819.10520037026,2228.3491786518,7,15
"912340350",25,2027.71623916159,2075.38987054075,2287.34065519221,4,21
"912340352",20,1971.16744344312,1991.83515746979,2185.35845629437,4,16
"912340357",62,3186.87571646257,3461.11280452603,2753.94837323248,18,44
"912340358",12,1971.07329018087,1951.68101531986,1968.69006049611,1,11
"912340359",18,1885.65451102733,1725.78552963285,2138.79896507223,5,13
"912340360",63,3625.66367476748,4423.01338357855,2762.96971264875,19,44
"912340361",71,4031.95112010353,4039.75798421488,2831.31372136695,15,56
"912340362",72,4077.0576508013,4626.09018833457,2839.4193288992,24,48
"912340363",70,3646.21079538464,4210.45184374169,2823.11677003184,17,53
"912340364",79,3426.40555053256,3899.38859338251,2893.78092561085,23,56
"912340365",59,2867.81287915113,3368.57291380014,2726.17127719361,15,44
"912340366",73,3653.53639099383,5859.9985598357,2847.4358582506,22,51
"912340367",74,3752.08649443434,3906.3646231434,2855.36548874306,19,55
"912340368",65,4048.88703926457,4452.40436738814,2780.67589681985,21,44
"912340369",58,3224.31946009604,3708.801999614,2716.66249357165,16,42
"912340370",60,3767.9851895487,3617.53663081577,2735.5526890818,20,40
"912340371",59,3674.83032032128,5052.38952868284,2726.17127719361,16,43
"912340372",49,3133.17928236673,3608.42160987686,2624.62502504328,12,37
"912340373",53,3126.39421808452,3119.78630867402,2667.061866114,20,33
"912340374",48,3278.1023338595,3365.71172730844,2613.58673801098,17,31
"912340375",60,3496.08960527304,4391.02172156664,2735.5526890818,19,41
"912340376",56,3570.66773023006,3720.65890715673,2697.24673169728,18,38
"912340377",67,3629.05005014836,3596.89503437003,2797.95380131742,20,47
"912340378",52,3376.98045586694,3225.80002236858,2656.6981055205,16,36
"912340379",60,3293.66763374506,3322.84126316662,2735.5526890818,19,41
"912340380",52,2660.14208440473,2516.72942210968,2656.6981055205,13,39
"912340381",55,3356.10431995345,3515.41229540415,2687.33120998132,15,40
"912340382",68,2980.32871640775,3086.24599749049,2806.43931339586,22,46
"912340383",60,3006.30553104952,3559.99229745989,2735.5526890818,19,41
"912340384",50,3427.12645842556,4004.59751039853,2635.48551585152,13,37
"912340385",51,2856.22991429943,2846.9269674597,2646.17454577679,16,35
"912340386",50,2931.24949456725,2994.91536235098,2635.48551585152,18,32
"912340387",53,3282.94749699513,3501.63740870129,2667.061866114,18,35
"912340388",35,2811.61806796691,2766.04040649985,2450.1860183293,10,25
"912340389",38,2948.86270498676,2975.16862638082,2491.71993967651,11,27
"912340390",48,2731.36210208467,3133.52632743168,2613.58673801098,14,34
"912340391",70,2828.0519886131,2399.24782853868,2823.11677003184,18,52
"912340392",38,2768.7581134196,2734.32810928721,2491.71993967651,12,26
"912340393",74,2723.634941324,2876.67136257053,2855.36548874306,18,56
"912340394",42,2531.94947128776,2152.53188003427,2543.21752514954,9,33
"912340395",36,2277.78992996653,1883.4162115514,2464.33502634194,9,27
"912340396",39,2482.78203567207,1715.4169578383,2504.98447234734,8,31
"912340397",44,2249.76379994606,1574.76094957229,2567.51523707907,11,33
"912340398",39,2431.92159541843,2041.85233721071,2504.98447234734,6,33
"912340399",40,2427.70445876776,2127.15497959748,2517.98110851286,8,32
"912340400",38,2400.19301854738,2092.8869825089,2491.71993967651,7,31
"912340401",32,2302.75222374324,2099.44677772872,2405.71569249515,5,27
"912340402",39,2343.52099046568,2110.03688494049,2504.98447234734,6,33
"912340403",39,2239.07405176646,2282.39647568559,2504.98447234734,6,33
"912340404",32,2280.84242597641,2274.65471204076,2405.71569249515,3,29
"912340405",44,2415.03864460382,2129.89907345121,2567.51523707907,8,36
"912340406",31,2309.36887325443,2279.69027144204,2390.15469389133,5,26
"912340407",35,2373.50020975631,2379.20477697367,2450.1860183293,5,30
"912340409",1,1161.63288973642,1184.66451052022,1184.66451052022,0,1
"912340410",1,1154.06889749332,1184.66451052022,1184.66451052022,1,0
"912340411",1,1160.86995737529,1146.60365874313,1184.66451052022,0,1
"912340414",11,1705.80164985261,1195.49549556276,1933.98659929558,1,10
"912340416",7,1730.17370173468,1710.67999896936,1763.32076508842,1,6
"912340417",11,1686.71623951546,1117.57462967159,1933.98659929558,2,9
"912340418",10,1704.93255775508,1532.85630649431,1896.67490607898,0,10
"912340419",8,1686.95427563801,1453.03276432517,1812.11073017574,1,7
"912340420",9,1730.41365002821,1356.8493016897,1856.26587460569,2,7
"912340421",11,1782.51389327259,1505.89142458093,1933.98659929558,3,8
"912340422",11,1725.78682382785,1666.03935213956,1933.98659929558,1,10
"912340423",9,1810.91271758143,1832.4511192692,1856.26587460569,2,7
"912340424",9,1697.67064192674,1281.40398421272,1856.26587460569,1,8
"912340425",16,1764.2579812192,1450.21702082755,2087.92318348224,2,14
"912340426",12,1752.73437097386,1635.2069104017,1968.69006049611,3,9
"912340427",12,1764.32301899627,1379.98620988004,1968.69006049611,2,10
"912340428",12,1744.75564795501,1537.75091148667,1968.69006049611,1,11
"912340429",8,1743.70924831032,1361.91621443415,1812.11073017574,2,6
"912340430",7,1718.89531710672,1929.57176821587,1763.32076508842,0,7
"912340431",8,1650.74096578444,1669.96367940887,1812.11073017574,0,8
"912340433",12,1718.80289857458,1538.03681186372,1968.69006049611,1,11
"912340434",9,1691.59916910678,1467.22681796746,1856.26587460569,1,8
"912340435",9,1719.05102606938,1536.91179783557,1856.26587460569,0,9
"912340436",7,1719.84950160004,1843.22789794606,1763.32076508842,0,7
"912340437",8,1718.30783313402,1805.7556168356,1812.11073017574,1,7
"912340438",8,1761.41503299249,1758.72841821569,1812.11073017574,2,6
"912340439",9,1727.20958079904,1843.86610784138,1856.26587460569,2,7
"912340440",11,1746.74173684875,1437.31244094559,1933.98659929558,2,9
"912340441",6,1683.625396235,1718.47818637944,1708.62817714657,1,5
"912340442",9,1830.41406242445,1915.94563082862,1856.26587460569,2,7
"912340443",15,1874.72065364815,1930.83953430764,2060.56118614118,4,11
"912340444",9,1589.97061118671,1146.99740974304,1856.26587460569,0,9
"912340445",8,1727.7210803621,1333.66416975455,1812.11073017574,2,6
"912340446",30,1832.02261702475,1383.42562262237,2374.18906024059,9,21
"912340447",23,2062.10780443523,1633.50084768873,2248.68783741607,9,14
"912340448",23,2215.30712422774,1804.94205982804,2248.68783741607,9,14
"912340449",15,1880.1406093563,1723.67811332908,2060.56118614118,6,9
"912340450",24,1974.47735070721,1760.31997769192,2268.33468283819,12,12
"912340451",21,1972.9280206329,2038.74825201604,2207.26116887512,6,15
"912340452",17,1858.84308890855,1850.68506314296,2113.95669457394,5,12
"912340453",36,2425.12918632232,2104.42511509172,2464.33502634194,16,20
"912340454",23,2216.23288403896,1720.34836258561,2248.68783741607,10,13
"912340455",19,2283.59009098444,1841.4303533533,2162.56636020013,10,9
"912340456",21,2174.19193705999,2147.78850463038,2207.26116887512,8,13
"912340457",32,2489.40420577444,2626.22035314633,2405.71569249515,13,19
"912340458",21,2238.67961562608,2270.76347745378,2207.26116887512,9,12
"912340459",23,2277.15823240307,2328.54294756994,2248.68783741607,9,14
"912340460",26,2496.6290648432,2440.59064597223,2305.75108410937,12,14
"912340461",36,2746.0614170236,2603.12854049099,2464.33502634194,18,18
"912340462",37,2511.10982569682,3091.43690977421,2478.17471526668,19,18
"912340463",38,2569.38829814381,2831.99984197512,2491.71993967651,18,20
"912340464",42,2738.26182441274,2384.67626462277,2543.21752514954,18,24
"912340465",41,2593.70304707576,2412.71198313435,2530.72175773865,15,26
"912340466",39,2710.69503786644,2442.17314534925,2504.98447234734,17,22
"912340467",40,2605.30888330527,2455.68198247025,2517.98110851286,16,24
"912340468",22,2076.05664091681,1984.61224293863,2228.3491786518,6,16
"912340469",14,2081.24774691512,2139.21847234238,2031.70713799962,7,7
"912340470",30,1959.04127263452,1387.02138889228,2374.18906024059,15,15
"912340471",40,2218.83438175503,1607.29567387002,2517.98110851286,17,23
"912340472",37,2100.0130954413,1609.44684132187,2478.17471526668,12,25
"912340473",20,2142.79829887084,1691.37085416665,2185.35845629437,8,12
"912340474",26,2078.68557809798,2167.74273749347,2305.75108410937,10,16
"912340475",20,2190.5975733168,2036.78255752211,2185.35845629437,10,10
"912340476",34,2258.09311327002,1959.12304819221,2435.71163614839,8,26
"912340477",22,2218.01048653239,1899.83547891546,2228.3491786518,10,12
"912340478",27,2351.43610101232,1883.07992102916,2323.60649590586,8,19
"912340479",20,2131.7765641967,1890.55910652713,2185.35845629437,8,12
"912340480",32,1883.27587146905,1736.48337470336,2405.71569249515,9,23
"912340481",24,2035.7354101433,1798.97189780445,2268.33468283819,10,14
"912340482",29,2200.60501151356,2052.82418578602,2357.79423966008,10,19
"912340483",34,2039.08918222719,1528.96342452968,2435.71163614839,17,17
"912340484",26,2227.92572227166,1570.44253503061,2305.75108410937,11,15
"912340485",20,1964.84736447526,1622.05548835289,2185.35845629437,10,10
"912340486",23,1919.34042632512,1333.35314616797,2248.68783741607,7,16
"912340487",20,2001.69035592024,1484.3833670437,2185.35845629437,4,16
"912340488",24,2241.77917710527,1800.23961045341,2268.33468283819,10,14
"912340489",25,2041.00919594456,1914.01900003053,2287.34065519221,10,15
"912340490",26,2125.12312129815,1642.32199395652,2305.75108410937,6,20
"912340491",46,2502.24477329818,2204.24722425174,2590.94954296761,17,29
"912340492",18,1988.64277066419,1703.36254670271,2138.79896507223,5,13
"912340493",27,2352.44479016101,2075.01948613244,2323.60649590586,10,17
"912340494",17,1994.30443640084,1686.34049135623,2113.95669457394,4,13
"912340495",16,2013.80698823116,1716.14318045141,2087.92318348224,7,9
"912340496",13,1917.34841147185,1774.17949796812,2001.16379457045,4,9
"912340497",12,1932.05679906822,1776.20187047041,1968.69006049611,5,7
"912340498",17,2019.68224903286,1857.61516088638,2113.95669457394,7,10
"912340499",19,1981.28895106237,1860.63573943232,2162.56636020013,8,11
"912340500",28,2143.97077698084,1887.88913251367,2340.94327947849,13,15
"912340501",23,2057.14616055418,1647.32758846241,2248.68783741607,11,12
"912340502",14,1941.48327398945,1746.0145674888,2031.70713799962,6,8
"912340503",12,1848.80163682084,1660.4420003335,1968.69006049611,6,6
"912340504",21,1973.69019599379,1647.4470945691,2207.26116887512,6,15
"912340505",16,2002.14245554384,1875.36002346091,2087.92318348224,9,7
"912340506",18,2004.7794828361,1648.3418994137,2138.79896507223,8,10
"912340507",23,2007.34444692638,1497.64595203259,2248.68783741607,7,16
"912340508",33,2103.07688456759,1659.07950988373,2420.89448855093,14,19
"912340509",29,2150.67125020763,1599.91189657164,2357.79423966008,12,17
"912340510",41,2194.3273876871,1639.87432825767,2530.72175773865,11,30
"912340512",26,2248.99583565738,2172.09442821114,2305.75108410937,9,17
"912340513",34,2172.01936008275,1761.25692478993,2435.71163614839,11,23
"912340514",46,2806.22920700047,2893.08820825515,2590.94954296761,22,24
"912340515",38,2561.5969095303,2728.4985071826,2491.71993967651,18,20
"912340517",21,1824.8943520024,1959.83835492266,2207.26116887512,7,14
"912340518",19,2132.57170274093,2130.77221215364,2162.56636020013,7,12
"912340519",31,2305.03139005401,2302.80097633313,2390.15469389133,13,18
"912340520",19,2076.36850644849,1647.73262564875,2162.56636020013,7,12
"912340521",25,2143.20521972257,1863.42420274426,2287.34065519221,9,16
"912340522",18,1988.56396541454,1613.69517307491,2138.79896507223,7,11
"912340523",20,2085.88707935874,1714.51488188626,2185.35845629437,8,12
"912340524",23,2348.93316198099,2337.02022936152,2248.68783741607,9,14
"912340525",24,2276.97710917656,2332.39437600654,2268.33468283819,8,16
"912340526",23,2287.77281630816,2498.63744353927,2248.68783741607,9,14
"912340527",36,2102.48396537589,1911.69304195844,2464.33502634194,13,23
"912340528",28,1938.6481601909,1625.25175710308,2340.94327947849,9,19
"912340529",37,2290.84455734373,1679.66801490635,2478.17471526668,17,20
"912340530",25,2058.35185191913,1781.32148673236,2287.34065519221,11,14
"912340531",18,2029.82888561563,1912.7318898935,2138.79896507223,8,10
"912340532",32,2275.63034578579,1684.75402331958,2405.71569249515,17,15
"912340533",24,2147.22663157189,1690.63682910015,2268.33468283819,10,14
"912340534",30,1993.16945223071,1534.57290256325,2374.18906024059,12,18
"912340535",19,1894.24322358315,1572.08545211156,2162.56636020013,8,11
"912340536",30,2240.67893666584,2194.106973866,2374.18906024059,9,21
"912340537",22,2114.68527356539,1726.4249548917,2228.3491786518,10,12
"912340538",30,2175.52956064503,1934.51132357556,2374.18906024059,12,18
"912340539",15,1896.83422393559,1799.69163624978,2060.56118614118,4,11
"912340540",19,1956.65600589912,1605.49239429595,2162.56636020013,6,13
"912340541",29,2074.47208609664,1529.55200391771,2357.79423966008,10,19
"912340542",33,1997.58238528496,1293.34377506338,2420.89448855093,8,25
"912340543",26,2069.44911257083,1634.20725806392,2305.75108410937,6,20
"912340544",45,2475.53534394504,2507.96862109532,2579.33597919865,17,28
"912340545",30,2416.11933440478,2337.75393151312,2374.18906024059,12,18
"912340546",33,2270.67159643543,1964.25084852304,2420.89448855093,12,21
"912340547",37,2180.83727786267,1634.10441860391,2478.17471526668,14,23
"912340548",36,2402.51724632292,2484.21332001835,2464.33502634194,16,20
"912340549",45,2860.65801085406,2102.88233796775,2579.33597919865,24,21
"912340550",59,3019.27492494428,2657.13111373443,2726.17127719361,20,39
"912340551",27,2096.54875062976,1508.75364530744,2323.60649590586,6,21
"912340552",26,1928.21869801626,1599.5494336812,2305.75108410937,8,18
"912340553",20,1954.11912009703,1433.18726446134,2185.35845629437,5,15
"912340554",22,2096.49045279693,1655.70586345921,2228.3491786518,4,18
"912340555",28,2147.61741315674,1597.97755731982,2340.94327947849,8,20
"912340556",22,1981.45620724594,1184.04802089536,2228.3491786518,6,16
"912340557",14,1983.53046111723,1797.08208019301,2031.70713799962,2,12
"912340559",62,2831.84427210331,3869.61484378275,2753.94837323248,26,36
"912340560",49,2858.0590047097,3642.3366688834,2624.62502504328,21,28
"912340561",37,2710.30689145561,2718.07802476738,2478.17471526668,19,18
"912340562",48,2916.43253103175,3653.49390132485,2613.58673801098,23,25
"912340563",53,2971.7014284461,3324.20812651281,2667.061866114,22,31
"912340564",39,3134.47088984791,3640.97453052288,2504.98447234734,15,24
"912340565",37,2882.67241612225,3532.44703263923,2478.17471526668,14,23
"912340566",36,2627.62704411608,3251.46962504993,2464.33502634194,13,23
"912340567",47,2650.74174137495,3262.31909353468,2602.36394728806,18,29
"912340568",40,2653.30279535214,3468.29529018333,2517.98110851286,17,23
"912340569",46,2979.00526733735,3546.96069187786,2590.94954296761,17,29
"912340570",43,2796.83620038998,3127.39768694669,2555.47878346624,19,24
"912340571",43,2802.6166382915,3515.21060602424,2555.47878346624,25,18
"912340572",42,2689.78616471995,3353.1389981667,2543.21752514954,16,26
"912340573",42,2675.73692250057,3077.67537283994,2543.21752514954,18,24
"912340574",55,3289.19522061038,3835.30262392961,2687.33120998132,25,30
"912340575",66,3431.22291425801,3773.68573156519,2789.3669207067,26,40
"912340576",54,3209.09506405521,3647.77235166315,2677.2712016452,24,30
"912340577",47,2945.42855631998,3784.23232271038,2602.36394728806,17,30
"912340578",46,2833.64661423545,2901.42857161732,2590.94954296761,20,26
"912340579",45,2593.51695344208,2674.4982159778,2579.33597919865,16,29
"912340580",46,2674.6938966832,2746.15831208703,2590.94954296761,19,27
"912340581",46,2485.57717405768,3130.10176150439,2590.94954296761,16,30
"912340582",50,2872.89576906685,3142.19400071779,2635.48551585152,20,30
"912340583",64,3205.865196032,4066.70872107875,2771.87783482774,27,37
"912340584",50,2813.69104425749,3332.18783928019,2635.48551585152,20,30
"912340586",49,2996.28484147481,3606.08009009116,2624.62502504328,22,27
"912340587",42,3024.01485274332,3823.70413819428,2543.21752514954,23,19
"912340588",36,2934.46498014518,3044.36463205593,2464.33502634194,19,17
"912340589",44,3001.02810840713,3599.83987760326,2567.51523707907,20,24
"912340590",51,2814.15082010317,3738.92535652917,2646.17454577679,23,28
"912340591",49,2598.97784235531,3342.60594059301,2624.62502504328,21,28
"912340592",24,2382.64002277439,2620.66298027736,2268.33468283819,9,15
"912340593",29,2187.26733753965,2198.56821781339,2357.79423966008,9,20
"912340594",44,2772.85369004244,2506.92855636952,2567.51523707907,15,29
"912340595",40,2523.00071169451,2301.55263829799,2517.98110851286,13,27
"912340596",43,2678.25432709502,2560.90287509943,2555.47878346624,17,26
"912340597",40,2553.2317434462,2694.90634166942,2517.98110851286,11,29
"912340598",43,2653.45874579663,2986.31641093409,2555.47878346624,18,25
"912340599",37,2543.39908065105,2751.69583551544,2478.17471526668,10,27
"912340600",27,2365.8251181656,2904.80566624931,2323.60649590586,11,16
"912340601",25,2291.83647249174,2610.77090633045,2287.34065519221,10,15
"912340602",42,2561.9265777159,2682.53959927697,2543.21752514954,17,25
"912340603",53,2509.48672882942,2458.22936138634,2667.061866114,15,38
"912340604",54,3296.64103752886,3808.59950009418,2677.2712016452,21,33
"912340605",58,3264.00426214647,4097.67781664461,2716.66249357165,23,35
"912340606",40,2570.98966518028,2969.97945560855,2517.98110851286,14,26
"912340607",41,2680.8696602621,3287.11840199677,2530.72175773865,16,25
"912340608",39,2416.09215523374,2331.11160968156,2504.98447234734,15,24
"912340609",34,2567.20361285423,2485.90447495814,2435.71163614839,16,18
"912340610",44,2707.51866080062,2509.75315546077,2567.51523707907,17,27
"912340611",59,2764.24241374284,3128.2916086862,2726.17127719361,22,37
"912340612",25,2005.11101041364,1269.37404684437,2287.34065519221,5,20
"912341092",59,2925.69606626136,3373.54469437116,2726.17127719361,17,42
"912341093",42,2854.47694959447,2879.07304667534,2543.21752514954,17,25
"912341094",45,2934.45513212231,3044.90928254279,2579.33597919865,12,33
"912341095",33,2416.28936476019,2172.54459323521,2420.89448855093,16,17
"912341096",55,2473.06052472538,2091.72773931949,2687.33120998132,14,41
"912341097",45,2231.37054391298,1877.09069255084,2579.33597919865,18,27
"912341098",50,2261.23356205726,1806.08151488076,2635.48551585152,20,30
"912341099",24,2305.67780413245,2281.17281742339,2268.33468283819,9,15
"912341100",35,2567.49628096161,2583.02245217397,2450.1860183293,14,21
"912341101",39,2420.48914379081,2414.05744334587,2504.98447234734,17,22
"912341102",45,2484.29202693763,2220.95766722448,2579.33597919865,17,28
"912341103",38,2318.93297626932,2026.76188989256,2491.71993967651,14,24
"912341104",35,2262.29585793982,1999.40252144726,2450.1860183293,15,20
"912341105",38,2350.0619351895,2262.93707590745,2491.71993967651,14,24
"912341106",37,2055.10445600281,1488.61143027202,2478.17471526668,16,21
"912341107",43,2515.99441819906,2836.29391799456,2555.47878346624,12,31
"912341108",37,2648.62625633212,2363.50240594468,2478.17471526668,13,24
"912341109",30,2500.24307286512,2473.67041331908,2374.18906024059,12,18
"912341110",46,3053.40056220982,3073.51630108248,2590.94954296761,19,27
"912341111",48,2905.79495554922,3439.09902379762,2613.58673801098,17,31
"912341112",44,2710.88179501782,2432.25319574024,2567.51523707907,14,30
"912341113",38,2430.00863335628,2108.8826771606,2491.71993967651,11,27
"912341114",45,2926.72389685594,3192.77824452203,2579.33597919865,19,26
"912341115",47,2934.17919774365,3241.54729667561,2602.36394728806,16,31
"912341116",37,2481.47429967967,2395.53200911285,2478.17471526668,17,20
"912341117",32,2692.78253710602,3365.94558734313,2405.71569249515,9,23
"912341118",32,2786.63876211147,3121.82974046098,2405.71569249515,11,21
"912341119",33,2643.60512065581,3100.2616595054,2420.89448855093,13,20
"912341120",34,2862.58236874931,3344.52871081698,2435.71163614839,15,19
"912341121",43,2782.69733230256,3138.40980511927,2555.47878346624,11,32
"912341122",37,2592.80492571387,2451.61360105039,2478.17471526668,11,26
"912341123",46,2783.83979619276,3347.31727053354,2590.94954296761,11,35
"912341124",36,2643.13945540658,3496.36262760442,2464.33502634194,9,27
"912341125",42,3018.28314786179,4159.8430822012,2543.21752514954,13,29
"912341126",51,3002.39459741348,3763.68630051103,2646.17454577679,17,34
"912341127",40,2739.10401909481,3538.17887264552,2517.98110851286,10,30
"912341128",41,2985.3452443476,3563.98010210821,2530.72175773865,10,31
"912341129",42,2813.36203835357,3622.41915903523,2543.21752514954,14,28
"912341130",47,2649.02322950373,3214.46056998256,2602.36394728806,13,34
"912341131",37,2861.63642434223,3611.72167776012,2478.17471526668,11,26
"912341132",38,3034.98576588468,3276.89689209131,2491.71993967651,14,24
"912341133",54,2782.35317887281,3176.39423548926,2677.2712016452,18,36
"912341134",26,2402.99145148289,2145.22971375373,2305.75108410937,11,15
"912341135",42,2921.60464407696,3616.05857144381,2543.21752514954,13,29
"912341136",37,2620.44443920591,3047.25486124493,2478.17471526668,13,24
"912341137",46,2746.56189770503,3569.73332001628,2590.94954296761,16,30
"912341138",20,2257.20065820038,2346.50179968171,2185.35845629437,7,13
"912341139",45,2489.09875747994,2287.60099670803,2579.33597919865,11,34
"912341140",66,2524.94436016084,2026.3137878865,2789.3669207067,21,45
"912341141",35,2505.91758203869,2643.4297619135,2450.1860183293,11,24
"912341142",35,2687.23347673467,2684.44091571842,2450.1860183293,13,22
"912341143",28,2543.92365479558,2605.97441186329,2340.94327947849,11,17
"912341144",64,3712.95069432992,3516.19413640234,2771.87783482774,20,44
"912341145",27,2664.06857108066,2432.44235073701,2323.60649590586,8,19
"912341146",52,3121.25524176477,2867.44349441042,2656.6981055205,16,36
"912341147",27,2349.37770945132,2301.91595129042,2323.60649590586,8,19
"912341148",41,2713.09614408252,2442.25615365033,2530.72175773865,16,25
"912341149",30,2579.13238619242,2589.50245135603,2374.18906024059,11,19
"912341150",30,2822.70400370475,3148.30496559531,2374.18906024059,13,17
"912341151",44,2947.5752966492,2545.39713125338,2567.51523707907,15,29
"912341152",24,2285.85955892495,2083.17256148933,2268.33468283819,8,16
"912341153",34,2805.98577236971,2427.5553303653,2435.71163614839,9,25
"912341154",49,3108.04860455672,3213.30258472121,2624.62502504328,19,30
"912341155",51,2751.3445121313,2979.99590029453,2646.17454577679,18,33
"912341156",33,2650.52006099959,2798.68796403655,2420.89448855093,16,17
"912341157",31,2641.02965817948,2489.36149116545,2390.15469389133,10,21
"912341158",48,2841.87598309031,3305.28513469352,2613.58673801098,15,33
"912341159",42,2822.34845937124,2907.78137962816,2543.21752514954,13,29
"912341160",45,2885.75999895836,3035.46815172269,2579.33597919865,12,33
"912341161",41,2705.99167774177,3055.51640802782,2530.72175773865,11,30
"912341162",21,2257.86596354604,2626.17347310579,2207.26116887512,7,14
"912341163",39,2811.98414257287,3426.99314554375,2504.98447234734,9,30
"912341164",34,3013.79675948283,3668.04595391006,2435.71163614839,7,27
"912341165",34,3195.82252538745,3627.46349136166,2435.71163614839,8,26
"912341166",49,3135.63359508462,4023.41772213806,2624.62502504328,14,35
"912341167",47,3012.50158069315,3645.69438044848,2602.36394728806,15,32
"912341168",39,2763.48359526633,3053.5433672341,2504.98447234734,9,30
"912341169",42,2694.32340658272,2477.26758833478,2543.21752514954,10,32
"912341170",44,3171.76943668405,3148.4038959585,2567.51523707907,12,32
"912341171",33,2518.28663372824,2674.94458119511,2420.89448855093,12,21
"912341172",38,2393.75879644032,2167.12390056357,2491.71993967651,13,25
"912341173",41,3235.2833927913,3481.22380371104,2530.72175773865,16,25
"912341174",33,2754.47876776469,2501.4140361211,2420.89448855093,10,23
"912341175",38,3183.40276563478,4024.20007424405,2491.71993967651,16,22
"912341176",34,3033.29239604745,3255.6128907433,2435.71163614839,13,21
"912341177",51,3448.06130834894,3598.63473998458,2646.17454577679,19,32
"912341178",40,2626.12363174421,2514.37153615134,2517.98110851286,11,29
"912341179",45,2662.25724373745,3102.51418448633,2579.33597919865,17,28
"912341180",40,3078.79479034817,3612.03417966275,2517.98110851286,17,23
"912341181",45,2730.88793696934,3036.58263549889,2579.33597919865,21,24
"912341182",36,2654.01824878806,3071.77934737227,2464.33502634194,13,23
"912341183",42,2650.89362833509,3027.77708292523,2543.21752514954,15,27
"912341184",39,2721.8419063696,3237.90794404047,2504.98447234734,13,26
"912341185",39,2714.86578242049,3168.81682310549,2504.98447234734,15,24
"912341186",36,2916.49579753822,3516.86521655073,2464.33502634194,18,18
"912341187",40,3048.815685737,3279.57213417265,2517.98110851286,13,27
"912341188",42,2750.48877775406,3040.57795479087,2543.21752514954,13,29
"912341189",31,2437.9142002013,2255.50381817469,2390.15469389133,9,22
"912341190",40,2590.81556695044,2170.67962569262,2517.98110851286,13,27
"912341191",52,2848.05904756536,2584.47957511116,2656.6981055205,21,31
"912341192",51,2890.5968758732,2460.38387790859,2646.17454577679,19,32
"912341193",49,2677.48038290288,3020.21502442498,2624.62502504328,17,32
"912341194",52,2759.84418961328,2741.96172346598,2656.6981055205,20,32
"912341195",62,2694.82354454786,2309.67820817023,2753.94837323248,30,32
"912341196",44,2983.41470946188,3010.12394677898,2567.51523707907,19,25
"912341197",40,2776.81470353255,2777.72271601737,2517.98110851286,17,23
"912341198",51,2546.56549410719,2171.08714368742,2646.17454577679,14,37
"912341199",39,2577.92046533842,2047.33534972576,2504.98447234734,14,25
"912341200",36,2617.08991898664,2658.06185787315,2464.33502634194,12,24
"912341201",34,2656.19187522439,2805.72477077135,2435.71163614839,19,15
"912341202",52,2645.18577359766,2520.2155394115,2656.6981055205,25,27
"912341203",47,2881.12492189262,2802.85563955943,2602.36394728806,15,32
"912341204",37,2479.00214926737,2546.01217517788,2478.17471526668,14,23
"912341205",29,2572.92642323033,2571.31111974497,2357.79423966008,11,18
"912341206",46,2931.13857373139,3213.79192226798,2590.94954296761,19,27
"912341207",27,2612.40683486266,2854.0186096236,2323.60649590586,9,18
"912341208",26,2358.15115017886,2605.82167786403,2305.75108410937,7,19
"912341209",33,2383.0002957664,2421.85521529439,2420.89448855093,12,21
"912341210",41,2457.8359752828,2629.43312976393,2530.72175773865,11,30
"912341211",34,2524.67566274055,3040.48614820214,2435.71163614839,15,19
"912341212",51,2400.31352555419,2419.98021204998,2646.17454577679,18,33
"912341213",32,2483.67356437252,2562.80546542272,2405.71569249515,14,18
"912341214",50,2252.40022966784,2208.38175122216,2635.48551585152,21,29
"912341215",60,2714.48831930067,2674.00301874484,2735.5526890818,22,38
"912341216",33,2353.14410580653,2494.79819397614,2420.89448855093,9,24
"912341217",55,2879.93947148223,3171.14367606929,2687.33120998132,20,35
"912341218",33,2463.14206526144,2694.46635369798,2420.89448855093,12,21
"912341219",54,2669.12184171343,2953.45662873121,2677.2712016452,18,36
"912341220",39,2291.29803885775,1904.12242118481,2504.98447234734,16,23
"912341221",43,2694.5413576136,2621.69364389842,2555.47878346624,16,27
"912341222",28,2625.40340962,2611.63683821895,2340.94327947849,11,17
"912341223",56,2989.10881007792,3482.48029003593,2697.24673169728,18,38
"912341766",8,1573.61894001444,1367.5912255128,1812.11073017574,1,7
"912341767",3,1390.6648756711,1328.19885388147,1482.92019466158,0,3
"912341768",7,1537.97816792772,1434.33109384704,1763.32076508842,1,6
"912341769",12,1580.92360834382,1140.9242093099,1968.69006049611,2,10
"912341770",13,1614.24219721374,1128.67107616512,2001.16379457045,2,11
"912341771",13,1580.18152697916,1150.19830086075,2001.16379457045,2,11
"912341772",13,1547.55195219968,1110.29552515924,2001.16379457045,2,11
"912341773",9,1526.05284725711,1050.40387764841,1856.26587460569,2,7
"912341774",8,1553.73155484248,1213.5703751904,1812.11073017574,2,6
"912341775",7,1548.45995145616,1212.90301720902,1763.32076508842,1,6
"912341776",6,1555.583725084,1373.29922621508,1708.62817714657,1,5
"912341777",7,1538.31120074341,1413.74009427672,1763.32076508842,1,6
"912341778",6,1549.48662443818,1461.48057997163,1708.62817714657,1,5
"912341779",13,1564.56374384341,1340.48893358297,2001.16379457045,2,11
"912341780",3,1410.14021311871,1346.59868086106,1482.92019466158,1,2
"912341781",1,1165.39530323111,1135.86708398723,1184.66451052022,1,0
"912341782",10,1552.22310491033,1247.62255154273,1896.67490607898,3,7
"912341783",11,1528.25077239813,1111.59452237298,1933.98659929558,2,9
"912341784",12,1534.19918963973,1231.71939174142,1968.69006049611,2,10
"912341785",11,1536.12777913815,1169.18189140579,1933.98659929558,2,9
"912341786",10,1575.89572986534,1378.01259884313,1896.67490607898,3,7
"912341787",8,1563.94566083173,1277.641565606,1812.11073017574,1,7
"912341788",6,1574.50897801463,1560.03720439097,1708.62817714657,1,5
"912341789",19,2231.45282813122,2365.66079751812,2162.56636020013,7,12
"912341790",23,2225.7191254457,2353.95785408342,2248.68783741607,10,13
"912341791",20,2227.70246673114,2179.76521818812,2185.35845629437,6,14
"912341792",20,2123.36230202301,2042.57388745081,2185.35845629437,6,14
"912341793",18,2078.25456939756,1708.99324879016,2138.79896507223,4,14
"912341794",19,2289.13838160164,2058.91778429619,2162.56636020013,8,11
"912341795",28,2026.55419920298,1858.73209508079,2340.94327947849,8,20
"912341796",24,2105.00825262416,1869.03393957196,2268.33468283819,9,15
"912341797",17,2145.6567264487,1930.08582233255,2113.95669457394,6,11
"912341798",16,2054.27615095915,1798.82148847948,2087.92318348224,4,12
"912341799",28,2226.88415655901,1784.15308247483,2340.94327947849,10,18
"912341800",30,2298.39975926892,1800.16937850791,2374.18906024059,10,20
"912341801",21,2067.25068400585,1863.93791403328,2207.26116887512,6,15
"912341802",19,2101.13633001868,2059.86483567934,2162.56636020013,5,14
"912341803",20,2204.23327836481,1900.25287734258,2185.35845629437,7,13
"912341804",19,2155.2786313595,2032.22287787077,2162.56636020013,7,12
"912341805",23,2231.07801743427,2066.87297215765,2248.68783741607,7,16
"912341807",20,2177.01492391362,2030.12658870691,2185.35845629437,6,14
"912341808",20,2115.10935687376,2000.03197150052,2185.35845629437,8,12
"912341809",23,2156.77755702099,1906.16545824038,2248.68783741607,7,16
"912341810",25,2269.40851161476,2250.13654523438,2287.34065519221,9,16
"912341811",17,2080.43514943584,1840.6260397319,2113.95669457394,5,12
"912341812",16,1980.92881693641,1594.0800482033,2087.92318348224,5,11
"912341813",18,2055.43490420474,1845.12181551251,2138.79896507223,6,12
"912341814",15,2068.50918284684,1901.42397154591,2060.56118614118,3,12
"912341815",10,1909.78061126068,1736.61791767883,1896.67490607898,3,7
"912341816",13,2039.82701191999,1952.93077774869,2001.16379457045,3,10
"912341817",32,2426.55468401347,2546.83298742121,2405.71569249515,13,19
"912341818",34,2656.46429820997,2579.2469336849,2435.71163614839,14,20
"912341819",26,2305.58141840183,2492.3284556377,2305.75108410937,8,18
"912341820",7,1749.18631664973,1772.64875864756,1763.32076508842,2,5
"912341821",9,1871.33368831675,1910.17227878663,1856.26587460569,4,5
"912341822",27,2464.01422029593,2437.67372078162,2323.60649590586,11,16
"912341823",32,2331.16691653602,2273.91369062513,2405.71569249515,10,22
"912341824",13,2013.07566039885,2003.84683871125,2001.16379457045,4,9
"912341825",37,2462.12653892342,2362.21661351823,2478.17471526668,12,25
"912341826",39,2526.11192114161,2702.1642974501,2504.98447234734,12,27
"912341827",27,2487.2057374806,2410.66722192486,2323.60649590586,8,19
"912341829",21,2104.92384262318,2042.74921514983,2207.26116887512,2,19
"912341831",9,1686.59577078556,1361.54343877676,1856.26587460569,0,9
"912341832",8,1673.00264419576,1540.3234052262,1812.11073017574,0,8
"912341834",18,2105.57814383552,1924.77833692054,2138.79896507223,4,14
"912341835",14,2045.85627307851,1811.20366573751,2031.70713799962,4,10
"912341836",24,2119.16065347771,1941.21590595717,2268.33468283819,8,16
"912341837",67,2946.28378153997,2820.97282205395,2797.95380131742,24,43
"912341838",46,2816.28493034113,2908.61868916024,2590.94954296761,15,31
"912341839",43,2780.9964211796,2445.08361276311,2555.47878346624,20,23
"912341840",35,2519.10636612885,2290.79489421731,2450.1860183293,10,25
"912341841",54,2523.1050085058,2468.79656023527,2677.2712016452,19,35
"912341842",62,2834.63212205603,2388.46728753577,2753.94837323248,19,43
"912341843",74,2944.13306155151,2555.04166594044,2855.36548874306,18,56
"912341844",56,2754.85876043582,2417.08279101432,2697.24673169728,14,42
"912341845",57,2650.27522338632,2229.96660957932,2707.02236739438,17,40
"912341846",24,2244.21816568809,2559.92733867508,2268.33468283819,5,19
"912341847",5,1464.20987762912,1510.61879684684,1646.12614877363,0,5
"912341848",3,1397.49924965128,1398.28758737242,1482.92019466158,0,3
"912341849",1,1144.88248711016,1184.66451052022,1184.66451052022,0,1
"912341850",3,1411.44156231589,1405.05466121512,1482.92019466158,1,2
"912341851",5,1452.43103912864,1620.72610426299,1646.12614877363,2,3
"912341852",2,1293.88207205852,1195.96530795341,1364.97646362037,0,2
"912341853",2,1293.88207205852,1263.05961030208,1364.97646362037,0,2
"912341854",3,1393.51328932651,1446.81751121461,1482.92019466158,1,2
"912341855",6,1480.99251604653,1153.09569217075,1708.62817714657,1,5
"912341856",6,1471.42519853783,1546.92813503863,1708.62817714657,0,6
"912341857",1,1144.88248711016,1184.66451052022,1184.66451052022,0,1
"912341859",1,1158.60801709197,1184.66451052022,1184.66451052022,0,1
"912341861",1,1155.9980439258,1184.66451052022,1184.66451052022,0,1
"912341862",2,1311.96835167921,1326.37692701857,1364.97646362037,0,2
"912341863",5,1474.12893135944,1213.69700976098,1646.12614877363,1,4
"912341864",5,1496.90659660527,1226.55317412806,1646.12614877363,2,3
"912341865",3,1408.63184050767,1326.37141143467,1482.92019466158,0,3
"912341866",5,1485.98843050989,1092.16785268891,1646.12614877363,2,3
"912341867",5,1499.96935254504,1243.60091880368,1646.12614877363,2,3
"912341868",3,1397.85255232655,1217.00446786144,1482.92019466158,1,2
"912341870",3,1397.85255232655,1109.71401752279,1482.92019466158,1,2
"912341871",6,1507.8240199674,1253.71490703549,1708.62817714657,1,5
"912341872",7,1519.56983628627,1138.93402016455,1763.32076508842,1,6
"912341873",6,1499.65007764171,1081.43121242935,1708.62817714657,1,5
"912341874",5,1474.12893135944,1078.74682696283,1646.12614877363,1,4
"912341875",5,1500.10151804847,1238.50610107357,1646.12614877363,1,4
"912341876",4,1472.39845866795,1380.0544080965,1572.73281143487,1,3
"912341877",3,1410.60640726522,1313.27502008619,1482.92019466158,1,2
"912341878",5,1500.10151804847,1205.98268340624,1646.12614877363,1,4
"912341879",4,1446.90551959121,1295.1162752767,1572.73281143487,1,3
"912341880",4,1446.90551959121,1343.21589792635,1572.73281143487,1,3
"912341881",4,1472.39845866795,1414.47665003132,1572.73281143487,1,3
"912341882",3,1408.82629492408,1432.5499408814,1482.92019466158,1,2
"912341894",2,1330.31640868508,1306.53693305683,1364.97646362037,0,2
"912341895",2,1330.31640868508,1264.90154091213,1364.97646362037,0,2
"912341896",3,1397.78998879966,1478.02926312871,1482.92019466158,0,3
"912341897",1,1182.48225129826,1184.66451052022,1184.66451052022,0,1
"912341898",2,1330.31640868508,1364.97646362037,1364.97646362037,0,2
"912341899",3,1402.91749785247,1295.88345665687,1482.92019466158,1,2
"912341900",2,1323.85543898582,1190.48216729713,1364.97646362037,0,2
"912341901",3,1402.91749785247,1326.26379437348,1482.92019466158,1,2
"912341902",4,1473.44424725622,1327.39017775806,1572.73281143487,0,4
"912341904",4,1438.17451061118,1338.83084298924,1572.73281143487,1,3
"912341905",5,1483.37341376246,1247.35232308719,1646.12614877363,1,4
"912341906",5,1483.37341376246,1379.65940696524,1646.12614877363,1,4
"912341907",3,1402.91749785247,1290.05754959864,1482.92019466158,1,2
"912341908",3,1402.91749785247,1321.37189438118,1482.92019466158,1,2
"912341909",4,1452.92559134163,1319.80747401977,1572.73281143487,0,4
"912341910",3,1390.19418663479,1207.24433517202,1482.92019466158,0,3
"912341911",2,1323.85543898582,1172.09500910987,1364.97646362037,0,2
"912341912",4,1502.1806293436,1360.00686056403,1572.73281143487,0,4
"912341913",3,1390.19418663479,1280.30827425732,1482.92019466158,0,3
"912341914",3,1417.30695415022,1324.25427528901,1482.92019466158,0,3
"912341915",14,1793.2774220242,1861.89095706223,2031.70713799962,4,10
"912341916",15,1795.95703836421,1530.34899850797,2060.56118614118,2,13
"912341917",19,1915.432202123,1881.11284573914,2162.56636020013,5,14
"912341918",25,1833.6308892782,1758.68263093378,2287.34065519221,8,17
"912341919",19,1910.53907949718,1602.5669345278,2162.56636020013,8,11
"912341920",27,2088.22550198482,1359.33007321981,2323.60649590586,6,21
"912341921",18,1731.61470251026,1480.10233319596,2138.79896507223,4,14
"912341922",24,2114.55694380935,1686.03208917722,2268.33468283819,5,19
"912341924",8,1674.40963525539,1416.32077058053,1812.11073017574,3,5
"912341925",12,1870.13260336327,1737.79501846109,1968.69006049611,3,9
"912341926",4,1525.25259044087,1479.57046149112,1572.73281143487,2,2
"912341927",4,1577.77517486875,1538.49825998733,1572.73281143487,2,2
"912341928",10,1769.93562791469,1784.02268791055,1896.67490607898,3,7
"912341929",9,1748.58682785648,1745.91709012537,1856.26587460569,3,6
"912341930",13,1899.48064703227,1759.42517216069,2001.16379457045,4,9
"912341931",14,1744.67382892167,1826.38713704201,2031.70713799962,2,12
"912341932",10,1687.6840874439,1715.78165797733,1896.67490607898,2,8
"912341933",9,1713.27359702012,1651.94525581547,1856.26587460569,3,6
"912341934",15,1951.21098807471,1816.92901130706,2060.56118614118,2,13
"912341935",19,1862.347780261,1926.01175507023,2162.56636020013,4,15
"912341936",12,1867.28368099654,1818.47844165634,1968.69006049611,2,10
"912341937",10,1750.11373830247,1613.07919468296,1896.67490607898,3,7
"912341939",15,1905.26042547688,1782.02477247368,2060.56118614118,4,11
"912341940",20,2008.21381854396,1860.61838714112,2185.35845629437,4,16
"912341941",7,1676.41078182698,1712.40629952341,1763.32076508842,5,2
"912341942",7,1679.79338817955,1620.33140908451,1763.32076508842,2,5
"912341943",12,1957.78901656371,1826.19381864861,1968.69006049611,2,10
"912341944",7,1642.2914428574,1550.84808711371,1763.32076508842,5,2
"912341945",4,1487.84425599883,1333.86840162167,1572.73281143487,4,0
"912341946",6,1666.65794465648,1573.4382934835,1708.62817714657,3,3
"912341947",10,1903.52730716145,1796.71882112262,1896.67490607898,2,8
"912341949",5,1572.14756091602,1546.53224431252,1646.12614877363,2,3
"912341951",8,1709.13581459768,1766.42401514613,1812.11073017574,3,5
"912341953",10,1696.83916597452,1682.63679040172,1896.67490607898,4,6
"912341954",7,1748.15087455944,1638.91303406845,1763.32076508842,2,5
"912341955",13,1873.23979861864,1846.52058171789,2001.16379457045,2,11
"912341956",4,1531.01582989643,1521.53091564089,1572.73281143487,2,2
"912341957",5,1582.57876249347,1552.12980139632,1646.12614877363,2,3
"912341958",3,1417.47543729498,1309.32834516821,1482.92019466158,3,0
"912341959",10,1777.9430857157,1685.31403445717,1896.67490607898,2,8
"912341960",13,1882.02439402766,1760.15685420518,2001.16379457045,4,9
"912341961",11,1795.31881457698,1762.66207650831,1933.98659929558,3,8
"912341962",3,1417.6193059716,1409.20335781142,1482.92019466158,2,1
"912341963",15,1897.33677828165,1923.86949309836,2060.56118614118,3,12
"912341964",19,1796.28019047274,1538.06710687815,2162.56636020013,2,17
"912341965",22,1903.68989776374,1661.47958368878,2228.3491786518,3,19
"912341966",82,3600.85150646315,3389.51557030648,2915.91045786314,24,58
"912341969",83,3430.94307312814,3102.15273606172,2923.1438046077,21,62
"912341970",82,3395.73871469178,2630.69428391226,2915.91045786314,25,57
"912342031",93,3721.52488064326,3664.10230988141,2991.90921350397,31,62
"912342032",95,4147.44718069041,4620.607683114,3004.94950458202,36,59
"912342033",103,3171.1019728312,2367.28406141611,3055.02181112984,36,67
"912342034",94,3340.35012994538,2467.0584559742,2998.45695239283,31,63
"912342035",79,3200.71607099394,3049.61883872066,2893.78092561085,29,50
"912342036",5,1639.67142778817,1715.19818088625,1646.12614877363,0,5
"912342037",7,1718.87915027124,1772.71016853411,1763.32076508842,2,5
"912342038",9,1746.63318341775,1548.42444756409,1856.26587460569,2,7
"912342039",14,1752.87530388378,1756.97877293029,2031.70713799962,2,12
"912342040",5,1650.28324376403,1816.82415454557,1646.12614877363,0,5
"912342041",7,1648.04156657858,1680.21038989335,1763.32076508842,0,7
"912342042",8,1681.68538373895,1526.35990193671,1812.11073017574,1,7
"912342043",9,1791.52474356062,1993.38235561531,1856.26587460569,1,8
"912342044",8,1720.97044176801,1946.80241379379,1812.11073017574,1,7
"912342045",12,1756.31811746527,1492.79558297076,1968.69006049611,1,11
"912342046",11,1816.64215418128,1625.02636796527,1933.98659929558,2,9
"912342047",13,1708.79788548251,1616.41760136105,2001.16379457045,2,11
"912342048",9,1790.25750920519,1900.38496727998,1856.26587460569,2,7
"912342049",13,1763.15425512483,1334.13697106706,2001.16379457045,3,10
"912342052",8,1729.24356694734,1781.98690918196,1812.11073017574,1,7
"912342053",8,1673.87306441173,1583.42135634738,1812.11073017574,1,7
"912342054",12,1722.74497413903,1282.13567602532,1968.69006049611,3,9
"912342055",4,1580.54100279482,1660.37580377738,1572.73281143487,0,4
"912342056",7,1714.28387365326,1830.41449896413,1763.32076508842,0,7
"912342057",10,1709.9246479493,1492.09933286806,1896.67490607898,1,9
"912342058",6,1690.56026161822,1783.99874052992,1708.62817714657,0,6
"912342059",11,1818.9897421094,1792.26443309793,1933.98659929558,1,10
"912342060",9,1813.08997921379,1852.99073543398,1856.26587460569,1,8
"912342061",10,1761.90444680457,1727.24634863708,1896.67490607898,0,10
"912342062",7,1754.21067883004,1829.64064111269,1763.32076508842,0,7
"912342063",8,1713.94686932252,1461.11732591771,1812.11073017574,1,7
"912342064",7,1773.8108238514,1866.24777674906,1763.32076508842,2,5
"912342065",8,1722.36287940526,1472.15245370805,1812.11073017574,1,7
"912342067",7,1706.8543148224,1698.43530935873,1763.32076508842,0,7
"912342068",9,1748.94728522126,1731.02895280416,1856.26587460569,0,9
"912342069",6,1711.13454391822,1736.27754746271,1708.62817714657,2,4
"912342070",7,1773.8108238514,1783.87144140578,1763.32076508842,2,5
"912342071",8,1595.91113010873,1350.29377718144,1812.11073017574,0,8
"912342073",5,1661.99189573918,1738.70826650597,1646.12614877363,0,5
"912342074",12,1754.69241067879,1102.31380813566,1968.69006049611,1,11
"912342075",7,1750.65845899416,1797.26673402763,1763.32076508842,1,6
"912342076",7,1732.35778555894,1771.67235832532,1763.32076508842,1,6
"912342077",6,1697.91889604399,1698.08911179961,1708.62817714657,0,6
"912342078",7,1730.15703503821,1830.81172526163,1763.32076508842,0,7
"912342080",5,1661.99189573918,1737.22387086171,1646.12614877363,0,5
"912342081",6,1731.01314025839,1798.23153045901,1708.62817714657,1,5
"912342082",3,1513.28544623258,1587.25165366269,1482.92019466158,0,3
"912342083",5,1639.67142778817,1780.53797279996,1646.12614877363,0,5
"912342086",9,1747.11156138337,1826.65989486419,1856.26587460569,1,8
"912342087",10,1697.84248955754,1619.62379353872,1896.67490607898,2,8
"912342088",12,1778.28407752287,1840.33633745172,1968.69006049611,2,10
"912342089",7,1663.98133219531,1632.40726173724,1763.32076508842,1,6
"912342091",5,1507.87575777615,1417.37845971537,1646.12614877363,1,4
"912342092",4,1472.52198581632,1425.60233542329,1572.73281143487,0,4
"912342093",4,1467.06560015539,1351.81884295155,1572.73281143487,1,3
"912342094",1,1167.4550817084,1130.15701167419,1184.66451052022,0,1
"912342095",2,1330.07806212425,1298.26940535067,1364.97646362037,0,2
"912342096",17,2062.2055054862,1829.40135928934,2113.95669457394,6,11
"912342097",21,2039.98683733556,1919.85992162397,2207.26116887512,8,13
"912342098",19,2083.79934582099,2099.32953224348,2162.56636020013,8,11
"912342100",19,2079.61289644049,2186.6027130267,2162.56636020013,5,14
"912342102",17,2046.59344937254,2119.39213132733,2113.95669457394,6,11
"912342103",15,2038.10773158044,2092.24905061433,2060.56118614118,7,8
"912342104",17,2033.51249953523,2132.32513472875,2113.95669457394,6,11
"912342105",17,2076.69179259852,2171.55330464852,2113.95669457394,6,11
"912342106",20,2086.16197659411,2110.37865673604,2185.35845629437,6,14
"912342107",12,1870.68951757901,1745.68040996576,1968.69006049611,4,8
"912342108",16,1937.94340513654,1891.57935587194,2087.92318348224,5,11
"912342109",19,2104.05379575352,2162.52479843472,2162.56636020013,8,11
"912342110",20,2206.94284547881,2317.59653418264,2185.35845629437,7,13
"912342111",16,2053.27292056954,1932.89334416062,2087.92318348224,7,9
"912342112",15,2021.12081637867,1820.82454934945,2060.56118614118,5,10
"912342113",13,1970.66693772055,1872.00093948045,2001.16379457045,3,10
"912342114",14,2048.28284091168,1788.82680790677,2031.70713799962,3,11
"912342115",16,2083.19968232911,1887.84325242068,2087.92318348224,6,10
"912342116",17,2078.77785614461,1909.05741989222,2113.95669457394,4,13
"912342117",14,1941.54963142592,1815.88226839303,2031.70713799962,4,10
"912342118",48,2806.70792528252,3104.48608470395,2613.58673801098,16,32
"912342119",46,3014.87792110845,3403.7033330839,2590.94954296761,16,30
"912342120",39,3218.29064386754,3292.53384686819,2504.98447234734,16,23
"912342121",48,3102.81341533519,3770.76721566609,2613.58673801098,22,26
"912342122",47,2805.24727290248,3201.370386352,2602.36394728806,16,31
"912342123",35,2520.57912755176,2630.19555028085,2450.1860183293,10,25
"912342124",37,2669.04409254575,2772.46896317263,2478.17471526668,11,26
"912342125",35,2733.1240659398,2806.6176152728,2450.1860183293,16,19
"912342126",40,2834.3255684587,3038.91998131765,2517.98110851286,13,27
"912342127",86,2815.63842123819,2957.43320074981,2944.43562859908,26,60
"912342128",30,2467.14556271203,3095.76839082477,2374.18906024059,9,21
"912342129",61,2909.78569114129,2927.51811949285,2744.81051624266,17,44
"912342130",69,3072.13405273227,3049.62810635788,2814.82611826518,20,49
"912342131",51,3224.83017182624,3450.89246346191,2646.17454577679,15,36
"912342132",84,3279.08060795417,3143.7522829535,2930.30814451558,27,57
"912342133",67,2708.98315795863,2164.64861204492,2797.95380131742,20,47
"912342134",75,2770.26089935338,2293.08857841263,2863.21031780169,21,54
"912342135",71,3464.52271001761,3793.62449881574,2831.31372136695,22,49
"912342136",78,2898.68807391555,2274.38894035862,2886.25582696583,24,54
"912342137",51,2893.56759024455,2544.55352996287,2646.17454577679,17,34
"912342138",77,2418.58163493152,2175.77456974167,2878.65357631343,24,53
"912342139",84,3397.02638992971,2844.96500126299,2930.30814451558,23,61
"912342140",62,3072.11411121625,2987.1515639678,2753.94837323248,20,42
"912342141",51,3463.4116073286,4337.13773966678,2646.17454577679,17,34
"912342142",92,2807.00983913405,2505.28627081682,2985.30521778333,27,65
"912342143",64,3110.98931161693,3643.15655530144,2771.87783482774,20,44
"912342144",60,2965.63816622814,3679.45988548649,2735.5526890818,16,44
"912342145",47,2775.6065757292,3475.06752383346,2602.36394728806,12,35
"912342146",64,2725.85167862339,2793.53006636103,2771.87783482774,16,48
"912342147",68,2944.91599023071,3793.43182216923,2806.43931339586,24,44
"912342148",70,2765.69269899204,2284.79801317339,2823.11677003184,22,48
"912342149",84,2820.14304572179,2943.92805331488,2930.30814451558,22,62
"912342150",63,3319.1386612351,3347.93591767165,2762.96971264875,20,43
"912342151",76,3019.19671808082,2966.88421450861,2870.97236507783,23,53
"912342152",55,2661.87122297453,2668.51645114428,2687.33120998132,14,41
"912342153",78,2873.54538448918,3423.10245583424,2886.25582696583,17,61
"912342154",81,3012.65036623054,2693.51359410467,2908.60658576875,23,58
"912342155",42,2728.57925651968,2652.69518896592,2543.21752514954,15,27
"912342156",46,2826.70784637885,2654.63115522237,2590.94954296761,18,28
"912342158",32,2601.32210668484,2776.33341656999,2405.71569249515,11,21
"912342159",34,2662.81319703415,2461.934083956,2435.71163614839,11,23
"912342160",34,2526.28402199417,2718.14453334847,2435.71163614839,10,24
"912342163",35,2442.30858892449,2503.20158193128,2450.1860183293,16,19
"912342165",72,2934.20166148527,3422.04264325834,2839.4193288992,25,47
"912342166",61,2911.33995379787,2834.2961512711,2744.81051624266,23,38
"912342167",40,2775.82717954034,2922.26591741375,2517.98110851286,14,26
"912342168",43,2966.6555221646,3458.28567194692,2555.47878346624,17,26
"912342169",26,1848.16278551482,1500.66101889284,2305.75108410937,7,19
"912342170",33,1974.20651793862,1487.81402743616,2420.89448855093,9,24
"912342171",17,2113.16718549899,2028.43587009228,2113.95669457394,4,13
"912342172",20,2050.2394075135,1842.67159660855,2185.35845629437,7,13
"912342173",33,2001.61736379218,1406.92187774197,2420.89448855093,10,23
"912342174",26,2238.35482261744,1899.94989547178,2305.75108410937,8,18
"912342175",21,2046.70327183971,1705.92245736827,2207.26116887512,7,14
"912342176",24,2075.38934505737,1838.04410003402,2268.33468283819,10,14
"912342177",15,1952.73254804815,1646.37017550482,2060.56118614118,6,9
"912342178",24,2204.49207607626,1866.68218072145,2268.33468283819,9,15
"912342179",21,2059.19543585931,1679.2969145646,2207.26116887512,9,12
"912342180",20,2043.30934462678,1843.03250854094,2185.35845629437,7,13
"912342181",22,2104.32617472117,1892.9596083676,2228.3491786518,8,14
"912342182",22,2129.79255930231,1919.07250470334,2228.3491786518,10,12
"912342183",16,1887.13222390454,1562.2799067343,2087.92318348224,7,9
"912342184",25,1952.07574353009,1625.10720101998,2287.34065519221,9,16
"912342185",32,2313.36716835099,1953.18742647984,2405.71569249515,11,21
"912342186",35,2379.53814155972,1828.76373212622,2450.1860183293,14,21
"912342187",44,2501.69390580397,1841.49431780997,2567.51523707907,14,30
"912342189",47,2579.68767960984,2586.92676779842,2602.36394728806,17,30
"912342190",50,2674.98438654757,2395.80201706896,2635.48551585152,17,33
"912342191",42,2592.30629838573,2454.22718809039,2543.21752514954,18,24
"912342192",9,1556.02123500883,1157.39044688954,1856.26587460569,1,8
"912342196",16,1931.68538171971,1775.13000847454,2087.92318348224,4,12
"912342198",9,1694.71199171191,1525.75785632355,1856.26587460569,2,7
"912342200",9,1549.94770286788,1045.50959335483,1856.26587460569,1,8
"912342201",9,1578.10314757058,1325.1932456325,1856.26587460569,1,8
"912342202",1,1168.07761147649,1184.66451052022,1184.66451052022,1,0
"912342203",1,1168.07761147649,1173.14249841464,1184.66451052022,1,0
"912342205",14,1855.69870945678,1798.28931794954,2031.70713799962,3,11
"912342206",18,2034.05244507717,1891.77923442808,2138.79896507223,4,14
"912342207",23,2114.85709591928,1872.63608211374,2248.68783741607,6,17
"912342208",19,2117.58855583623,1997.42606626876,2162.56636020013,3,16
"912342209",26,2116.19738133714,1741.45983278266,2305.75108410937,5,21
"912342210",28,1978.32685504097,2012.86487540859,2340.94327947849,6,22
"912342211",23,2040.7845334197,1868.65980523837,2248.68783741607,5,18
"912342212",8,1813.86056630716,1851.68104044748,1812.11073017574,0,8
"912342213",17,1868.80931203729,1894.89306307049,2113.95669457394,3,14
"912342214",25,2092.1733314486,1884.87568737181,2287.34065519221,4,21
"912342215",15,1890.80548176529,1921.89507496795,2060.56118614118,4,11
"912342216",23,2202.9777669388,1930.72192534896,2248.68783741607,5,18
"912342217",24,2060.36557295821,1684.80986624307,2268.33468283819,5,19
"912342218",23,2074.46959962841,1669.57608938307,2248.68783741607,5,18
"912342219",21,2041.63412485303,1688.48677786329,2207.26116887512,6,15
"912342220",32,1984.75609116979,1582.70913490723,2405.71569249515,8,24
"912342221",21,1920.91063934401,1574.09839245032,2207.26116887512,3,18
"912342222",29,2069.19781397395,1789.66397786244,2357.79423966008,6,23
"912342223",25,1976.06093577534,1531.86954859524,2287.34065519221,5,20
"912342224",13,2033.28123826112,1897.56554884011,2001.16379457045,1,12
"912342225",25,2512.93445320963,2744.84063068969,2287.34065519221,4,21
"912342226",26,2557.14420726313,2439.29882366263,2305.75108410937,6,20
"912342227",29,2868.19059658293,2979.09491243109,2357.79423966008,11,18
"912342228",37,2659.22348757959,2213.95070895456,2478.17471526668,14,23
"912342229",35,2877.02985981395,3036.29067588081,2450.1860183293,10,25
"912342230",55,2587.90789213264,2276.55275487457,2687.33120998132,18,37
"912342231",47,2592.71954037892,3016.22306343395,2602.36394728806,15,32
"912342232",61,2448.95356643763,2508.79385829955,2744.81051624266,20,41
"912342233",54,2724.19251581619,2095.17132182396,2677.2712016452,15,39
"912342234",58,2859.14410495357,2937.75716460784,2716.66249357165,20,38
"912342235",73,3182.16921140946,3375.6106246388,2847.4358582506,27,46
"912342236",81,3604.19715500771,2978.79387263444,2908.60658576875,27,54
"912342237",64,2739.191318437,3298.50207370148,2771.87783482774,18,46
"912342238",47,2926.5923591942,3024.26885483286,2602.36394728806,15,32
"912342239",32,2301.18102371835,2060.35487481776,2405.71569249515,11,21
"912342240",42,2664.97410383492,2646.35076108605,2543.21752514954,15,27
"912342241",45,2738.32909854193,2378.94736405847,2579.33597919865,14,31
"912342242",49,2627.26808334856,2036.0475058075,2624.62502504328,18,31
"912342243",55,2662.87471742274,2899.50524944658,2687.33120998132,23,32
"912342244",33,2358.23347452341,2307.66093998657,2420.89448855093,9,24
"912342245",22,2228.60118199768,2278.9082359364,2228.3491786518,8,14
"912342266",50,2824.22706545345,2691.17044632327,2635.48551585152,21,29
"912342267",64,2884.13895101668,2999.90567295602,2771.87783482774,20,44
"912342268",66,2639.40685538068,2280.13688605296,2789.3669207067,20,46
"912342269",67,2449.65029057406,2141.24658261427,2797.95380131742,25,42
"912342270",67,2715.40034412955,2897.30785041643,2797.95380131742,24,43
"912342271",80,2669.67726387194,1930.60922142387,2901.2306171403,28,52
"912342272",45,2735.70218398002,2777.93441974594,2579.33597919865,13,32
"912342273",58,3089.3292625713,2862.96857470004,2716.66249357165,23,35
"912342274",51,2658.31987544818,2176.4965185072,2646.17454577679,19,32
"912342275",42,2503.06827289946,2326.21657515054,2543.21752514954,13,29
"912342276",50,2495.61609895408,2460.05848376894,2635.48551585152,19,31
"912342277",51,2858.96425019844,2636.58352291345,2646.17454577679,18,33
"912342278",53,2545.06417862025,2747.14105054139,2667.061866114,20,33
"912342279",70,2501.7894757163,1777.7030300244,2823.11677003184,28,42
"912342280",60,2650.31797205356,2273.31145740865,2735.5526890818,23,37
"912342282",65,2684.40948820801,2369.49337677681,2780.67589681985,18,47
"912342283",61,2487.58415784474,1872.61019892785,2744.81051624266,19,42
"912342284",55,2575.04866501215,2413.6008584948,2687.33120998132,19,36
"912342285",78,3094.53203217812,1823.95429963266,2886.25582696583,24,54
"912342347",6,1578.84396857652,1548.05215488166,1708.62817714657,1,5
"912342348",11,1689.07610127249,1768.59733862512,1933.98659929558,1,10
"912342351",3,1418.25622314303,1482.92019466158,1482.92019466158,0,3
"912342373",59,2807.03189288952,3110.77392455288,2726.17127719361,16,43
"912342374",39,2936.10806335165,3189.50180483484,2504.98447234734,11,28
"912342375",76,2797.41227487209,3218.21635897656,2870.97236507783,22,54
"912342376",71,3147.7475785919,3530.50648078553,2831.31372136695,26,45
"912342377",70,2906.29642942863,2189.4257568587,2823.11677003184,21,49
"912342378",64,2639.16518578287,2878.47549384463,2771.87783482774,21,43
"912342379",86,3762.76970781243,3184.15634272394,2944.43562859908,31,55
"912342380",66,3250.66953727525,2683.68366727569,2789.3669207067,23,43
"912342381",92,3445.46449725876,2838.74475869714,2985.30521778333,28,64
"912342382",86,3423.80901976429,2761.29953854712,2944.43562859908,26,60
"912342383",92,3118.07154528884,2760.3544657749,2985.30521778333,31,61
"912342384",75,3701.39499063427,2559.31103339187,2863.21031780169,22,53
"912342385",71,3416.98113443248,2944.38273883766,2831.31372136695,24,47
"912342386",54,2575.48211119204,1984.72751555405,2677.2712016452,19,35
"912342387",72,2631.43751185552,2589.9495450844,2839.4193288992,23,49
"912342388",71,3101.60771467059,3186.25490375084,2831.31372136695,20,51
"912342389",21,1933.86405930493,1481.66093909334,2207.26116887512,6,15
"912342390",18,1831.73708801281,1200.35197351592,2138.79896507223,6,12
"912342391",24,1854.65584561347,1210.7926318129,2268.33468283819,5,19
"912342392",18,1836.14435290411,1285.45005409371,2138.79896507223,6,12
"912342393",18,1855.68244665087,1378.28450392545,2138.79896507223,5,13
"912342394",12,1799.58981232797,1774.81828249753,1968.69006049611,4,8
"912342395",20,1851.48890107744,1325.62567478763,2185.35845629437,5,15
"912342396",14,1834.7257566083,1327.69102062426,2031.70713799962,4,10
"912342397",15,1838.92458040483,1582.79402126551,2060.56118614118,4,11
"912342398",11,1740.66208310559,1518.50675575707,1933.98659929558,4,7
"912342399",9,1817.11305093594,1724.83974907759,1856.26587460569,2,7
"912342400",15,1750.00682258722,1424.37682231494,2060.56118614118,6,9
"912342401",21,1958.2256373694,1623.21466620394,2207.26116887512,6,15
"912342402",17,1783.59486385317,1498.72033492206,2113.95669457394,4,13
"912342403",17,1790.66248309567,1400.27257329707,2113.95669457394,7,10
"912342404",22,1809.81081958106,1250.9192424635,2228.3491786518,6,16
"912342405",23,1849.28535167419,1422.5043290997,2248.68783741607,8,15
"912342406",24,1969.66772875591,1585.43098373945,2268.33468283819,7,17
"912342407",27,2025.82211690903,1451.10614394975,2323.60649590586,7,20
"912342408",20,1830.56017933654,1512.29024311794,2185.35845629437,5,15
"912342409",24,2002.268381405,1509.99194819006,2268.33468283819,6,18
"912342410",25,1930.60451989418,1469.36000021545,2287.34065519221,8,17
"912342411",27,1973.06958572748,1503.67879401531,2323.60649590586,7,20
"912342412",21,1829.0226714378,1375.41891266714,2207.26116887512,5,16
"912342413",20,1850.05393453668,1392.32114657351,2185.35845629437,5,15
"912342414",25,1929.72139495839,1279.16314851108,2287.34065519221,7,18
"912342415",17,1824.80771748785,1318.46442293623,2113.95669457394,6,11
"912342416",23,1983.96925210745,1453.84026786902,2248.68783741607,7,16
"912342417",25,2062.16928743715,1393.30514240463,2287.34065519221,8,17
"912342418",19,1939.37046855065,1612.49130935419,2162.56636020013,4,15
"912342419",18,1965.30693266329,1547.78524546577,2138.79896507223,4,14
"912342420",20,1945.31233309366,1620.99021264636,2185.35845629437,6,14
"912342421",28,2086.46198434137,1580.95995143653,2340.94327947849,7,21
"912342422",16,1827.61462718079,1485.93475918253,2087.92318348224,3,13
"912342423",20,1983.78420548505,1321.83348995507,2185.35845629437,6,14
"912342424",22,1876.09461984302,1395.32850708287,2228.3491786518,5,17
"912342425",17,1925.5257728567,1488.21338180132,2113.95669457394,4,13
"912342426",7,1639.61600716125,1483.01117656729,1763.32076508842,3,4
"912342427",15,1801.99916169337,1480.30607724631,2060.56118614118,3,12
"912342428",17,1916.43957828427,1645.07956303689,2113.95669457394,6,11
"912342429",44,2667.55471516445,2031.40302593025,2567.51523707907,22,22
"912342430",19,1985.78064296939,1554.049357393,2162.56636020013,6,13
"912342431",41,2447.59867876357,2098.51461861915,2530.72175773865,18,23
"912342432",26,2100.34160803483,1933.90517656188,2305.75108410937,12,14
"912342433",47,2441.80152827742,1898.44342375183,2602.36394728806,20,27
"912342434",44,2200.23143964179,1557.84532221611,2567.51523707907,16,28
"912342435",31,2425.06984661968,2163.88344833389,2390.15469389133,13,18
"912342436",31,2008.13858229173,1791.27040343736,2390.15469389133,13,18
"912342437",43,2591.72411827297,2646.07433511003,2555.47878346624,17,26
"912342438",50,2501.74488556393,2358.53478703674,2635.48551585152,24,26
"912342439",35,2649.02106671156,2991.57251121945,2450.1860183293,16,19
"912342440",33,2684.10560919903,3184.43247216842,2420.89448855093,13,20
"912342441",33,2527.89107052319,2732.36527034127,2420.89448855093,11,22
"912342442",39,2597.30717018146,2628.33100348164,2504.98447234734,16,23
"912342443",25,1727.08166546304,1376.49935470895,2287.34065519221,10,15
"912342444",26,2043.40419579754,1621.38174142527,2305.75108410937,10,16
"912342445",28,2167.91797492834,1589.38015394525,2340.94327947849,14,14
"912342446",29,2239.44393424282,1826.94001123224,2357.79423966008,13,16
"912342447",24,2090.14219500015,1717.9038132955,2268.33468283819,7,17
"912342448",24,2114.29156812142,2040.44473885345,2268.33468283819,11,13
"912342449",26,2172.13661215283,1961.45800587568,2305.75108410937,12,14
"912342450",39,2332.42248085442,2329.70949533737,2504.98447234734,16,23
"912342451",27,2053.23682530358,1353.3446680212,2323.60649590586,14,13
"912342452",26,2179.92868843399,1524.10660164428,2305.75108410937,12,14
"912342453",40,2502.79713024597,1955.25837411875,2517.98110851286,18,22
"912342454",36,2443.67531350771,1928.05967612804,2464.33502634194,14,22
"912342455",28,2338.59368165946,2053.17787602031,2340.94327947849,13,15
"912342456",35,2419.47130935928,2090.91687332472,2450.1860183293,16,19
"912342457",26,2328.78585892445,2436.19413915796,2305.75108410937,9,17
"912342458",31,2543.71465036061,2763.04424503468,2390.15469389133,10,21
"912342459",21,2056.48130028511,1549.51927015162,2207.26116887512,9,12
"912342460",33,2423.43223385932,2098.61070043399,2420.89448855093,11,22
"912342461",34,2665.48265296029,2739.44770897353,2435.71163614839,14,20
"912342462",39,2571.38101488628,2247.95758177129,2504.98447234734,16,23
"912342463",30,2557.26608695548,2487.9580365503,2374.18906024059,15,15
"912342464",42,2693.5278355133,2969.49889149877,2543.21752514954,20,22
"912342465",37,2538.45318297111,2742.10517137478,2478.17471526668,14,23
"912342466",26,2375.04331374392,2562.14039523861,2305.75108410937,7,19
"912342467",24,2192.65965990973,1870.76555913614,2268.33468283819,11,13
"912342468",24,2192.98951528375,1979.5803925356,2268.33468283819,8,16
"912342469",17,1836.02891248563,1399.03715997273,2113.95669457394,7,10
"912342470",37,2397.02198985057,1729.94444805019,2478.17471526668,14,23
"912342471",15,2030.17723127228,1475.24248958262,2060.56118614118,8,7
"912342472",30,2200.05127031752,1810.83721499787,2374.18906024059,11,19
"912342473",14,1937.6368143134,1715.86233876291,2031.70713799962,5,9
"912342474",21,1955.50103188103,1512.92699949423,2207.26116887512,7,14
"912342475",25,2020.82731928507,1330.66636752594,2287.34065519221,10,15
"912342476",28,2176.57837066802,1655.57695678688,2340.94327947849,15,13
"912342477",28,2145.25247513237,1641.92931337888,2340.94327947849,12,16
"912342478",40,2330.42935377241,1858.94157764548,2517.98110851286,18,22
"912342479",31,2264.43367186888,2067.88281158176,2390.15469389133,13,18
"912342480",47,2392.53470919254,1784.77428370029,2602.36394728806,21,26
"912342481",43,2724.66425626408,3508.64513881212,2555.47878346624,21,22
"912342482",51,3144.14353728046,3534.25842533781,2646.17454577679,23,28
"912342483",39,2410.8941959911,2691.18761249226,2504.98447234734,17,22
"912342484",30,2252.88127563054,2332.3238717159,2374.18906024059,12,18
"912342485",42,2497.93325455314,2080.6053814325,2543.21752514954,23,19
"912342486",52,2537.15702933952,1692.53583949928,2656.6981055205,24,28
"912342487",12,1815.91333512811,1513.06067585181,1968.69006049611,4,8
"912342488",16,1891.7762631015,1665.59345410922,2087.92318348224,6,10
"912342489",29,2310.12766456613,1760.17318612431,2357.79423966008,17,12
"912342490",47,1966.94147157816,1920.72225871723,2602.36394728806,19,28
"912342491",31,2252.20015465238,1717.89401589209,2390.15469389133,12,19
"912342492",40,2496.61147553811,2542.64417322347,2517.98110851286,15,25
"912342493",29,2236.66317561988,2065.72408707509,2357.79423966008,12,17
"912342494",44,2399.90746907102,2068.72135396812,2567.51523707907,18,26
"912342506",67,3176.11731019742,3438.88295897037,2797.95380131742,18,49
"912342515",6,1647.16299119034,1618.62876313948,1708.62817714657,1,5
"912342519",29,1878.9092484964,1337.90278875611,2357.79423966008,9,20
"912342523",14,1951.48387527372,2018.93589326886,2031.70713799962,3,11
"912342524",12,1851.31649109824,1562.16388677628,1968.69006049611,2,10
"912342525",14,1836.88264038538,1657.98218436964,2031.70713799962,2,12
"912342526",11,1818.69018442012,1466.59117679951,1933.98659929558,2,9
"912342527",12,1707.49846315821,1423.81146386198,1968.69006049611,2,10
"912342528",13,1818.72870605631,1663.86842846414,2001.16379457045,2,11
"912342529",10,1852.61870277094,1780.04976880362,1896.67490607898,1,9
"912342530",10,1713.88257114385,1289.35455846019,1896.67490607898,1,9
"912342531",14,1891.01708398895,1431.68630296739,2031.70713799962,3,11
"912342532",24,1919.57406853183,1776.90472943435,2268.33468283819,6,18
"912342533",14,1845.82697196152,1479.63385112726,2031.70713799962,3,11
"912342534",17,1775.69508583527,1595.41081443787,2113.95669457394,4,13
"912342535",14,1757.45798106608,1424.13023238634,2031.70713799962,3,11
"912342536",8,1686.76754508992,1591.18978749195,1812.11073017574,2,6
"912342537",11,1807.81757753212,1772.68195985881,1933.98659929558,2,9
"912342538",6,1585.2170995005,1592.77953534157,1708.62817714657,1,5
"912342539",6,1620.26504962772,1465.7561677027,1708.62817714657,1,5
"912342540",11,1888.34060331439,1717.70875568843,1933.98659929558,2,9
"912342541",10,1751.0272576434,1599.48442571862,1896.67490607898,2,8
"912342542",10,1760.26437086885,1588.38354911931,1896.67490607898,1,9
"912342543",9,1637.5897091898,1539.0478295146,1856.26587460569,2,7
"912342544",13,1899.24202893476,1752.17294120117,2001.16379457045,1,12
"912342545",10,1765.94491193936,1530.7333305416,1896.67490607898,2,8
"912342546",12,1773.91626540608,1675.84701014223,1968.69006049611,2,10
"912342547",16,1884.80283916789,1763.22905109351,2087.92318348224,3,13
"912342548",22,2014.14917229043,1787.31953912892,2228.3491786518,3,19
"912342549",10,1709.78094651644,1485.71902120952,1896.67490607898,2,8
"912342550",14,1720.2801574116,1455.00436625313,2031.70713799962,2,12
"912342551",14,1739.8366297294,1243.86958257828,2031.70713799962,1,13
"912342552",9,1706.95733809973,1586.06481484415,1856.26587460569,3,6
"912342553",10,1744.95939419527,1708.81459835968,1896.67490607898,3,7
"912342554",14,1768.54953625384,1625.45022890321,2031.70713799962,3,11
"912342555",13,1836.82778334119,1665.37509752611,2001.16379457045,3,10
"912342556",12,1861.18315893631,1526.1744220966,1968.69006049611,3,9
"912342557",9,1674.70893003608,1568.78831343931,1856.26587460569,2,7
"912342558",14,1729.14593946272,1549.9934837192,2031.70713799962,1,13
"912342559",12,1812.09724474739,1620.69136698266,1968.69006049611,3,9
"912342560",20,1901.37779753691,1623.40986793984,2185.35845629437,4,16
"912342561",17,1881.92983878882,1637.34547992324,2113.95669457394,3,14
"912342562",20,1905.28039185808,1389.17039272096,2185.35845629437,5,15
"912342563",21,1818.81926535661,1432.50800769979,2207.26116887512,3,18
"912342564",9,1810.27418601448,1668.22462793002,1856.26587460569,3,6
"912342565",11,1803.02577540856,1720.84803808866,1933.98659929558,3,8
"912342566",12,1895.43223805098,1702.70994681037,1968.69006049611,2,10
"912342567",15,1845.52624537954,1534.06519609207,2060.56118614118,3,12
"912342568",19,1934.20503719272,1638.33484122829,2162.56636020013,4,15
"912342569",15,1911.50001434337,1636.92274445266,2060.56118614118,4,11
"912342570",16,1889.39125638463,1609.55955755036,2087.92318348224,3,13
"912342571",11,1863.02663964663,1672.79100536072,1933.98659929558,1,10
"912342572",13,1891.30367728308,1693.97072316119,2001.16379457045,2,11
"912342573",5,1585.05294235755,1441.276638709,1646.12614877363,1,4
"912342574",13,1854.02048702713,1769.87733720278,2001.16379457045,2,11
"912342575",9,1729.36985506854,1715.02283312715,1856.26587460569,2,7
"912342576",12,1887.44113864219,1731.48422980969,1968.69006049611,3,9
"912342577",8,1726.8198468546,1603.44866176527,1812.11073017574,2,6
"912342578",9,1717.31513931031,1578.87061742635,1856.26587460569,1,8
"912342579",10,1656.58708870895,1455.41666004907,1896.67490607898,1,9
"912342581",9,1784.83300402065,1684.64016981885,1856.26587460569,1,8
"912342582",10,1711.34717631837,1554.69676784317,1896.67490607898,2,8
"912342583",15,1809.21565111201,1479.84698523496,2060.56118614118,4,11
"912342584",13,1812.55353484594,1466.05093962916,2001.16379457045,2,11
"912342585",17,1879.71696024842,1522.18195442793,2113.95669457394,4,13
"912342586",12,1770.95110635805,1366.79785446526,1968.69006049611,3,9
"912342587",14,1795.15163754975,1667.94692748119,2031.70713799962,2,12
"912342588",10,1685.68287588634,1588.58304120442,1896.67490607898,2,8
"912342589",12,1741.07290658066,1547.46869523716,1968.69006049611,4,8
"912342590",10,1681.67866088578,1388.34964942341,1896.67490607898,2,8
"912342591",12,1707.79396066172,1434.33360836927,1968.69006049611,2,10
"912342592",13,1677.84237620196,1547.78485175759,2001.16379457045,4,9
"912342593",12,1686.20813612354,1550.65439636591,1968.69006049611,3,9
"912342594",12,1674.65684401899,1354.42454713897,1968.69006049611,3,9
"912342595",18,1837.30897552705,1439.76990789934,2138.79896507223,4,14
"912342596",14,1816.76386892108,1637.95594644271,2031.70713799962,2,12
"912342597",14,1736.9680344934,1477.04001537315,2031.70713799962,3,11
"912342598",7,1600.32356454023,1587.38302506172,1763.32076508842,2,5
"912342599",7,1668.01857070674,1522.31925571491,1763.32076508842,2,5
"912342600",11,1794.05491642301,1670.46227427163,1933.98659929558,2,9
"912342601",7,1616.66130786931,1467.61583632835,1763.32076508842,2,5
"912342602",13,1863.36779691121,1687.01304637307,2001.16379457045,2,11
"912342604",6,1523.52371273226,1469.27277480597,1708.62817714657,1,5
"912342605",3,1371.19846475946,1102.88673085562,1482.92019466158,0,3
"912342606",2,1292.20239526938,1066.98231326274,1364.97646362037,0,2
"912342607",6,1532.21988524023,1488.38964633138,1708.62817714657,1,5
"912342608",7,1636.3611562762,1593.94299160174,1763.32076508842,1,6
"912342609",1,1163.18018429858,1146.44648551289,1184.66451052022,0,1
"912342610",3,1421.48546233202,1435.31067208492,1482.92019466158,1,2
"912342611",2,1317.90000378705,1278.56947665137,1364.97646362037,1,1
"912342612",5,1508.44642513268,1528.44772906818,1646.12614877363,1,4
"912342613",4,1441.40043447121,1443.24058210518,1572.73281143487,0,4
"912342614",2,1344.17434608905,1306.95485052914,1364.97646362037,0,2
"912342615",6,1493.31378840691,1351.91677076164,1708.62817714657,2,4
"912342616",3,1378.2817810895,1412.99797789844,1482.92019466158,0,3
"912342617",3,1378.2817810895,1318.48505782133,1482.92019466158,0,3
"912342618",2,1299.36117613236,1232.2308833047,1364.97646362037,0,2
"912342619",4,1427.17362901662,1481.64215617734,1572.73281143487,1,3
"912342620",7,1600.71723076945,1554.8433370584,1763.32076508842,1,6
"912342621",3,1398.46704240366,1416.57449228243,1482.92019466158,1,2
"912342622",4,1435.20162187902,1360.01965307135,1572.73281143487,1,3
"912342623",6,1500.46513435592,1639.05941322632,1708.62817714657,1,5
"912342624",4,1435.20162187902,1381.3541837775,1572.73281143487,1,3
"912342625",2,1296.88149172313,1143.82796550691,1364.97646362037,0,2
"912342626",3,1410.96086758528,1416.20907144521,1482.92019466158,0,3
"912342627",3,1411.8369411355,1435.08025299019,1482.92019466158,1,2
"912342628",3,1506.41259970584,1439.87685275202,1482.92019466158,0,3
"912342629",3,1375.65148559748,1256.78500875587,1482.92019466158,0,3
"912342630",2,1309.04308098029,1309.24351431768,1364.97646362037,0,2
"912342631",4,1558.12226371908,1535.25101441166,1572.73281143487,1,3
"912342632",4,1543.64651641515,1482.53457603692,1572.73281143487,0,4
"912342633",3,1398.46704240366,1398.71753000993,1482.92019466158,1,2
"912342634",3,1398.37280420125,1206.70689929143,1482.92019466158,0,3
"912342635",1,1164.93329481912,1153.06986609439,1184.66451052022,1,0
"912342636",2,1299.36117613236,1347.76993240969,1364.97646362037,0,2
"912342637",1,1164.93329481912,1170.95266870018,1184.66451052022,1,0
"912342638",5,1508.1305478442,1349.57075411927,1646.12614877363,2,3
"912342639",3,1421.03618234532,1445.7692402308,1482.92019466158,1,2
"912342640",1,1163.18018429858,1161.08278712491,1184.66451052022,0,1
"912342641",2,1308.5559367426,1325.61614616665,1364.97646362037,0,2
"912342642",1,1163.18018429858,1184.66451052022,1184.66451052022,0,1
"912342643",6,1481.64147083099,1313.33845121854,1708.62817714657,1,5
"912342644",10,1585.49135214038,1304.84383985168,1896.67490607898,2,8
"912342645",3,1386.18979973379,1273.17084178365,1482.92019466158,1,2
"912342646",6,1560.94288302361,1482.41170831262,1708.62817714657,2,4
"912342647",3,1388.55174551761,1403.75562520266,1482.92019466158,0,3
"912342648",6,1550.29769984887,1569.87729352066,1708.62817714657,2,4
"912342649",2,1311.01603171319,1314.73488800215,1364.97646362037,1,1
"912342650",4,1473.17651068573,1465.38133792895,1572.73281143487,1,3
"912342651",5,1475.24548603528,1250.80555011226,1646.12614877363,1,4
"912342652",3,1420.95120560654,1435.08025299019,1482.92019466158,2,1
"912342653",1,1163.18018429858,1126.05027361264,1184.66451052022,0,1
"912342654",6,1529.6786170377,1512.73053024339,1708.62817714657,0,6
"912342655",3,1376.16360791144,1385.29034595981,1482.92019466158,0,3
"912342656",3,1397.94662014163,1465.75620691621,1482.92019466158,1,2
"912342657",3,1398.46704240366,1315.45108271303,1482.92019466158,1,2
"912342658",4,1460.21081006343,1504.62074142221,1572.73281143487,1,3
"912342659",3,1467.04108472535,1482.92019466158,1482.92019466158,0,3
"912342660",1,1163.18018429858,1161.08278712491,1184.66451052022,0,1
"912342661",1,1164.93329481912,1170.95266870018,1184.66451052022,1,0
"912342662",4,1451.33240081987,1572.73281143487,1572.73281143487,0,4
"912342663",8,1544.90664202961,1645.61317177157,1812.11073017574,1,7
"912342664",1,1163.18018429858,1169.73094395865,1184.66451052022,0,1
"912342667",4,1443.48236804568,1422.80808317225,1572.73281143487,1,3
"912342668",5,1475.14653083238,1361.41563276809,1646.12614877363,1,4
"912342669",6,1496.8675107309,1508.55754261143,1708.62817714657,1,5
"912342670",7,1626.20541073211,1493.44112817542,1763.32076508842,1,6
"912342671",1,1163.18018429858,1146.44648551289,1184.66451052022,0,1
"912342672",2,1299.36117613236,1337.80548219874,1364.97646362037,0,2
"912342673",3,1410.96086758528,1399.12781180335,1482.92019466158,0,3
"912342674",1,1163.18018429858,1122.51421325362,1184.66451052022,0,1
"912342675",2,1317.90000378705,1323.12883284315,1364.97646362037,1,1
"912342676",2,1317.90000378705,1364.97646362037,1364.97646362037,1,1
"912342677",4,1434.66752929629,1380.32484578219,1572.73281143487,1,3
"912342678",2,1298.83611287102,1279.6523702124,1364.97646362037,1,1
"912342679",3,1391.91231504286,1237.84051522577,1482.92019466158,0,3
"912342680",2,1312.73729452909,1237.64490780163,1364.97646362037,0,2
"912342681",3,1411.8369411355,1423.21106807631,1482.92019466158,1,2
"912342682",6,1535.49753778381,1584.46135304011,1708.62817714657,1,5
"912342683",2,1302.44124535866,1334.22617358215,1364.97646362037,0,2
"912342684",1,1163.18018429858,1150.27835827952,1184.66451052022,0,1
"912342685",5,1619.54248532664,1563.3280391889,1646.12614877363,0,5
"912342686",7,1510.91058399752,1540.387751576,1763.32076508842,0,7
"912342687",3,1398.46704240366,1445.7692402308,1482.92019466158,1,2
"912342688",4,1434.66752929629,1419.13218806845,1572.73281143487,1,3
"912342689",3,1388.12374275658,1482.92019466158,1482.92019466158,1,2
"912342690",5,1467.99029692763,1415.15917209636,1646.12614877363,1,4
"912342691",4,1424.58662704613,1356.67656048058,1572.73281143487,1,3
"912342692",4,1424.58662704613,1318.4529579099,1572.73281143487,1,3
"912342693",2,1299.36117613236,1347.76993240969,1364.97646362037,0,2
"912342694",2,1299.36117613236,1364.97646362037,1364.97646362037,0,2
"912342695",2,1308.5559367426,1311.17536155464,1364.97646362037,0,2
"912342696",3,1391.97670769364,1441.84057788345,1482.92019466158,0,3
"912342697",4,1467.91609672831,1491.93685666581,1572.73281143487,1,3
"912342698",5,1496.46144230582,1537.10627274811,1646.12614877363,1,4
"912342699",4,1442.1308611058,1557.51884645718,1572.73281143487,0,4
"912342700",3,1389.32027697716,1275.15890033711,1482.92019466158,0,3
"912342701",4,1471.95147369425,1449.18357955555,1572.73281143487,2,2
"912342702",3,1380.87296117015,1365.90402723637,1482.92019466158,1,2
"912342703",7,1506.93506069291,1147.86817032612,1763.32076508842,1,6
"912342704",9,1642.35719862841,1413.45918535377,1856.26587460569,1,8
"912342705",3,1424.72253076412,1409.79301254114,1482.92019466158,1,2
"912342706",3,1434.50771780513,1387.27141491455,1482.92019466158,1,2
"912342707",10,1669.87028435385,1445.79913672691,1896.67490607898,3,7
"912342708",5,1507.19105305892,1364.0985482985,1646.12614877363,2,3
"912342709",4,1454.07145536332,1403.13315284535,1572.73281143487,2,2
"912342710",7,1574.95505129602,1374.55122586183,1763.32076508842,3,4
"912342711",7,1566.97261679821,1294.99533704226,1763.32076508842,2,5
"912342712",7,1572.13541627987,1284.95871780495,1763.32076508842,2,5
"912342713",9,1650.51172557049,1285.63110824275,1856.26587460569,2,7
"912342714",7,1572.13541627987,1079.01689152218,1763.32076508842,2,5
"912342715",9,1603.268573922,1231.90511861764,1856.26587460569,2,7
"912342716",7,1548.16765979621,1040.70292534755,1763.32076508842,2,5
"912342717",6,1551.61177753892,1278.86777959876,1708.62817714657,2,4
"912342718",9,1609.96789855734,1270.13201287823,1856.26587460569,3,6
"912342719",4,1474.29020834376,1169.5110096086,1572.73281143487,2,2
"912342720",7,1530.00139899317,1041.05921067776,1763.32076508842,2,5
"912342721",9,1664.99644191013,1341.93749003026,1856.26587460569,2,7
"912342722",8,1576.8227379754,1194.04896932847,1812.11073017574,2,6
"912342723",7,1591.93914846934,1312.82363786634,1763.32076508842,2,5
"912342724",9,1665.92364447053,1335.39014454371,1856.26587460569,2,7
"912342725",8,1653.85134883573,1642.05608832042,1812.11073017574,0,8
"912342726",18,1655.23816269851,1477.76031881333,2138.79896507223,3,15
"912342727",4,1498.51174748452,1443.39314108232,1572.73281143487,0,4
"912342728",8,1618.63510388428,1332.88149297949,1812.11073017574,0,8
"912342729",16,1639.95746628766,1338.16732393904,2087.92318348224,2,14
"912342730",11,1642.42767424238,1413.66634930817,1933.98659929558,2,9
"912342731",16,1662.47817198564,1391.41047730805,2087.92318348224,1,15
"912342732",14,1687.61631493267,1462.5009087985,2031.70713799962,2,12
"912342733",17,1623.43077458516,1213.81420473223,2113.95669457394,3,14
"912342734",15,1675.03354051604,1575.27606358682,2060.56118614118,3,12
"912342735",18,1702.66075168451,1336.68533520607,2138.79896507223,3,15
"912342736",13,1714.29001185122,1353.14905907026,2001.16379457045,2,11
"912342737",17,1686.18646586858,1320.53030322418,2113.95669457394,3,14
"912342738",19,1719.30471350848,1365.38121505968,2162.56636020013,5,14
"912342739",14,1694.93153032323,1632.39530174912,2031.70713799962,3,11
"912342740",19,1737.9886970181,1460.59036232802,2162.56636020013,6,13
"912342741",14,1745.0370083405,1432.06046023839,2031.70713799962,4,10
"912342742",16,1696.38931436309,1425.94858411466,2087.92318348224,4,12
"912342743",12,1684.56817422404,1590.95905751005,1968.69006049611,1,11
"912342744",18,1670.90802405255,1571.5269666995,2138.79896507223,1,17
"912342745",12,1630.88914798423,1492.11938599152,1968.69006049611,1,11
"912342746",12,1674.93355141371,1613.10336918233,1968.69006049611,1,11
"912342747",16,1664.09602452131,1383.02861723214,2087.92318348224,4,12
"912342748",16,1664.15175329998,1345.70385830615,2087.92318348224,2,14
"912342751",16,1665.8972445288,1128.17053290961,2087.92318348224,4,12
"912342752",16,1620.93648271318,1201.86599836485,2087.92318348224,3,13
"912342753",25,1566.24429981085,1261.48150233204,2287.34065519221,2,23
"912342754",14,1699.93459360016,1454.37450712704,2031.70713799962,2,12
"912342755",17,1630.49313498941,1084.40001938306,2113.95669457394,1,16
"912342756",8,1621.49211331083,1533.93603375125,1812.11073017574,2,6
"912342757",15,1664.51988519037,1374.42286187709,2060.56118614118,2,13
"912342758",16,1648.61650651194,1411.62565367395,2087.92318348224,2,14
"912342759",16,1580.67308487095,1025.93395739346,2087.92318348224,2,14
"912342760",18,1665.29071531777,1099.6028236337,2138.79896507223,3,15
"912342761",9,1611.9781057386,1393.4215105118,1856.26587460569,1,8
"912342762",11,1646.53082896485,1348.32016585034,1933.98659929558,1,10
"912342763",13,1678.8195786741,1545.80495023175,2001.16379457045,1,12
"912342764",9,1633.31620929828,1531.21993899907,1856.26587460569,1,8
"912342765",12,1743.61658809037,1622.29196419261,1968.69006049611,3,9
"912342767",7,1579.90950465341,1468.58881419619,1763.32076508842,1,6
"912342768",10,1652.9598630535,1575.93265549126,1896.67490607898,1,9
"912342769",13,1648.53318968831,1676.5156111634,2001.16379457045,2,11
"912342770",12,1618.43907647987,1411.29176704372,1968.69006049611,1,11
"912342771",4,1468.3394883492,1449.55791254699,1572.73281143487,0,4
"912342772",10,1678.92113154578,1762.67095173556,1896.67490607898,1,9
"912342773",8,1576.92347437567,1467.28729942619,1812.11073017574,1,7
"912342774",8,1643.36171207838,1468.54685059294,1812.11073017574,0,8
"912342775",5,1544.76904914685,1354.08665892626,1646.12614877363,0,5
"912342776",10,1588.64445228441,1524.32379906286,1896.67490607898,0,10
"912342777",3,1423.75648366107,1460.51836617296,1482.92019466158,0,3
"912342778",20,1716.32275023127,1290.67395034638,2185.35845629437,5,15
"912342779",9,1620.80887444277,1335.73716868967,1856.26587460569,1,8
"912342780",18,1636.61240402116,1181.58932161991,2138.79896507223,4,14
"912342781",8,1604.28578981537,1559.75899180472,1812.11073017574,0,8
"912342782",9,1700.35622310773,1501.85368155649,1856.26587460569,1,8
"912342783",7,1636.26542963616,1598.11981808268,1763.32076508842,0,7
"912342784",15,1621.8162762039,1362.84274235393,2060.56118614118,3,12
"912342785",9,1597.51812820321,1302.45559998713,1856.26587460569,1,8
"912342788",13,1701.31635196579,1617.45243207853,2001.16379457045,1,12
"912342789",16,1681.0136294999,1366.61076047794,2087.92318348224,2,14
"912342790",22,1590.38001156818,1111.24365081762,2228.3491786518,2,20
"912342792",9,1608.95019491362,1145.083092262,1856.26587460569,2,7
"912342793",13,1704.3072117476,1376.7998067343,2001.16379457045,2,11
"912342794",7,1587.09951419924,1220.8997535573,1763.32076508842,2,5
"912342795",10,1643.09343815446,1188.30053344982,1896.67490607898,1,9
"912342796",7,1579.60828287975,1418.23840234077,1763.32076508842,1,6
"912342797",9,1629.39658933428,1453.7350805941,1856.26587460569,1,8
"912342798",5,1543.51246392521,1563.72477412795,1646.12614877363,0,5
"912342799",2,1329.5677261165,1340.33419287358,1364.97646362037,0,2
"912342800",6,1562.85794850104,1445.10055487986,1708.62817714657,0,6
"912342801",5,1502.05888280404,1329.26731056601,1646.12614877363,0,5
"912342802",8,1611.90877496261,1282.92236042798,1812.11073017574,1,7
"912342803",12,1659.44409444445,1339.6288055276,1968.69006049611,3,9
"912342804",12,1631.22510918913,1339.4701660772,1968.69006049611,1,11
"912342805",7,1571.14557918543,1240.02144683729,1763.32076508842,1,6
"912342806",15,1732.04609207269,1307.88463177986,2060.56118614118,3,12
"912342807",13,1677.83895919473,1189.10355514203,2001.16379457045,1,12
"912342808",8,1589.19184698803,1350.15450404819,1812.11073017574,1,7
"912342809",12,1678.69757975921,1297.63510616816,1968.69006049611,2,10
"912342810",11,1680.13030438179,1168.02353806898,1933.98659929558,1,10
"912342811",12,1645.5444097286,1361.25041680975,1968.69006049611,2,10
"912342812",13,1680.44358998151,1370.12293482915,2001.16379457045,2,11
"912342813",11,1690.6628079888,1409.40989948874,1933.98659929558,2,9
"912342814",6,1557.68404779782,1194.31598058723,1708.62817714657,1,5
"912342815",2,1307.96437984173,1364.97646362037,1364.97646362037,0,2
"912342816",13,1642.29133376839,1399.494492825,2001.16379457045,1,12
"912342817",10,1765.53053050528,1480.3887531154,1896.67490607898,2,8
"912342818",10,1712.2968137951,1473.48128568484,1896.67490607898,2,8
"912342819",11,1663.56191034098,1270.95741944289,1933.98659929558,1,10
"912342820",5,1545.62799414079,1403.82113358894,1646.12614877363,1,4
"912342821",7,1597.39759896449,1373.82614526485,1763.32076508842,1,6
"912342822",5,1519.09902761733,1521.49875189831,1646.12614877363,0,5
"912342823",5,1548.91644237097,1453.84817983722,1646.12614877363,0,5
"912342824",6,1576.08938759309,1529.34259058646,1708.62817714657,0,6
"912342825",12,1686.43687636401,1680.00546655003,1968.69006049611,2,10
"912342826",5,1530.01559067668,1526.34928186179,1646.12614877363,0,5
"912342827",11,1636.8815553231,1446.87602244609,1933.98659929558,2,9
"912342828",10,1634.86005338094,1435.36311452504,1896.67490607898,1,9
"912342829",5,1513.13414894377,1526.80860739663,1646.12614877363,0,5
"912342830",12,1623.52623163643,1394.87100544212,1968.69006049611,1,11
"912342831",10,1656.6007056053,1539.59834549908,1896.67490607898,2,8
"912342832",10,1671.02816360244,1533.5206551073,1896.67490607898,1,9
"912342833",2,1329.5677261165,1309.87332876185,1364.97646362037,0,2
"912342834",9,1664.265844776,1597.87311396648,1856.26587460569,4,5
"912342835",7,1635.93330981527,1654.765242543,1763.32076508842,0,7
"912342836",12,1644.44153647892,1691.25374325801,1968.69006049611,1,11
"912342837",11,1600.76380058799,1451.33647834586,1933.98659929558,1,10
"912342838",14,1645.92236737505,1293.32370640971,2031.70713799962,2,12
"912342839",15,1634.87136194334,1338.7221054597,2060.56118614118,2,13
"912342840",13,1651.93612627774,1358.37210920597,2001.16379457045,3,10
"912342841",15,1709.37258295588,1095.33334864324,2060.56118614118,1,14
"912342842",16,1710.89705804428,1449.85676433848,2087.92318348224,2,14
"912342843",10,1634.40957135348,1305.51402814447,1896.67490607898,1,9
"912342844",17,1589.52043951462,1119.78346553295,2113.95669457394,2,15
"912342845",9,1631.61861958455,1511.68536582597,1856.26587460569,1,8
"912342846",13,1670.54153415547,1429.79670296522,2001.16379457045,1,12
"912342847",13,1613.12321099984,1202.79506964203,2001.16379457045,1,12
"912342848",17,1738.45936240052,1560.17173550869,2113.95669457394,1,16
"912342849",17,1668.60196529824,1190.5525326149,2113.95669457394,2,15
"912342850",4,1495.86092238106,1321.49735996279,1572.73281143487,1,3
"912342851",15,1642.70899824815,1353.08727675578,2060.56118614118,2,13
"912342852",13,1646.95569714432,1379.80676280033,2001.16379457045,2,11
"912342853",6,1527.5193564655,1388.24735439774,1708.62817714657,1,5
"912342854",21,1563.24768891316,1614.89850565329,2207.26116887512,3,18
"912342855",16,1560.45340481361,1461.23424860116,2087.92318348224,2,14
"912342856",7,1579.61562212576,1385.70762462687,1763.32076508842,2,5
"912342857",11,1645.62449659463,1458.26200315229,1933.98659929558,1,10
"912342858",10,1658.84319300622,1272.51628884459,1896.67490607898,1,9
"912342859",9,1628.59545132115,1547.79092914047,1856.26587460569,1,8
"912342860",8,1618.94096250238,1580.7362411594,1812.11073017574,2,6
"912342861",8,1596.92735392174,1520.92368102487,1812.11073017574,2,6
"912342862",12,1615.92039283854,1286.88094813657,1968.69006049611,2,10
"912342863",6,1543.93747725951,1559.14485102548,1708.62817714657,1,5
"912342864",10,1593.09201276208,987.434643884453,1896.67490607898,1,9
"912342865",15,1714.61691980423,1605.81624389568,2060.56118614118,1,14
"912342866",7,1540.34578796589,1404.04168403111,1763.32076508842,2,5
"912342867",14,1639.23118693135,1125.19079302727,2031.70713799962,3,11
"912342868",9,1619.51268714665,1276.38262900952,1856.26587460569,2,7
"912342869",11,1685.32906353607,1381.64092082691,1933.98659929558,5,6
"912342870",15,1647.91644697723,1466.43287063779,2060.56118614118,4,11
"912342871",7,1549.85320753332,1260.17937712752,1763.32076508842,1,6
"912342872",12,1677.53292273307,1488.24289532861,1968.69006049611,2,10
"912342873",12,1694.24957711644,1433.37105318661,1968.69006049611,3,9
"912342874",11,1678.84965746495,1361.16806048232,1933.98659929558,2,9
"912342875",13,1702.01354752174,1266.16965506271,2001.16379457045,2,11
"912342876",17,1673.69070004821,1167.31624604397,2113.95669457394,4,13
"912342877",23,1661.11657955912,1148.64502033367,2248.68783741607,3,20
"912342878",8,1579.25080558573,1158.19969043616,1812.11073017574,1,7
"912342879",17,1669.13541872567,1047.02918500783,2113.95669457394,5,12
"912342880",18,1730.69134184211,1453.39050010346,2138.79896507223,5,13
"912342881",9,1633.15455471924,1425.24532218834,1856.26587460569,1,8
"912342882",17,1659.81222681256,1508.17526813554,2113.95669457394,3,14
"912342883",12,1683.20870508759,1515.98982930796,1968.69006049611,3,9
"912342884",16,1706.41917015871,1327.79531815266,2087.92318348224,4,12
"912342885",16,1716.87787736865,1110.04769412549,2087.92318348224,3,13
"912342886",14,1657.53018790248,1303.31451758653,2031.70713799962,3,11
"912342887",14,1615.32420528777,1326.62738775008,2031.70713799962,1,13
"912342888",13,1709.52739051473,1386.7901595606,2001.16379457045,1,12
"912342889",17,1652.46494244015,947.141698312379,2113.95669457394,2,15
"912342890",17,1682.01418893326,1140.83161380706,2113.95669457394,2,15
"912342891",19,1718.45476270529,1091.97261211129,2162.56636020013,3,16
"912342892",14,1656.00641925061,1166.37297134068,2031.70713799962,1,13
"912342893",17,1702.47269532256,1381.27031826151,2113.95669457394,4,13
"912342894",16,1632.16922437867,1221.59824011801,2087.92318348224,2,14
"912342895",3,1405.39401978422,1288.77950896205,1482.92019466158,0,3
"912342896",1,1162.65434719398,1129.02740872474,1184.66451052022,0,1
"912342897",1,1164.35739673228,1162.37381954811,1184.66451052022,0,1
"912342898",10,1733.98401622444,1793.6911605173,1896.67490607898,0,10
"912342899",9,1650.12991117798,1380.66780395164,1856.26587460569,1,8
"912342900",7,1624.80237415619,1395.44913252973,1763.32076508842,2,5
"912342901",10,1657.06588551483,1507.42769659692,1896.67490607898,1,9
"912342902",10,1646.6342714419,1588.58067025198,1896.67490607898,0,10
"912342903",7,1640.43713232914,1565.50233482339,1763.32076508842,1,6
"912342904",10,1672.57891076938,1223.99993170565,1896.67490607898,0,10
"912342905",10,1658.1332511445,1293.0576220467,1896.67490607898,2,8
"912342906",19,1659.62718904852,1084.62387981615,2162.56636020013,1,18
"912342907",15,1648.20572175409,1326.13892747665,2060.56118614118,1,14
"912342908",19,1699.08146434594,1376.36068816877,2162.56636020013,2,17
"912342909",8,1611.18309011432,1210.01258997596,1812.11073017574,1,7
"912342910",16,1680.15517765899,1293.95572176477,2087.92318348224,1,15
"912342911",11,1608.89590723675,1189.15583708725,1933.98659929558,1,10
"912342912",6,1580.38182863122,1305.09086036021,1708.62817714657,1,5
"912342913",14,1622.75731354311,1270.09619695001,2031.70713799962,2,12
"912342914",8,1621.15807165424,1207.86389623262,1812.11073017574,1,7
"912342915",6,1550.05952088684,1362.85805481671,1708.62817714657,0,6
"912342916",26,1597.32744668639,1316.26965238396,2305.75108410937,3,23
"912342917",13,1654.22173429439,1437.35098533634,2001.16379457045,1,12
"912342918",19,1562.36185682953,1112.16322868343,2162.56636020013,2,17
"912342919",10,1607.8926794008,1292.64706228739,1896.67490607898,1,9
"912342920",15,1600.40939724742,1501.06688663981,2060.56118614118,1,14
"912342921",13,1639.37131023368,1590.46394224809,2001.16379457045,1,12
"912342922",10,1671.29712422637,1582.7606401137,1896.67490607898,2,8
"912342923",5,1562.10667448255,1531.26529652968,1646.12614877363,0,5
"912342924",11,1705.91169391095,1437.68399091212,1933.98659929558,3,8
"912342925",1,1162.65434719398,1160.50615054317,1184.66451052022,0,1
"912342926",7,1630.42008286775,1552.84173482457,1763.32076508842,0,7
"912342927",11,1712.68275460326,1592.50132580735,1933.98659929558,0,11
"912342928",7,1621.18424753523,1674.22941429428,1763.32076508842,1,6
"912342929",11,1692.6901933841,1539.99458027756,1933.98659929558,2,9
"912342930",10,1622.58961084505,1245.91979281859,1896.67490607898,1,9
"912342931",15,1675.65599542062,1377.46993046777,2060.56118614118,2,13
"912342932",14,1643.24317228676,1497.13434875686,2031.70713799962,2,12
"912342933",13,1665.57734880447,1263.64764502703,2001.16379457045,1,12
"912342934",15,1628.01551091644,1211.71422218533,2060.56118614118,2,13
"912342935",10,1617.14066966558,1457.04759107373,1896.67490607898,1,9
"912342936",12,1630.21408267389,1099.14200599733,1968.69006049611,1,11
"912342937",13,1661.56961824034,1480.64110547475,2001.16379457045,3,10
"912342938",12,1662.84595771006,1462.93781910666,1968.69006049611,3,9
"912342939",7,1573.5768215017,1414.79222695503,1763.32076508842,2,5
"912342940",14,1651.38634291079,1369.79857341155,2031.70713799962,2,12
"912342941",9,1673.08825828946,1390.59325478203,1856.26587460569,1,8
"912342942",6,1569.17769839136,1504.87510918037,1708.62817714657,0,6
"912342943",11,1526.06336313858,1422.62099843469,1933.98659929558,1,10
"912342944",9,1777.99876787184,1754.00357571069,1856.26587460569,2,7
"912342947",9,1785.82158415689,1925.22389460653,1856.26587460569,2,7
"912342948",9,1788.53940856904,1918.7381149853,1856.26587460569,1,8
"912342949",7,1692.53858435286,1560.40489344959,1763.32076508842,2,5
"912342950",10,1745.00524927658,1766.15883734538,1896.67490607898,1,9
"912342951",10,1771.43534966262,1826.80596016497,1896.67490607898,1,9
"912342953",7,1667.51417606086,1478.19128481486,1763.32076508842,1,6
"912342954",8,1689.00538778675,1634.5814778607,1812.11073017574,1,7
"912342955",7,1728.48355101715,1682.34665414023,1763.32076508842,2,5
"912342956",8,1667.04283268209,1440.3461814919,1812.11073017574,1,7
"912342957",8,1703.23767714188,1715.57678868568,1812.11073017574,1,7
"912342958",11,1762.14857664771,1542.59375849121,1933.98659929558,2,9
"912342960",9,1741.80160765483,1423.3768816863,1856.26587460569,1,8
"912342961",9,1758.34218916266,1468.37540209375,1856.26587460569,2,7
"912342973",32,1793.77757992031,1685.87952796141,2405.71569249515,9,23
"912342977",5,1571.21713689892,1579.14861767292,1646.12614877363,2,3
"912342999",17,1890.69046387771,1848.26714622342,2113.95669457394,4,13
"912343000",19,1949.74215225297,1927.1732913771,2162.56636020013,5,14
"912343025",6,1646.41672323002,1482.69286679229,1708.62817714657,1,5
"912343026",9,1757.68748431817,1926.91509924264,1856.26587460569,1,8
"912343028",7,1714.4470678174,1864.1768963941,1763.32076508842,1,6
"912343029",6,1700.24098387136,1767.82653305659,1708.62817714657,1,5
"912343050",31,1922.43267831362,1606.8915431639,2390.15469389133,9,22
"912343055",6,1670.28767831473,1707.68578953653,1708.62817714657,1,5
"912343056",5,1639.67142778817,1783.78975078204,1646.12614877363,0,5
"912343057",4,1591.64083574002,1679.59080166958,1572.73281143487,0,4
"912343058",6,1729.18889025462,1835.24420796468,1708.62817714657,0,6
"912343059",9,1655.15205716433,1389.61985224791,1856.26587460569,1,8
"912343060",8,1699.36110195579,1503.04090020614,1812.11073017574,0,8
"912343061",27,2292.16615797566,2108.28607760445,2323.60649590586,5,22
"912343063",9,1822.46155646882,1835.19442059135,1856.26587460569,1,8
"912343064",10,1766.30825759036,1593.28333314845,1896.67490607898,1,9
"912343065",12,1854.07198559463,1661.94278362154,1968.69006049611,1,11
"912343066",10,1764.07649497558,1625.97473083827,1896.67490607898,2,8
"912343073",13,1801.00323968898,1705.72880659832,2001.16379457045,2,11
"912343075",32,2136.93912771662,1976.75633035619,2405.71569249515,7,25
"912343076",22,2201.58806119882,2030.79830709502,2228.3491786518,4,18
"912343085",12,1871.10447495014,1720.01283045692,1968.69006049611,4,8
"912343088",32,2409.12750894873,2649.57077722962,2405.71569249515,13,19
"912343089",45,2879.85198088383,2355.14696535987,2579.33597919865,21,24
"912343090",52,2752.79808266982,2449.07737010962,2656.6981055205,24,28
"912343091",47,2760.44688771187,2627.52134720894,2602.36394728806,21,26
"912343092",50,3105.55108465338,2909.27029209306,2635.48551585152,21,29
"912343093",40,2781.77596151209,2575.68596578856,2517.98110851286,17,23
"912343095",36,2653.14354148414,2224.68981768864,2464.33502634194,12,24
"912343096",56,2927.41006536942,2556.97099433054,2697.24673169728,24,32
"912343097",40,2776.22771129547,2329.93015016381,2517.98110851286,16,24
"912343098",44,2537.16941630859,2156.49254803198,2567.51523707907,20,24
"912343099",40,2730.51560823345,2741.59755520296,2517.98110851286,19,21
"912343100",39,2584.95577603962,2502.61930733454,2504.98447234734,17,22
"912343101",42,2761.54599171678,2442.36096780766,2543.21752514954,18,24
"912343102",53,2722.64362845179,2207.54314183664,2667.061866114,18,35
"912343103",37,2283.24365629746,2041.59139434962,2478.17471526668,14,23
"912343104",29,2352.21237353394,2376.59317377866,2357.79423966008,9,20
"912343105",46,2567.25467699354,2168.32340738353,2590.94954296761,16,30
"912343106",43,2787.75236381855,2693.2233094821,2555.47878346624,19,24
"912343107",42,2653.677898337,2288.5899583425,2543.21752514954,18,24
"912343108",37,2558.8048614515,2349.07858933516,2478.17471526668,15,22
"912343109",39,2613.36012378864,2425.26393589761,2504.98447234734,19,20
"912343110",43,2805.10846209144,2733.84991191389,2555.47878346624,25,18
"912343111",49,2646.00051775443,2447.00777447744,2624.62502504328,25,24
"912343112",33,2264.22549588796,2002.20969975009,2420.89448855093,14,19
"912343113",29,2437.73991507833,2256.73698704545,2357.79423966008,10,19
"912343114",42,2569.79089432961,2663.51870339441,2543.21752514954,17,25
"912343115",39,2441.38609405607,2512.52513206666,2504.98447234734,15,24
"912343116",51,2633.89625538859,2562.88279579627,2646.17454577679,21,30
"912343117",29,2256.92521036306,2030.31021921302,2357.79423966008,12,17
"912343118",42,2594.96097326071,2374.36395147241,2543.21752514954,14,28
"912343119",40,2687.07411760099,2529.99747865024,2517.98110851286,17,23
"912343120",42,3045.20821049696,2807.53208632409,2543.21752514954,18,24
"912343121",46,2619.40633902087,2167.1971139054,2590.94954296761,19,27
"912343122",35,2443.049096115,2066.21361494341,2450.1860183293,17,18
"912343123",51,2927.99460496258,2672.40091595569,2646.17454577679,21,30
"912343124",63,3246.91212309185,3009.12918154839,2762.96971264875,25,38
"912343125",40,2625.8089187342,2622.87628648527,2517.98110851286,17,23
"912343126",35,2916.34963107274,2665.73692507941,2450.1860183293,16,19
"912343127",56,3271.55521788097,3392.16406224422,2697.24673169728,21,35
"912343128",63,2966.96270887997,3315.63932474201,2762.96971264875,26,37
"912343129",43,2604.76770698456,2275.38470716097,2555.47878346624,19,24
"912343130",35,2398.09573001402,2306.17655314157,2450.1860183293,12,23
"912343131",47,2889.97764108228,2974.33674813869,2602.36394728806,20,27
"912343132",52,3010.59797289691,2359.84735822072,2656.6981055205,21,31
"912343133",37,2620.44218312685,2391.00317533507,2478.17471526668,14,23
"912343134",27,2500.61701942375,2513.20234193597,2323.60649590586,14,13
"912343135",40,2770.31055224687,2576.25164874368,2517.98110851286,19,21
"912343136",35,2736.97711237333,2289.37057591246,2450.1860183293,18,17
"912343137",40,2975.08856151753,2090.25627657507,2517.98110851286,18,22
"912343138",33,2631.53744926627,2379.29767646243,2420.89448855093,19,14
"912343139",37,2369.94928922677,2248.06171741808,2478.17471526668,18,19
"912343140",38,2507.10322267455,2499.56317380438,2491.71993967651,16,22
"912343141",34,2608.67685210244,2448.44344410152,2435.71163614839,13,21
"912343142",49,3061.8011321377,2592.5968211802,2624.62502504328,18,31
"912343143",30,2596.35998038738,2744.14063253264,2374.18906024059,9,21
"912343144",39,2741.50252886698,2841.65581062693,2504.98447234734,12,27
"912343145",55,2752.25874217678,2769.14690326187,2687.33120998132,21,34
"912343146",43,2931.91381419301,2646.95922473252,2555.47878346624,13,30
"912343147",44,2797.42334435507,2822.21443057092,2567.51523707907,20,24
"912343148",56,2700.54940288875,2712.22157500958,2697.24673169728,18,38
"912343149",50,2722.68904392502,2613.02965909787,2635.48551585152,20,30
"912343150",50,2763.96051842517,2332.32117326865,2635.48551585152,22,28
"912343151",38,2610.3309514965,2980.42041215117,2491.71993967651,11,27
"912343152",39,2782.68554132396,2976.91339099517,2504.98447234734,16,23
"912343153",41,2602.26257890145,2369.39339834697,2530.72175773865,16,25
"912343154",57,2362.42525311412,1743.17969046766,2707.02236739438,21,36
"912343155",24,2405.95064105691,2600.31353803191,2268.33468283819,11,13
"912343156",33,2468.46060089061,2616.32746310483,2420.89448855093,10,23
"912343157",35,2477.92106316431,2158.89254548798,2450.1860183293,16,19
"912343158",47,2275.63626844932,2035.92056481982,2602.36394728806,19,28
"912343159",48,2810.34876596227,3024.24329152047,2613.58673801098,20,28
"912343160",34,2359.43868951273,2677.99566108378,2435.71163614839,15,19
"912343161",52,2679.60317490785,2602.86225420903,2656.6981055205,21,31
"912343162",35,2742.17507959727,2381.50077677242,2450.1860183293,12,23
"912343163",43,2605.13702499349,3019.02499868373,2555.47878346624,17,26
"912343164",56,2762.61088729,2751.16184807508,2697.24673169728,20,36
"912343165",39,2354.9387942288,1896.67702007962,2504.98447234734,13,26
"912343166",47,2728.82530232996,2325.08276457166,2602.36394728806,18,29
"912343167",43,2711.9095135311,2225.8096632411,2555.47878346624,16,27
"912343168",32,2486.54022582144,2250.94916373851,2405.71569249515,11,21
"912343169",42,2503.50467369089,2895.06912087612,2543.21752514954,14,28
"912343170",59,2741.95450243714,3117.83963160298,2726.17127719361,21,38
"912343171",47,2709.63479521621,2606.71277812806,2602.36394728806,20,27
"912343172",38,2957.73054831343,2535.69618550357,2491.71993967651,18,20
"912343173",53,2444.09899029391,2059.03308897075,2667.061866114,17,36
"912343174",42,2664.06172933301,2375.59625294702,2543.21752514954,15,27
"912343175",54,3111.36504854135,2714.25848193471,2677.2712016452,16,38
"912343176",56,2968.69427404231,2530.82368587184,2697.24673169728,20,36
"912343177",49,2829.07858721736,2900.86777639688,2624.62502504328,21,28
"912343178",52,3079.43022514319,2538.97239947261,2656.6981055205,21,31
"912343179",30,2494.43648707399,2404.70864018311,2374.18906024059,12,18
"912343180",63,2578.10056909475,2575.7315665714,2762.96971264875,23,40
"912343181",49,2731.07987964986,2689.17570183708,2624.62502504328,17,32
"912343182",53,2431.22549884335,2631.585415025,2667.061866114,19,34
"912343183",49,2727.53479747206,2794.22992321672,2624.62502504328,18,31
"912343185",35,2461.04991053368,2292.04673736126,2450.1860183293,12,23
"912343186",38,2888.02091628626,3388.45191663711,2491.71993967651,10,28
"912343187",50,2920.78655463734,2613.3256459549,2635.48551585152,16,34
"912343188",53,2853.82814202788,2936.97121157315,2667.061866114,20,33
"912343189",47,2820.07668702544,3105.50538449243,2602.36394728806,15,32
"912343190",50,2586.07732888438,1814.23455902104,2635.48551585152,18,32
"912343191",41,2395.57343521164,1926.90706756788,2530.72175773865,15,26
"912343192",46,2524.3326205659,2243.11474712063,2590.94954296761,16,30
"912343193",28,2447.32491856958,2167.22532277624,2340.94327947849,8,20
"912343194",31,2278.99244525271,2143.7171185362,2390.15469389133,9,22
"912343195",43,3027.9485942403,3121.65298202441,2555.47878346624,19,24
"912343196",53,3025.79704558489,3065.90291895483,2667.061866114,22,31
"912343197",46,3165.85711571196,3587.51946566996,2590.94954296761,23,23
"912343198",46,2967.01427590107,2704.73651937606,2590.94954296761,18,28
"912343199",56,2808.6048213294,3342.21823360287,2697.24673169728,17,39
"912343200",50,2799.1735302606,3132.66832689092,2635.48551585152,14,36
"912343201",50,2629.823748619,2780.51037287905,2635.48551585152,16,34
"912343202",43,2616.37172820899,2852.14343355749,2555.47878346624,16,27
"912343203",40,2460.11216833157,1804.7236228416,2517.98110851286,14,26
"912343204",44,2733.67223106872,2997.09609320144,2567.51523707907,14,30
"912343205",43,2943.11452950353,2971.1263538916,2555.47878346624,13,30
"912343206",69,2937.42100126036,2927.39627764834,2814.82611826518,24,45
"912343207",55,2609.49484098591,2296.70708743369,2687.33120998132,16,39
"912343208",55,2114.17250972722,1755.62354746344,2687.33120998132,15,40
"912343209",58,2552.81491571933,2952.07494014041,2716.66249357165,22,36
"912343210",38,2740.07967596783,2565.50262372793,2491.71993967651,12,26
"912343211",53,2677.30788611062,2842.96618161339,2667.061866114,13,40
"912343212",52,3045.50357381827,2841.49252827089,2656.6981055205,19,33
"912343213",46,2777.22876665089,2810.07276140101,2590.94954296761,14,32
"912343214",39,2695.39499002802,2781.78365319327,2504.98447234734,11,28
"912343215",24,2186.90907739716,1896.7035001966,2268.33468283819,6,18
"912343216",42,2374.2110589774,2672.89355270161,2543.21752514954,13,29
"912343217",58,2788.49220698252,2730.13614040886,2716.66249357165,19,39
"912343218",41,2879.64686133436,2947.67679296869,2530.72175773865,15,26
"912343219",36,2813.93516481475,3085.41282206315,2464.33502634194,14,22
"912343220",41,2756.95534730995,2901.80643847355,2530.72175773865,15,26
"912343221",41,2571.68713564876,2771.45537131745,2530.72175773865,17,24
"912343222",42,2998.82999699192,3423.11333472077,2543.21752514954,18,24
"912343223",40,2625.64283781164,2374.59159816267,2517.98110851286,11,29
"912343224",48,2717.13871310594,2941.63556527665,2613.58673801098,17,31
"912343225",55,3073.35075625656,2871.52137576015,2687.33120998132,21,34
"912343226",53,3149.92804496952,3133.5527430389,2667.061866114,19,34
"912343227",49,2504.3204821322,2646.59133926955,2624.62502504328,16,33
"912343228",56,2442.99338434309,1435.74116968192,2697.24673169728,18,38
"912343229",74,2661.5632103894,2686.71929181668,2855.36548874306,29,45
"912343230",55,3018.71753916046,3108.91220462229,2687.33120998132,22,33
"912343231",63,3092.37140916884,3075.54561314672,2762.96971264875,23,40
"912343232",61,3151.57603061851,3350.16683512259,2744.81051624266,24,37
"912343233",53,2850.17783207728,2849.59216972152,2667.061866114,22,31
"912343234",70,3127.35968303536,2923.78069791898,2823.11677003184,25,45
"912343235",60,3011.81644764345,2852.23239906018,2735.5526890818,25,35
"912343236",44,2538.60982283909,2546.94573836881,2567.51523707907,15,29
"912343238",27,2237.9985955479,2426.98211512315,2323.60649590586,9,18
"912343239",30,2137.51400284424,2335.32156891899,2374.18906024059,9,21
"912343240",41,2471.14072241833,2259.33412805673,2530.72175773865,11,30
"912343241",44,2802.68527741099,2562.99497768047,2567.51523707907,15,29
"912343242",43,2458.87071637656,2539.30519192763,2555.47878346624,16,27
"912343243",20,2271.00665504091,2117.34199659909,2185.35845629437,7,13
"912343244",42,2577.0230731868,2237.50857475368,2543.21752514954,17,25
"912343245",58,2501.90732053258,2348.59502399574,2716.66249357165,21,37
"912343246",49,2480.70702643065,2612.517585421,2624.62502504328,16,33
"912343247",59,2554.9169038595,3072.23661390845,2726.17127719361,22,37
"912343248",49,2732.29574127817,2543.41823790651,2624.62502504328,21,28
"912343249",52,2586.29121601183,2442.30675024537,2656.6981055205,21,31
"912343250",45,3092.46910279223,3071.07952009212,2579.33597919865,24,21
"912343251",56,3065.70635613466,3215.08834008828,2697.24673169728,26,30
"912343252",46,2988.51686746991,3185.08921009872,2590.94954296761,18,28
"912343253",54,2987.42933400099,3070.54976993729,2677.2712016452,20,34
"912343254",62,2760.50975334536,2343.55073067317,2753.94837323248,22,40
"912343255",58,2912.67639089607,2576.23203113809,2716.66249357165,25,33
"912343256",52,2695.97623927011,2603.32675427505,2656.6981055205,17,35
"912343257",43,2625.30776641901,2569.55210238896,2555.47878346624,15,28
"912343258",56,2749.54789591425,2799.00655850923,2697.24673169728,19,37
"912343259",38,2414.35454499206,2113.83764754254,2491.71993967651,13,25
"912343260",41,2644.90852829742,2178.20770167505,2530.72175773865,15,26
"912343261",61,2742.95729443231,2604.46541516146,2744.81051624266,20,41
"912343262",58,2873.01458315379,2995.17819604629,2716.66249357165,23,35
"912343263",52,2725.39281874782,2521.23855593993,2656.6981055205,21,31
"912343264",38,2630.40282455025,2506.99813955498,2491.71993967651,14,24
"912343265",44,2691.71113117239,2502.68372761086,2567.51523707907,15,29
"912343267",51,2331.73198035333,1894.73256854925,2646.17454577679,18,33
"912343268",44,2653.19803335241,2068.39793089328,2567.51523707907,13,31
"912343269",51,2827.47314735505,2617.69672641583,2646.17454577679,19,32
"912343270",44,2757.99713097134,2651.0754690473,2567.51523707907,15,29
"912343271",38,2235.94630916354,2200.10684675091,2491.71993967651,14,24
"912343272",40,2367.42168635068,2067.15853144806,2517.98110851286,15,25
"912343273",35,2581.36412591085,2574.83047083527,2450.1860183293,11,24
"912343274",44,2382.75844446606,2485.91371596006,2567.51523707907,14,30
"912343275",54,2476.20892630386,1766.79998894885,2677.2712016452,16,38
"912343276",60,2892.40936200035,2306.03324245988,2735.5526890818,27,33
"912343277",51,2763.67480585125,2467.48762816195,2646.17454577679,19,32
"912343278",43,2499.25841000665,2399.89714358369,2555.47878346624,16,27
"912343279",33,2607.88912500766,2576.66674790818,2420.89448855093,16,17
"912343280",42,2454.17218239419,2326.8346446929,2543.21752514954,19,23
"912343281",49,2893.32771737017,2227.47634570108,2624.62502504328,21,28
"912343282",42,2479.47358792261,2461.4290295205,2543.21752514954,16,26
"912343283",50,2550.87176824414,2181.53486190684,2635.48551585152,18,32
"912343284",48,2789.70932582957,2051.61297835181,2613.58673801098,18,30
"912343285",55,2851.8453987874,2619.08609232994,2687.33120998132,22,33
"912343286",59,2732.89547682451,2247.28720060267,2726.17127719361,22,37
"912343287",71,2922.86706800565,3184.60563242947,2831.31372136695,29,42
"912343288",33,2358.7493897184,2467.91986292447,2420.89448855093,10,23
"912343289",67,2755.55927116719,2770.60387025676,2797.95380131742,21,46
"912343290",29,2527.6173732988,2570.88909040091,2357.79423966008,9,20
"912343291",34,2285.29426136905,2483.66536838871,2435.71163614839,11,23
"912343292",58,3141.28386453924,2989.69783689953,2716.66249357165,19,39
"912343293",46,2545.3914948091,2503.56875468393,2590.94954296761,18,28
"912343294",57,2982.63273520858,2839.35587115426,2707.02236739438,19,38
"912343295",46,2630.28308650543,2226.10359690114,2590.94954296761,20,26
"912343296",50,2461.68713914677,2025.8305177809,2635.48551585152,21,29
"912343297",53,2578.90597188296,1980.84196331096,2667.061866114,21,32
"912343298",44,2833.75104150182,2706.1602549528,2567.51523707907,16,28
"912343299",52,2648.90434959101,2717.82107991133,2656.6981055205,16,36
"912343300",41,2589.62118408167,2770.61616694163,2530.72175773865,13,28
"912343301",59,2804.52842013371,2765.9902055146,2726.17127719361,13,46
"912343302",60,2512.94670892042,2669.12120398668,2735.5526890818,18,42
"912343303",43,2603.04217997689,2214.17939670731,2555.47878346624,14,29
"912343304",40,2728.68795860132,3229.28793279385,2517.98110851286,14,26
"912343305",60,2722.60660964462,2772.95439267665,2735.5526890818,22,38
"912343306",42,2688.54077309197,2649.48320203682,2543.21752514954,16,26
"912343307",47,2675.362696426,2657.81113214002,2602.36394728806,20,27
"912343308",56,2645.62661122416,2666.603204101,2697.24673169728,20,36
"912343309",53,2825.48808775727,2464.62304515136,2667.061866114,17,36
"912343310",41,2594.29695956397,2512.60329426571,2530.72175773865,10,31
"912343311",41,2798.56449179108,2542.13791045279,2530.72175773865,14,27
"912343312",58,2939.27322479864,2589.45228242743,2716.66249357165,18,40
"912343313",62,2945.27341823632,2321.71592853625,2753.94837323248,23,39
"912343314",33,2754.72498672495,3105.48554259312,2420.89448855093,13,20
"912343315",27,2748.65763088007,2995.83844176487,2323.60649590586,10,17
"912343316",48,2335.23650918413,2036.4439973625,2613.58673801098,17,31
"912343317",44,2419.08222882255,2067.59568970607,2567.51523707907,15,29
"912343318",56,2878.16555226845,2518.83281054043,2697.24673169728,28,28
"912343319",57,2919.76712043267,2695.62364528545,2707.02236739438,29,28
"912343320",40,2519.52984621158,2522.3679116631,2517.98110851286,13,27
"912343321",51,2776.51870350726,2680.20042059319,2646.17454577679,18,33
"912343322",45,2529.94022856594,2721.89289378903,2579.33597919865,13,32
"912343323",36,2596.53015420262,2697.25303390724,2464.33502634194,10,26
"912343324",67,2361.31691388828,2382.40631409947,2797.95380131742,21,46
"912343325",50,2348.9009788585,1769.62343750827,2635.48551585152,14,36
"912343326",64,3023.366118881,2900.33870196537,2771.87783482774,25,39
"912343327",68,3032.44379468081,2864.53220688609,2806.43931339586,19,49
"912343328",55,2846.02080004633,2827.81080011348,2687.33120998132,18,37
"912343329",51,2868.08226362056,3049.41323634804,2646.17454577679,19,32
"912343330",56,3075.02673169672,3013.88496610994,2697.24673169728,26,30
"912343331",37,2551.62420181389,2915.79364365517,2478.17471526668,18,19
"912343332",51,2648.60509580942,2682.06974101874,2646.17454577679,20,31
"912343333",45,2704.54351307682,2597.69287971142,2579.33597919865,15,30
"912343334",51,2740.30826751979,2564.78816371742,2646.17454577679,23,28
"912343335",56,2772.9547442985,3087.49767703162,2697.24673169728,22,34
"912343336",52,2449.34098469328,2182.18520805443,2656.6981055205,20,32
"912343337",55,2343.17667399563,2191.29622605175,2687.33120998132,18,37
"912343338",49,2568.16611269897,2393.62083764768,2624.62502504328,17,32
"912343339",61,2524.55842807938,2277.68456761136,2744.81051624266,19,42
"912343340",70,3042.9613004362,2758.60741447001,2823.11677003184,27,43
"912343341",60,2663.89289417016,2642.43167455795,2735.5526890818,23,37
"912343342",60,2449.1309339992,1921.13375277716,2735.5526890818,22,38
"912343343",53,2679.35109727136,2107.11781712006,2667.061866114,23,30
"912343344",52,2614.17787798565,2651.1479429717,2656.6981055205,19,33
"912343345",57,2516.85184814368,2635.74241652158,2707.02236739438,19,38
"912343346",64,2660.88181688381,2754.17724955421,2771.87783482774,20,44
"912343347",56,2358.34802229332,2535.25139942996,2697.24673169728,24,32
"912343348",75,2818.9039196283,3199.91163292405,2863.21031780169,23,52
"912343349",59,2717.60988965901,2551.21950138711,2726.17127719361,21,38
"912343350",70,2763.89919962612,2123.70959351782,2823.11677003184,23,47
"912343351",74,2403.98427337812,2238.4495138034,2855.36548874306,23,51
"912343352",42,2243.63146883518,1758.19383810737,2543.21752514954,15,27
"912343353",28,2332.53447939122,1888.96322613927,2340.94327947849,13,15
"912343354",55,3105.56739211262,2817.30407760117,2687.33120998132,20,35
"912343355",38,2644.88206165442,2770.77055590356,2491.71993967651,15,23
"912343356",46,2741.65808030418,2755.78301114932,2590.94954296761,26,20
"912343357",48,3117.98931994802,2810.52205901933,2613.58673801098,21,27
"912343358",40,1930.52240582109,1018.37139393526,2517.98110851286,15,25
"912343359",40,1870.06497953912,781.646930776891,2517.98110851286,11,29
"912343361",25,1899.13988125644,1694.77990422595,2287.34065519221,7,18
"912343363",20,1963.9460308263,1992.97922005214,2185.35845629437,4,16
"912343364",16,1928.25434373378,1988.2588935221,2087.92318348224,3,13
"912343366",11,1773.97109623888,1668.25497363002,1933.98659929558,3,8
"912343367",9,1793.83468215915,1811.03272259009,1856.26587460569,3,6
"912343370",13,1841.71269642301,1794.56207943974,2001.16379457045,2,11
"912343371",15,1857.16446016287,1654.4335344541,2060.56118614118,3,12
"912343372",11,1855.16731344243,1784.80613149553,1933.98659929558,3,8
"912343373",23,2043.80589298106,2007.52850598913,2248.68783741607,8,15
"912343374",19,1993.57468877662,2056.51120126893,2162.56636020013,5,14
"912343375",17,1889.85095964321,1836.48039891673,2113.95669457394,5,12
"912343376",13,1881.31056310561,1800.06202760938,2001.16379457045,4,9
"912343378",21,1901.58359767419,1573.64326720998,2207.26116887512,4,17
"912343379",21,1929.85097418783,1665.70421615084,2207.26116887512,5,16
"912343380",18,1849.00661305599,1638.69368378593,2138.79896507223,6,12
"912343381",17,1810.7226922361,1711.00628973489,2113.95669457394,6,11
"912343382",22,2031.16982966671,2009.01028481384,2228.3491786518,6,16
"912343383",19,1948.63040334577,1804.56893447093,2162.56636020013,5,14
"912343384",25,1914.85984692804,1214.32012293321,2287.34065519221,5,20
"912343385",17,2052.17641583762,2033.22627894499,2113.95669457394,3,14
"912343389",18,1971.07160146356,1755.56326299691,2138.79896507223,3,15
"912343390",4,1578.66879064673,1543.97874527994,1572.73281143487,1,3
"912343391",3,1412.63814391331,1424.38293931067,1482.92019466158,1,2
"912343392",5,1587.71773281963,1517.3661201617,1646.12614877363,1,4
"912343393",3,1452.43772794921,1414.00652572642,1482.92019466158,1,2
"912343394",7,1723.69238247194,1704.85901593404,1763.32076508842,1,6
"912343395",14,1880.83051587598,1721.35188595775,2031.70713799962,3,11
"912343399",16,1752.26977502025,1443.4653374198,2087.92318348224,2,14
"912343407",58,2701.5356855292,2947.21439696999,2716.66249357165,16,42
"912343408",50,2619.22311675381,2718.06357639394,2635.48551585152,20,30
"912343409",57,2876.13016857612,3157.32961373461,2707.02236739438,17,40
"912343410",55,2938.77727580041,2922.40354261511,2687.33120998132,16,39
"912343411",50,2538.27947736348,2522.35715954979,2635.48551585152,19,31
"912343412",49,2974.23975465294,3410.07395975235,2624.62502504328,15,34
"912343414",61,3078.17871397342,3281.19214109878,2744.81051624266,21,40
"912343415",53,2661.33076896099,2249.36731908658,2667.061866114,17,36
"912343416",57,3161.78374514377,3198.65510525648,2707.02236739438,20,37
"912343417",51,2746.71033104516,2361.88655841291,2646.17454577679,13,38
"912343418",48,3154.54547671034,3170.41225410464,2613.58673801098,17,31
"912343419",37,2372.32988635133,2292.25859827979,2478.17471526668,19,18
"912343420",32,2382.72119491727,2097.34874178351,2405.71569249515,14,18
"912343421",22,1975.93898047961,1717.38777500822,2228.3491786518,9,13
"912343422",40,2314.1809198915,2199.49570817436,2517.98110851286,14,26
"912343423",62,2905.98256028871,2579.2423476963,2753.94837323248,20,42
"912343424",51,3031.8118766553,3039.45163028684,2646.17454577679,14,37
"912343425",54,2654.39538069464,2148.73046721488,2677.2712016452,17,37
"912343426",40,2193.07515708789,2044.27356087498,2517.98110851286,13,27
"912343427",47,2623.643401481,2398.21264101349,2602.36394728806,16,31
"912343428",45,2546.16115318053,2228.91717511724,2579.33597919865,18,27
"912343429",52,2342.18056397851,2116.04764902624,2656.6981055205,20,32
"912343431",33,2313.6856651833,1932.39924552327,2420.89448855093,13,20
"912343432",38,2548.26540383557,1997.63462748558,2491.71993967651,17,21
"912343433",43,2341.76227124501,1909.71239212011,2555.47878346624,19,24
"912343434",49,2431.03457974696,1778.42257721992,2624.62502504328,22,27
"912343439",21,1998.54738913589,1799.44568759162,2207.26116887512,3,18
"912343444",18,1923.73181392916,1889.64692237266,2138.79896507223,4,14
"912343445",16,1814.64142747857,1621.6784568353,2087.92318348224,3,13
"912343448",13,1767.79484254951,1645.35721197713,2001.16379457045,2,11
"912343453",19,1921.38720494209,1487.76846583357,2162.56636020013,4,15
"912343457",14,1880.91719667109,1783.43124804113,2031.70713799962,2,12
"912343458",14,1777.01115947825,1507.52930836038,2031.70713799962,4,10
"912343461",21,1772.59399819162,1294.14304962145,2207.26116887512,4,17
"912343464",20,1932.32534328786,1754.42107025987,2185.35845629437,5,15
"912343469",23,2059.10077908035,1913.26562515945,2248.68783741607,5,18
"912343470",19,1949.26623515169,1824.73555496898,2162.56636020013,5,14
"912343473",22,1848.58302057755,1466.35033386174,2228.3491786518,5,17
"912343481",24,2073.23717307441,1830.74688476783,2268.33468283819,3,21
"912343484",16,1786.11307830333,1741.38285745682,2087.92318348224,3,13
"912343485",14,1937.15106044719,1828.25181125528,2031.70713799962,3,11
"912343486",21,1863.918699926,1593.92389841297,2207.26116887512,2,19
"912343487",25,1888.52389485645,1855.06218937469,2287.34065519221,6,19
"912343488",37,2321.55617783191,2240.08282877016,2478.17471526668,11,26
"912343489",61,2613.73480113511,2951.79413696906,2744.81051624266,21,40
"912343522",7,1689.8768842712,1683.18257078002,1763.32076508842,3,4
"912343534",14,1869.14612093302,1745.67652024147,2031.70713799962,3,11
"912343548",12,1868.08626977295,1745.35855880188,1968.69006049611,2,10
"912343549",17,1965.77090403618,1832.93546302811,2113.95669457394,4,13
"912343551",3,1447.9021784562,1400.30898294445,1482.92019466158,2,1
"912343552",6,1672.82141838193,1561.35304368992,1708.62817714657,3,3
"912343748",40,2657.85232053947,2518.21705204836,2517.98110851286,16,24
"912343749",51,2599.61455622066,2165.85924668096,2646.17454577679,13,38
"912343750",67,2673.91248166492,2548.36243649708,2797.95380131742,21,46
"912343751",47,2921.19134516292,2904.43480825312,2602.36394728806,18,29
"912343752",54,3057.64104213977,2929.14969429181,2677.2712016452,23,31
"912343753",56,3053.13697496147,2984.12446685686,2697.24673169728,17,39
"912343754",49,2827.73593430664,2844.45075012958,2624.62502504328,15,34
"912343756",74,2535.18226364567,1741.60696185054,2855.36548874306,27,47
"912343757",47,2642.27024624191,2740.43199339119,2602.36394728806,17,30
"912343758",63,3086.09247215062,2756.64287371604,2762.96971264875,25,38
"912343759",53,3053.87121131255,2861.23103279329,2667.061866114,19,34
"912343760",43,2760.49037158445,2536.7616132377,2555.47878346624,11,32
"912343761",42,2595.24159322077,3053.27792768353,2543.21752514954,11,31
"912343762",37,2620.51484762402,3034.59518518411,2478.17471526668,9,28
"912343763",82,3135.19090455086,3541.26049561602,2915.91045786314,30,52
"912343764",84,2557.37431559319,2495.31743598604,2930.30814451558,26,58
"912343765",78,2270.28864281518,2940.33697625677,2886.25582696583,27,51
"912343766",76,2819.49820252371,2763.86230229448,2870.97236507783,26,50
"912343767",68,3161.85047133616,1991.97614864811,2806.43931339586,24,44
"912343768",68,3301.95729791496,4284.45585902227,2806.43931339586,22,46
"912343769",57,2699.44278046755,2114.21575225395,2707.02236739438,18,39
"912343770",77,3094.12779528057,2389.00977432564,2878.65357631343,24,53
"912343771",80,2615.61753628182,2404.80716644431,2901.2306171403,26,54
"912343772",73,2991.97907317162,2826.02137025992,2847.4358582506,25,48
"912343773",63,3190.47422695107,3226.01450335132,2762.96971264875,16,47
"912343774",63,3258.44581204241,2836.52333571657,2762.96971264875,22,41
"912343775",73,3566.12155764353,3260.76172641762,2847.4358582506,25,48
"912343776",75,3152.19380938904,2592.82539255981,2863.21031780169,24,51
"912343777",73,3308.63706870214,2470.39736128633,2847.4358582506,22,51
"912343778",85,2286.28972996728,1837.32307966015,2937.40494579778,23,62
"912343779",39,2537.22319154806,2497.85064830087,2504.98447234734,13,26
"912343780",45,2787.97361919629,2664.78522296909,2579.33597919865,17,28
"912343781",42,2805.50183803081,3014.61702239165,2543.21752514954,12,30
"912343782",38,2852.94268504647,2685.58072063466,2491.71993967651,15,23
"912343783",35,2683.53569709755,2377.81645479953,2450.1860183293,12,23
"912343784",46,2393.74496759778,2043.14210434104,2590.94954296761,17,29
"912343785",44,2718.12984809104,3114.81115798551,2567.51523707907,16,28
"912343786",44,2712.0658689028,1643.55295484811,2567.51523707907,13,31
"912343787",38,2470.61159331247,2468.54854548486,2491.71993967651,13,25
"912343788",31,2521.0704770622,2448.772203404,2390.15469389133,9,22
"912343789",47,2384.83213665274,2945.94559020183,2602.36394728806,16,31
"912343790",57,2382.21154907459,2003.78187740672,2707.02236739438,16,41
"912343791",58,2867.912010021,3361.77966794188,2716.66249357165,22,36
"912343792",57,2659.2601657745,3366.94177411518,2707.02236739438,22,35
"912343793",57,2603.64082190824,2287.36174084685,2707.02236739438,16,41
"912343794",61,2900.02243796906,3790.16678888857,2744.81051624266,24,37
"912343796",55,2802.96066202407,2348.86329377518,2687.33120998132,19,36
"912343797",57,3100.11497637267,3559.07409825548,2707.02236739438,17,40
"912343798",56,2838.65062024998,2547.85695199948,2697.24673169728,19,37
"912343799",54,2828.90939078478,2732.1908141263,2677.2712016452,18,36
"912343800",52,3244.05986782648,3311.69916304878,2656.6981055205,19,33
"912343801",67,2613.46771477203,1376.5545795627,2797.95380131742,23,44
"912343802",60,2949.90814871346,2198.52070978091,2735.5526890818,20,40
"912343803",65,3261.12591082331,2920.15680518286,2780.67589681985,19,46
"912343804",53,2543.85812233737,2222.4561757003,2667.061866114,18,35
"912343805",77,2577.71063339915,1920.88231710046,2878.65357631343,26,51
"912343806",45,2507.6426218906,2043.06222705041,2579.33597919865,14,31
"912343807",51,2767.84340680215,2366.73514350493,2646.17454577679,21,30
"912343808",55,2841.12966848139,2340.4633297075,2687.33120998132,23,32
"912343809",60,3385.09177999378,3242.80680330057,2735.5526890818,18,42
"912343810",63,3029.25021117832,3195.05558236658,2762.96971264875,25,38
"912343811",49,2736.91954362279,2733.94485186244,2624.62502504328,21,28
"912343812",66,2798.90276131182,3275.35630421071,2789.3669207067,23,43
"912343813",50,2653.6890702372,2521.3279762756,2635.48551585152,17,33
"912343814",28,2365.82293183851,2433.2422751386,2340.94327947849,7,21
"912343815",81,2962.56860369098,2412.21114268834,2908.60658576875,23,58
"912343816",83,2543.58892373337,1945.61604005289,2923.1438046077,27,56
"912343817",101,2843.29688056452,2445.26723796996,3042.80202352452,34,67
"912343818",68,2489.1862884013,2576.28586592982,2806.43931339586,25,43
"912343819",36,2483.15106749904,2326.07878881319,2464.33502634194,8,28
"912343820",8,1773.64401563916,1871.56778332711,1812.11073017574,2,6
"912343821",29,2203.11426558698,2385.89002354289,2357.79423966008,12,17
"912343823",25,2328.09836276065,2398.74562385933,2287.34065519221,9,16
"912343824",6,1789.968644101,1805.60749089029,1708.62817714657,2,4
"912343825",32,2129.20891239787,2024.10489330528,2405.71569249515,12,20
"912343826",39,2414.85418639778,2278.89249230739,2504.98447234734,13,26
"912343827",24,2101.72689473103,2168.90055117962,2268.33468283819,7,17
"912343828",9,1883.05491172377,1890.00696416707,1856.26587460569,3,6
"912343829",31,2361.55363224707,2040.82050047196,2390.15469389133,12,19
"912343830",24,2311.79527116739,2386.65139607541,2268.33468283819,8,16
"912343831",29,2242.5905398394,2376.61408263399,2357.79423966008,9,20
"912343843",29,2054.93399029705,1765.82588377348,2357.79423966008,4,25
"912343844",11,1781.96376830739,1881.81555742875,1933.98659929558,2,9
"912343845",24,1852.91684367524,1845.28035600418,2268.33468283819,3,21
"912343846",17,1923.24635902014,1693.95860972143,2113.95669457394,2,15
"912343847",20,2054.65513707461,2007.13896502325,2185.35845629437,2,18
"912343848",11,1830.31321051553,1772.49531305077,1933.98659929558,1,10
"912343849",21,1815.05472146546,1643.08005383479,2207.26116887512,4,17
"912343850",16,1831.3350536443,1470.60009205097,2087.92318348224,0,16
"912343851",20,1901.87242507235,1582.00367597435,2185.35845629437,2,18
"912343852",21,1895.35591279747,1497.31650500172,2207.26116887512,2,19
"912343853",12,1726.98770938573,1475.39067503171,1968.69006049611,0,12
"912343854",14,1685.7409920873,1243.49387544744,2031.70713799962,2,12
"912343855",23,2027.69568400579,1720.6952317156,2248.68783741607,5,18
"912343856",18,1836.06091249722,1628.83893279059,2138.79896507223,6,12
"912343857",29,2045.91456519522,1770.92483557845,2357.79423966008,5,24
"912343858",20,1858.33940500876,1890.88776213336,2185.35845629437,3,17
"912343859",33,1905.39050707565,1237.98856130044,2420.89448855093,5,28
"912343860",18,1839.57764027752,1622.03518485468,2138.79896507223,4,14
"912343861",24,1902.36048331866,1681.201792599,2268.33468283819,3,21
"912343862",18,1872.80564001168,1740.83164351655,2138.79896507223,2,16
"912343863",19,1895.40645573578,1767.23829837103,2162.56636020013,3,16
"912343864",15,1913.11368224911,1691.96251872157,2060.56118614118,3,12
"912343865",17,1955.83306646944,1748.30601411814,2113.95669457394,2,15
"912343866",18,1914.55214665444,1627.92210486457,2138.79896507223,3,15
"912343867",12,1847.82934322255,1733.01503291862,1968.69006049611,3,9
"912343868",17,1882.43767561261,1453.05252729233,2113.95669457394,3,14
"912343869",20,1927.99218658793,1551.97748503951,2185.35845629437,5,15
"912343870",15,1807.79150762373,1323.48520291636,2060.56118614118,1,14
"912343871",16,1845.35894995158,1441.02663142898,2087.92318348224,3,13
"912343872",8,1674.25415457163,1548.71906825789,1812.11073017574,1,7
"912343873",5,1602.87208940249,1557.10500710296,1646.12614877363,2,3
"912343874",7,1613.93027964504,1615.29808440239,1763.32076508842,2,5
"912343875",11,1781.9852348124,1712.67975965369,1933.98659929558,3,8
"912343876",10,1729.56876002609,1587.28247232418,1896.67490607898,3,7
"912343877",7,1625.95038667089,1580.26208492413,1763.32076508842,2,5
"912343878",3,1471.15207791048,1416.62672013708,1482.92019466158,2,1
"912343879",8,1693.41256660001,1709.51314254785,1812.11073017574,1,7
"912343880",20,1796.664059027,1328.69711767672,2185.35845629437,4,16
"912343881",21,1933.21693948535,1447.92584492779,2207.26116887512,4,17
"912343882",19,1825.83625534661,1283.08048540747,2162.56636020013,4,15
"912343883",18,1872.92939786575,1467.23329835739,2138.79896507223,3,15
"912343884",17,1872.55692567979,1457.9356166827,2113.95669457394,3,14
"912343885",13,1771.10253079083,1394.58301332433,2001.16379457045,1,12
"912343886",18,1898.04640251044,1490.81238098414,2138.79896507223,3,15
"912343887",17,1843.86246678595,1506.4871668247,2113.95669457394,3,14
"912343888",20,1860.8395929765,1528.1505425593,2185.35845629437,4,16
"912343889",16,1865.5988660592,1758.71522881184,2087.92318348224,3,13
"912343890",16,1878.32271044637,1745.91145290712,2087.92318348224,4,12
"912343891",13,1858.81095514505,1728.20525416973,2001.16379457045,4,9
"912343892",18,1926.50022552215,1405.69748795219,2138.79896507223,2,16
"912343893",17,1919.0245628414,1473.55692459732,2113.95669457394,3,14
"912343894",14,1894.66615391642,1629.8275846499,2031.70713799962,4,10
"912343895",16,1891.99513488171,1649.59068637023,2087.92318348224,3,13
"912343896",19,1891.5544653095,1616.67551456105,2162.56636020013,3,16
"912343897",17,1889.26504436532,1403.26826834055,2113.95669457394,3,14
"912343898",20,1904.58194935251,1419.0019262786,2185.35845629437,3,17
"912343899",17,1896.23610259483,1434.09792322645,2113.95669457394,3,14
"912343900",14,1822.6241607714,1529.37582491129,2031.70713799962,2,12
"912343901",14,1824.26876711988,1668.83857937503,2031.70713799962,4,10
"912343902",17,1788.7084106312,1654.38909838172,2113.95669457394,2,15
"912343903",10,1744.89848662582,1576.15549486775,1896.67490607898,2,8
"912343904",12,1755.91934997867,1749.64269616982,1968.69006049611,3,9
"912343905",12,1799.87956139129,1625.13103171042,1968.69006049611,3,9
"912343906",20,1896.59155383084,1680.49293876138,2185.35845629437,5,15
"912343907",12,1762.11359877164,1763.84652230358,1968.69006049611,3,9
"912343908",10,1729.37126566763,1531.27831352272,1896.67490607898,1,9
"912343909",19,1883.67371687385,1321.87627455153,2162.56636020013,2,17
"912343910",17,1779.50300048038,1246.72291523613,2113.95669457394,2,15
"912343911",15,1798.26274160221,1360.53688248254,2060.56118614118,2,13
"912343912",16,1831.26306055939,1493.18346920171,2087.92318348224,2,14
"912343913",13,1868.38876085439,1689.98651337363,2001.16379457045,2,11
"912343914",13,1824.46131157856,1666.23434586095,2001.16379457045,3,10
"912343915",14,1806.96315828723,1335.37782042293,2031.70713799962,1,13
"912343934",17,2015.5772080415,1996.55943952607,2113.95669457394,5,12
"912343935",10,1839.59013426292,1873.32357380715,1896.67490607898,0,10
"912343936",12,2030.93743719618,1967.47952761311,1968.69006049611,4,8
"912343945",20,2009.3297364088,1901.58612941608,2185.35845629437,3,17
"912343956",9,1680.25074088091,1480.81123043433,1856.26587460569,3,6
"912344074",8,1607.71271768695,1337.03200436753,1812.11073017574,1,7
"912344075",4,1475.57606540489,1419.20335080975,1572.73281143487,0,4
"912344076",5,1490.90902255619,1616.91490596453,1646.12614877363,1,4
"912344085",9,1591.28876338584,1183.37457002677,1856.26587460569,2,7
"912344086",12,1632.32545926921,1433.94395539686,1968.69006049611,3,9
"912344087",10,1621.16693735516,1411.34828490668,1896.67490607898,3,7
"912344095",3,1398.46704240366,1331.68462793534,1482.92019466158,1,2
"912344099",8,1638.70531745718,1458.25707185061,1812.11073017574,1,7
"912344100",10,1643.73996678937,1545.21470714675,1896.67490607898,0,10
"912344101",13,1680.41952614208,1503.37351865045,2001.16379457045,1,12
"912344102",14,1574.79026803415,1191.51311690214,2031.70713799962,0,14
"912344103",8,1655.17768273118,1576.59080922773,1812.11073017574,0,8
"912344104",1,1150.67276488192,1119.41771915963,1184.66451052022,1,0
"912344106",1,1150.67276488192,1097.05484533734,1184.66451052022,1,0
"912344107",1,1168.07761147649,1173.14249841464,1184.66451052022,1,0
"912344108",3,1377.17718976313,NA,1482.92019466158,1,2
"912344109",2,1310.95801905599,1289.79877935359,1364.97646362037,1,1
"912344110",12,1646.0702090724,1307.90947013014,1968.69006049611,0,12
"912344111",9,1630.07272271481,1406.33051080431,1856.26587460569,0,9
"912344112",8,1614.45551068786,1440.0338509605,1812.11073017574,0,8
"912344113",5,1533.40675714441,1386.84772846104,1646.12614877363,1,4
"912344114",9,1672.31837460676,1494.99261992988,1856.26587460569,5,4
"912344115",8,1655.00676084187,1476.73162230465,1812.11073017574,4,4
"912344116",11,1707.91355756274,1539.36178039012,1933.98659929558,5,6
"912344117",10,1735.57216870022,1511.60706709688,1896.67490607898,5,5
"912344118",10,1836.60736846985,1631.72685747246,1896.67490607898,3,7
"912344119",10,1897.10739218128,1948.7052878576,1896.67490607898,4,6
"912344120",10,1789.3203183806,1688.6503203099,1896.67490607898,3,7
"912344121",10,1836.2987776781,1732.84769405439,1896.67490607898,3,7
"912344122",11,1668.60722010163,1297.46277126575,1933.98659929558,0,11
"912344123",5,1554.23511163189,1408.70640858846,1646.12614877363,0,5
"912344124",10,1665.16562125903,1411.61944933709,1896.67490607898,0,10
"912344125",8,1628.33832355452,1472.68207162418,1812.11073017574,0,8
"912344126",9,1623.52141038176,1667.57441375627,1856.26587460569,6,3
"912344127",10,1819.79242894323,1671.58843384486,1896.67490607898,4,6
"912344128",9,1681.17707900758,1537.22476842965,1856.26587460569,4,5
"912344129",11,1744.25696336749,1627.34850946655,1933.98659929558,5,6
"912344130",14,1914.34327851659,1789.58380508833,2031.70713799962,5,9
"912344131",9,1743.1850702421,1685.60450324557,1856.26587460569,4,5
"912344132",8,1820.20807897428,1678.4754154034,1812.11073017574,2,6
"912344133",9,1758.02830494722,1685.75125578544,1856.26587460569,3,6
"912344134",2,1319.99049277353,1364.97646362037,1364.97646362037,2,0
"912344136",2,1310.95801905599,1264.03216259816,1364.97646362037,1,1
"912344138",1,1150.67276488192,1130.43703863445,1184.66451052022,1,0
"912344139",3,1382.12537714648,1453.2955454943,1482.92019466158,1,2
"912344140",22,1973.56686330151,1563.21228782672,2228.3491786518,5,17
"912344142",24,1879.90907758618,1341.58169321158,2268.33468283819,5,19
"912344143",24,1951.87131227068,1582.40118562279,2268.33468283819,7,17
"912344144",9,1679.03409111891,1455.30635507405,1856.26587460569,2,7
"912344145",19,1835.8970512269,1439.27395304989,2162.56636020013,4,15
"912344146",15,1834.86902244234,1585.47234823889,2060.56118614118,3,12
"912344147",15,1799.99856362799,1437.4029791535,2060.56118614118,4,11
"912344149",19,1857.04463000875,1587.60369297613,2162.56636020013,3,16
"912344150",7,1671.34530449318,1629.48479897972,1763.32076508842,2,5
"912344151",17,1850.20408812092,1464.65561695973,2113.95669457394,4,13
"912344152",13,1780.4840966259,1465.19306299925,2001.16379457045,2,11
"912344153",11,1815.59815787117,1906.23167145638,1933.98659929558,3,8
"912344154",10,1806.91782021274,1845.96287807651,1896.67490607898,4,6
"912344155",3,1482.43247679265,1564.17563181492,1482.92019466158,0,3
"912344156",1,1199.87616926906,1241.75421342509,1184.66451052022,0,1
"912344157",4,1541.93169217737,1634.5752436846,1572.73281143487,0,4
"912344158",5,1628.43730721309,1699.93118251423,1646.12614877363,1,4
"912344159",13,1888.73539885805,1859.32019451448,2001.16379457045,4,9
"912344160",12,1877.83687577147,1849.60573758793,1968.69006049611,4,8
"912344161",15,1837.94717100655,1630.26697085148,2060.56118614118,4,11
"912344162",12,1828.4123332121,1770.86882012788,1968.69006049611,3,9
"912344163",13,1819.84188048662,1679.74396682287,2001.16379457045,6,7
"912344164",36,2500.003062435,2703.11188147206,2464.33502634194,6,30
"912344165",42,2672.73558747452,2799.79022715866,2543.21752514954,4,38
"912344166",51,2499.13055525048,2666.50685105636,2646.17454577679,14,37
"912344168",48,2888.75442104299,2923.7918914165,2613.58673801098,14,34
"912344169",55,2964.53218378795,3537.77204973333,2687.33120998132,19,36
"912344170",43,3141.63423800487,3383.34635642375,2555.47878346624,13,30
"912344171",37,2773.88344164766,3146.55686685309,2478.17471526668,11,26
"912344172",37,3227.44279963782,3314.77123027644,2478.17471526668,14,23
"912344173",57,3125.45920342895,3212.45318243526,2707.02236739438,22,35
"912344174",52,3181.86288479035,3199.68785499839,2656.6981055205,20,32
"912344175",35,2669.42053220263,3042.35736061654,2450.1860183293,8,27
"912344176",33,2759.81841581187,2870.77185298957,2420.89448855093,8,25
"912344177",40,2306.69246780916,2146.99722714722,2517.98110851286,11,29
"912344178",42,2406.38528639042,2459.42600991493,2543.21752514954,12,30
"912344179",66,3413.80227132402,3193.99842960046,2789.3669207067,23,43
"912344180",55,2812.03207876189,2645.66246826927,2687.33120998132,18,37
"912344181",55,2952.52472229273,2795.19893906404,2687.33120998132,18,37
"912344182",60,2632.55809219616,2082.96041642272,2735.5526890818,20,40
"912344183",53,2796.25984704403,2352.93837783084,2667.061866114,17,36
"912344184",63,3388.90804989151,3081.97698004024,2762.96971264875,24,39
"912344185",56,2686.41375823568,2886.74697911984,2697.24673169728,16,40
"912344186",65,2542.16126870778,2689.84888934838,2780.67589681985,18,47
"912344187",52,3030.08428412823,3021.11777710624,2656.6981055205,16,36
"912344188",40,2758.84796387496,2991.26136663175,2517.98110851286,12,28
"912344189",62,3039.62663022593,2456.00235933874,2753.94837323248,22,40
"912344190",59,2695.64119100874,2239.95158394959,2726.17127719361,19,40
"912344191",82,3145.29756039419,3470.12099093349,2915.91045786314,25,57
"912344192",51,2760.51101211544,2262.0267567576,2646.17454577679,16,35
"912344193",64,3140.07901479483,2719.62927152862,2771.87783482774,20,44
"912344194",46,2603.39592223344,2803.16269239308,2590.94954296761,16,30
"912344195",46,2881.43344482111,2902.63840870894,2590.94954296761,17,29
"912344196",61,3182.42960456199,2743.25552773615,2744.81051624266,16,45
"912344197",69,2845.13153953291,2682.28843877905,2814.82611826518,23,46
"912344199",51,2933.17235065457,2944.76141234036,2646.17454577679,16,35
"912344200",54,2839.52456782352,3178.28179215596,2677.2712016452,13,41
"912344201",63,2862.68151244775,3100.04442255341,2762.96971264875,15,48
"912344202",56,2768.6249554307,2804.35607060831,2697.24673169728,14,42
"912344203",49,2900.29812322108,2545.37905533817,2624.62502504328,16,33
"912344205",62,3518.72560155548,3374.06575056208,2753.94837323248,19,43
"912344206",57,3221.37405435302,2750.65757035095,2707.02236739438,18,39
"912344207",46,2725.17750590297,2894.95014603629,2590.94954296761,16,30
"912344208",40,2740.50525149434,3280.50991463221,2517.98110851286,11,29
"912344209",44,2766.06187901292,2798.30723532681,2567.51523707907,12,32
"912344210",56,2682.97773453982,3396.4064523401,2697.24673169728,14,42
"912344211",47,2988.03776828721,3240.77946381488,2602.36394728806,16,31
"912344212",65,3370.68711627388,4195.94650210813,2780.67589681985,24,41
"912344213",61,3728.3763945473,3403.89221710191,2744.81051624266,18,43
"912344214",68,3641.91583409655,3716.21585249504,2806.43931339586,24,44
"912344215",73,3322.49720730998,5007.2305202492,2847.4358582506,24,49
"912344216",68,3306.87311545296,4235.96323009143,2806.43931339586,18,50
"912344217",56,3092.22557849433,3664.62215428959,2697.24673169728,19,37
"912344218",52,3033.68473761256,3773.50563222967,2656.6981055205,15,37
"912344219",48,3081.71490287133,3514.13090110466,2613.58673801098,15,33
"912344220",46,2872.10082874828,3357.67987250644,2590.94954296761,18,28
"912344221",54,3089.336623233,2634.54133039788,2677.2712016452,15,39
"912344222",55,2991.62601480541,2672.64759125118,2687.33120998132,17,38
"912344223",45,2751.05995366197,3315.30294061053,2579.33597919865,11,34
"912344224",52,2816.01505495752,3136.53138974704,2656.6981055205,15,37
"912344225",48,2949.98639446092,2698.29177452928,2613.58673801098,17,31
"912344226",56,2684.53780528799,2524.00688710562,2697.24673169728,20,36
"912344227",57,3319.17588540304,3254.11437511749,2707.02236739438,14,43
"912344228",77,3231.27487856823,2396.21488333654,2878.65357631343,25,52
"912344229",47,3003.01189487197,2675.81069729134,2602.36394728806,13,34
"912344230",58,3173.81631586501,2636.57938967807,2716.66249357165,17,41
"912344231",54,3437.42566922348,3465.79700575229,2677.2712016452,14,40
"912344232",56,3299.34970318177,3493.69515638037,2697.24673169728,17,39
"912344233",51,2817.14191010396,2584.16683978183,2646.17454577679,20,31
"912344234",63,3088.9461313884,2704.8298039973,2762.96971264875,17,46
"912344235",59,2621.81062426605,1787.22373813863,2726.17127719361,18,41
"912344236",49,2532.00888352759,2580.63036999466,2624.62502504328,15,34
"912344238",61,3387.42544258053,2824.00861265254,2744.81051624266,19,42
"912344239",61,3105.60499488413,2860.90806758777,2744.81051624266,19,42
"912344240",56,3088.62647332949,3139.57804690542,2697.24673169728,18,38
"912344241",69,3601.33826666947,3514.26348704351,2814.82611826518,22,47
"912344242",66,2746.46641968286,2650.99732736214,2789.3669207067,21,45
"912344243",58,2988.59007336147,2391.27424162178,2716.66249357165,20,38
"912344244",75,2779.16310753242,2782.83025874248,2863.21031780169,18,57
"912344245",55,3156.04553136663,4027.9309456408,2687.33120998132,18,37
"912344246",66,3557.87067692811,3939.66373819462,2789.3669207067,22,44
"912344247",51,3133.84484230792,3774.05696757663,2646.17454577679,13,38
"912344248",43,2942.23964205024,3347.78825860613,2555.47878346624,13,30
"912344249",45,2429.76897853031,2586.9106478944,2579.33597919865,12,33
"912344250",36,2580.49759827917,3027.11509182002,2464.33502634194,12,24
"912344251",43,2554.42933677769,2643.35070955302,2555.47878346624,16,27
"912344252",39,2758.09133084796,2824.93284984057,2504.98447234734,15,24
"912344253",45,2788.01169507466,2680.67729862532,2579.33597919865,15,30
"912344254",44,2789.89286472644,2781.16945456958,2567.51523707907,12,32
"912344255",45,2618.99780353354,2919.22705982816,2579.33597919865,11,34
"912344256",39,2128.60745420961,2154.61671818857,2504.98447234734,8,31
"912344257",40,2500.28089351407,2541.14550608938,2517.98110851286,9,31
"912344258",48,2431.26309244969,2496.85857810122,2613.58673801098,16,32
"912344259",40,2459.26188237724,2401.34808980734,2517.98110851286,10,30
"912344260",57,2934.21695141447,3007.65181562841,2707.02236739438,20,37
"912344261",44,2664.73300513882,2670.75895908191,2567.51523707907,13,31
"912344262",56,2836.81978812218,2847.4087656189,2697.24673169728,17,39
"912344263",70,3103.13578210151,3051.07797895499,2823.11677003184,20,50
"912344264",49,2789.65553214361,3791.76182190087,2624.62502504328,11,38
"912344265",46,2921.37614121148,3649.32534047282,2590.94954296761,14,32
"912344266",62,2960.61584357976,2647.36813965551,2753.94837323248,20,42
"912344267",66,3156.1274142271,2686.57582471954,2789.3669207067,20,46
"912344268",47,3099.84974138422,3934.64685938878,2602.36394728806,14,33
"912344269",11,1883.60579701239,1824.47036903096,1933.98659929558,3,8
"912344270",37,2344.54665873479,2221.47996136738,2478.17471526668,12,25
"912344271",31,2360.56212470963,2293.77941983281,2390.15469389133,12,19
"912344272",13,1971.44806574219,1907.04316190107,2001.16379457045,6,7
"912344273",37,2257.61661396688,1742.31985041243,2478.17471526668,12,25
"912344274",43,2479.80038327655,1918.07438217969,2555.47878346624,11,32
"912344275",28,2207.76518255226,2024.10866881056,2340.94327947849,10,18
"912344277",36,2537.51144408703,2090.91531939243,2464.33502634194,13,23
"912344278",20,1945.34560489317,1849.40928962625,2185.35845629437,8,12
"912344279",14,1789.33271605151,1720.51466837114,2031.70713799962,4,10
"912344280",6,1691.82915144165,1640.56045272012,1708.62817714657,3,3
"912344281",10,1819.86494704156,1735.86073935611,1896.67490607898,3,7
"912344282",23,2424.66765381926,2233.93220189031,2248.68783741607,8,15
"912344283",29,2118.24862449984,1969.06774143523,2357.79423966008,9,20
"912344284",29,2285.82558267193,2256.59157708255,2357.79423966008,8,21
"912344285",4,1537.42941526474,1536.83760466044,1572.73281143487,0,4
"912344286",27,2178.78781868397,2219.85906968982,2323.60649590586,9,18
"912344287",31,2315.65354731338,2207.41653813018,2390.15469389133,10,21
"912344288",42,2082.03194091773,1838.32764467757,2543.21752514954,13,29
"912344289",36,2050.08882804269,1618.20207178242,2464.33502634194,10,26
"912344290",43,2258.59066536116,1909.57875803236,2555.47878346624,13,30
"912344291",43,2116.06734392766,1807.23695124026,2555.47878346624,13,30
"912344292",34,1908.34114580932,1602.01914447214,2435.71163614839,15,19
"912344293",40,2369.80592482761,2147.27454951689,2517.98110851286,15,25
"912344294",34,2171.82097996129,1693.76985593297,2435.71163614839,14,20
"912344295",42,2256.57169965862,1678.89451411829,2543.21752514954,17,25
"912344296",55,2034.2145407618,1793.02840684704,2687.33120998132,18,37
"912344297",51,2277.43090882885,2025.02364585105,2646.17454577679,23,28
"912344298",48,2297.69320375999,1706.19523390244,2613.58673801098,19,29
"912344299",43,2152.0377861687,1858.21952334642,2555.47878346624,16,27
"912344300",36,2266.00818048819,2264.26229294207,2464.33502634194,12,24
"912344301",30,2175.52151671064,1970.04535109057,2374.18906024059,11,19
"912344304",55,2182.76570869523,1522.84162454521,2687.33120998132,23,32
"912344305",49,2104.2278943124,1567.72378225626,2624.62502504328,20,29
"912344306",40,2132.57712366109,1733.45862809749,2517.98110851286,14,26
"912344307",42,2263.7534373504,1883.17199862489,2543.21752514954,14,28
"912344308",34,2269.97917681757,2335.59751751187,2435.71163614839,12,22
"912344309",43,2280.78160878224,2149.28154293488,2555.47878346624,14,29
"912344310",31,2255.4509432048,2285.40110113042,2390.15469389133,10,21
"912344311",30,2350.94954632311,2264.53885535929,2374.18906024059,12,18
"912344312",43,2230.94898325639,1753.05917727785,2555.47878346624,18,25
"912344313",38,2216.99763872977,1839.33991669631,2491.71993967651,18,20
"912344314",31,2371.03581081828,2171.05557251417,2390.15469389133,11,20
"912344315",51,2050.92197636113,1456.65775653547,2646.17454577679,23,28
"912344316",72,2462.53436057631,1493.95241135898,2839.4193288992,26,46
"912344317",57,2489.94580505897,1743.36868252581,2707.02236739438,24,33
"912344318",39,2210.50213490776,2389.45677294313,2504.98447234734,13,26
"912344319",38,2264.75732484055,2192.26961660719,2491.71993967651,15,23
"912344320",55,2490.36159899725,2167.6860991076,2687.33120998132,20,35
"912344321",54,2342.19558524729,1771.67420101419,2677.2712016452,19,35
"912344322",41,2538.82102431273,2667.68813828996,2530.72175773865,17,24
"912344323",59,2603.84376013257,2346.07233809822,2726.17127719361,23,36
"912344324",55,2718.60456524282,2231.64134370783,2687.33120998132,21,34
"912344325",46,2665.97457411512,2338.76547461169,2590.94954296761,18,28
"912344326",41,2876.38268838298,3006.87993373125,2530.72175773865,18,23
"912344327",21,2142.75076485977,2013.12869962207,2207.26116887512,10,11
"912344328",63,2606.53054791577,2230.66872675946,2762.96971264875,27,36
"912344329",57,2616.66178909576,2462.2269399184,2707.02236739438,23,34
"912344330",36,2524.6872567732,2514.61499799111,2464.33502634194,14,22
"912344331",33,2529.47081462059,2838.48624714923,2420.89448855093,17,16
"912344332",36,2347.56254606034,1861.14931961433,2464.33502634194,10,26
"912344333",48,2521.12970430088,1980.98052667044,2613.58673801098,21,27
"912344334",45,2737.90700092331,2349.55186051404,2579.33597919865,22,23
"912344335",52,2442.01886528156,1959.08782206963,2656.6981055205,22,30
"912344336",52,2528.31582102527,2386.75869850452,2656.6981055205,21,31
"912344337",49,2345.53160372505,2050.93089638151,2624.62502504328,20,29
"912344338",59,2514.97509540037,2129.60925617069,2726.17127719361,25,34
"912344339",47,2802.48415332873,2400.83592241966,2602.36394728806,18,29
"912344340",77,2580.12002327414,1794.63231329164,2878.65357631343,29,48
"912344341",58,2829.55285236648,2758.43682677381,2716.66249357165,22,36
"912344342",48,2566.13251330744,2583.56793917823,2613.58673801098,18,30
"912344343",38,2651.59681888705,2818.63121122456,2491.71993967651,14,24
"912344344",64,2658.97565734298,2284.68600183789,2771.87783482774,26,38
"912344345",61,2741.30154216222,2611.2497041682,2744.81051624266,21,40
"912344346",58,2534.99604463845,2082.72227488347,2716.66249357165,20,38
"912344347",57,2628.97744993466,2298.1289771956,2707.02236739438,19,38
"912344348",33,2302.89302453764,2311.82214642188,2420.89448855093,10,23
"912344349",47,2564.21335006343,2796.33121053821,2602.36394728806,19,28
"912344350",51,2396.01334472728,1987.98480028334,2646.17454577679,19,32
"912344351",59,2415.28618579527,2145.29161856643,2726.17127719361,22,37
"912344352",45,2817.53062864218,2810.9610151218,2579.33597919865,19,26
"912344353",59,2746.49417972433,2190.56402466463,2726.17127719361,23,36
"912344354",27,2253.8319717309,2160.33751327118,2323.60649590586,14,13
"912344355",26,2152.7566824863,1855.49314847619,2305.75108410937,10,16
"912344356",26,2295.8754888774,2442.39412524261,2305.75108410937,10,16
"912344357",49,2547.30369839543,2283.03417951817,2624.62502504328,20,29
"912344358",65,2236.65945470267,1714.40940832618,2780.67589681985,24,41
"912344359",65,2576.34032193951,1695.86300391565,2780.67589681985,27,38
"912344360",67,2350.01144458271,1321.69423370227,2797.95380131742,22,45
"912344361",76,2069.48645379865,1228.05773406512,2870.97236507783,23,53
"912344362",31,2419.70944807647,2252.27148482764,2390.15469389133,9,22
"912344363",33,2531.73346963039,2406.64814849297,2420.89448855093,12,21
"912344364",51,2304.59911286856,2079.77794611534,2646.17454577679,18,33
"912344365",52,2287.39713584317,1853.98817679162,2656.6981055205,17,35
"912344366",54,2166.69461539037,928.824109086273,2677.2712016452,19,35
"912344367",52,2026.43823640256,1633.44142531852,2656.6981055205,16,36
"912344368",41,2361.12177945991,1805.45193546859,2530.72175773865,17,24
"912344369",36,2202.78743266675,1753.13943841403,2464.33502634194,11,25
"912344370",35,1967.28942732132,1223.72870634775,2450.1860183293,10,25
"912344371",26,1984.79121388981,1759.209166199,2305.75108410937,7,19
"912344372",29,2012.8806990438,1794.18913351978,2357.79423966008,10,19
"912344373",63,2870.81305498142,3682.52373025318,2762.96971264875,25,38
"912344374",62,2947.18378050822,3735.73813328273,2753.94837323248,26,36
"912344375",72,2784.77894700891,3263.68979732593,2839.4193288992,30,42
"912344376",74,3184.44339742484,3797.9406804463,2855.36548874306,32,42
"912344377",55,2750.22122279551,3250.50091795028,2687.33120998132,23,32
"912344378",47,2589.53034032254,2923.05468874914,2602.36394728806,20,27
"912344379",14,1883.15877034878,1649.91914982762,2031.70713799962,5,9
"912344380",4,1583.10480357965,1510.44455873387,1572.73281143487,2,2
"912344381",16,1855.46036234617,1474.32237591689,2087.92318348224,7,9
"912344382",23,2141.82234597883,1859.06718603105,2248.68783741607,9,14
"912344383",17,1901.06434857235,1702.62444052648,2113.95669457394,6,11
"912344384",20,1904.99311067658,1771.09388165109,2185.35845629437,7,13
"912344404",23,1913.4984759848,1324.59968720214,2248.68783741607,6,17
"912344406",12,1874.95516026757,1766.72168801148,1968.69006049611,3,9
"912344416",25,1904.98072315151,1602.26933208469,2287.34065519221,5,20
"912344426",14,1847.86337212527,1582.01299950947,2031.70713799962,4,10
"912344434",27,1876.30209814289,1551.08545286621,2323.60649590586,6,21
"912344437",18,1936.04175366466,1580.35832972656,2138.79896507223,6,12
"912344439",17,1963.98535004347,1900.89142494351,2113.95669457394,7,10
"912344440",30,2075.48451958354,1910.25220517478,2374.18906024059,9,21
"912344443",23,1817.72960628091,1450.6533134826,2248.68783741607,5,18
"912344446",29,2077.20803477457,1624.51130461226,2357.79423966008,11,18
"912344447",45,2230.44856411168,2082.13268607567,2579.33597919865,10,35
"912344452",40,1984.10511393905,1448.93468033795,2517.98110851286,10,30
"912344464",89,3249.0190854435,2089.68320370355,2965.14449011489,29,60
"912344467",109,3156.22078988562,1909.09694432107,3090.58221916578,33,76
"912344468",51,2541.31711335022,2724.77495970334,2646.17454577679,17,34
"912344469",43,2738.44612196094,3258.42113965326,2555.47878346624,15,28
"912344470",21,2161.91721281202,2113.40023298104,2207.26116887512,9,12
"912344471",96,2717.69462159954,2242.29660723819,3011.38790884243,31,65
"912344472",67,2427.34645829288,1759.76428609439,2797.95380131742,26,41
"912344473",86,2771.66546707861,1413.74358831893,2944.43562859908,28,58
"912344474",87,3516.83895227301,2414.98313639543,2951.40156710974,29,58
"912344475",87,3022.8772535946,1999.76319796623,2951.40156710974,24,63
"912344476",118,2825.63551381604,1842.41014046371,3141.10838648581,37,81
"912344477",103,2623.55111882223,1981.48426924917,3055.02181112984,30,73
"912344479",72,3021.96982874549,3038.5663325662,2839.4193288992,18,54
"912344480",96,2982.87859794267,1732.04230808942,3011.38790884243,25,71
"912344481",84,3074.09025933248,1688.18995109574,2930.30814451558,26,58
"912344482",119,2944.89224444889,1942.01390247063,3146.53110896604,35,84
"912344483",90,3109.64987852225,1870.97646156908,2971.92401064611,25,65
"912344484",86,2959.15045017961,1967.04892100425,2944.43562859908,31,55
"912344485",77,3222.80379567313,2637.14375099103,2878.65357631343,28,49
"912344486",101,3865.18259195727,3082.49756582722,3042.80202352452,32,69
"912344488",86,2784.58692008326,1855.12324240622,2944.43562859908,30,56
"912344489",78,2411.84790876654,1958.82570419467,2886.25582696583,20,58
"912344490",95,3235.63325519628,1788.83236170971,3004.94950458202,32,63
"912344491",76,2860.29611601774,2039.9087071224,2870.97236507783,20,56
"912344492",72,3275.04314039402,2266.42917047488,2839.4193288992,19,53
"912344493",92,3031.25818490619,2548.11497501032,2985.30521778333,27,65
"912344494",94,2888.40949550724,2655.99256380889,2998.45695239283,35,59
"912344495",68,3051.15009074703,3250.51870350487,2806.43931339586,25,43
"912344496",73,2566.52954587992,1611.8042432093,2847.4358582506,22,51
"912344497",96,2901.5728529609,1534.82636416901,3011.38790884243,29,67
"912344499",107,2763.28463960962,2693.4532243918,3078.90571391637,36,71
"912344500",56,2981.09289305403,2659.62356712001,2697.24673169728,15,41
"912344501",106,2786.7715469118,1354.16353421642,3073.00222293854,30,76
"912344502",92,3215.92136255311,2947.35293121861,2985.30521778333,27,65
"912344503",86,3273.95557105116,2433.82644168507,2944.43562859908,22,64
"912344504",57,1819.77207831099,1481.50107233862,2707.02236739438,18,39
"912344505",59,2000.34483728323,1116.13742461144,2726.17127719361,20,39
"912344506",90,2780.1481896666,1837.36986839599,2971.92401064611,36,54
"912344507",71,2576.50398289673,2279.52353417569,2831.31372136695,26,45
"912344508",82,3062.74900388226,2459.99367153698,2915.91045786314,29,53
"912344509",74,2948.75002336293,1936.25684411464,2855.36548874306,26,48
"912344511",88,3216.13811472694,1798.51526046155,2958.30409156145,29,59
"912344513",99,2511.13040755188,1872.09474184352,3030.38817685238,30,69
"912344514",123,2615.15116398421,2176.60931602613,3167.86598086922,35,88
"912344515",83,2974.45942630193,2747.37592740825,2923.1438046077,31,52
"912344516",76,3088.53641860324,2587.26034882538,2870.97236507783,25,51
"912344517",97,3685.59286229702,2763.61334185882,3017.77317381863,25,72
"912344519",71,2604.64925638221,2188.95259249384,2831.31372136695,22,49
"912344522",119,3199.47424998565,1224.12753963209,3146.53110896604,37,82
"912344524",103,3111.70949797709,1850.70898291846,3055.02181112984,32,71
"912344525",105,3675.06645155356,2673.27970231837,3067.05425459434,34,71
"912344526",102,3247.96916481451,2578.4249091994,3048.93574640007,38,64
"912344528",100,2709.5414763128,2162.28084976315,3036.61979185145,28,72
"912344529",61,2372.27214928107,2227.77986049189,2744.81051624266,13,48
"912344530",54,2480.53019561698,2509.50270937903,2677.2712016452,15,39
"912344531",36,2364.99777676542,2520.85539929258,2464.33502634194,10,26
"912344532",42,2591.23435308537,2580.26598583242,2543.21752514954,16,26
"912344533",51,2919.04886670745,2548.30865325044,2646.17454577679,12,39
"912344534",44,2410.8255490552,2098.31401719848,2567.51523707907,15,29
"912344535",58,2739.59580248121,2201.17087952216,2716.66249357165,21,37
"912344537",29,2331.31894742423,2253.16532905094,2357.79423966008,10,19
"912344538",49,2459.88602662176,1902.92323978131,2624.62502504328,17,32
"912344539",59,2575.10598885837,2424.50176935908,2726.17127719361,21,38
"912344540",54,2192.42742251958,2043.54090299503,2677.2712016452,14,40
"912344541",51,2263.54031797706,1725.39851165805,2646.17454577679,13,38
"912344542",32,2260.13697069249,2137.60331897072,2405.71569249515,14,18
"912344543",56,2628.6863775426,2573.48958993867,2697.24673169728,22,34
"912344544",51,3025.94920508139,3254.77669954388,2646.17454577679,17,34
"912344545",57,2833.16541872426,2452.97378446793,2707.02236739438,18,39
"912344546",62,2999.31128373393,3625.19822955863,2753.94837323248,25,37
"912344547",60,2530.43158224877,2350.49762745502,2735.5526890818,18,42
"912344548",52,2758.20564362462,2411.94559266966,2656.6981055205,21,31
"912344549",50,2990.04146391849,3124.30065242229,2635.48551585152,20,30
"912344550",34,2066.98352824615,1900.36317855528,2435.71163614839,8,26
"912344551",45,2224.4534431909,2212.40645882514,2579.33597919865,14,31
"912344552",21,1744.40355981709,1082.7492540889,2207.26116887512,2,19
"912344553",24,2201.72002447059,1907.69262503047,2268.33468283819,5,19
"912344554",19,1960.28718110011,1892.950416679,2162.56636020013,5,14
"912344555",31,2270.5094965516,2164.36166996292,2390.15469389133,10,21
"912344556",25,2406.81271823373,2286.10620138174,2287.34065519221,8,17
"912344557",27,2393.26612570038,2315.19539853854,2323.60649590586,6,21
"912344558",26,2264.38268523708,2190.87859623749,2305.75108410937,3,23
"912344559",25,2230.75053167377,2145.16806528713,2287.34065519221,4,21
"912344560",24,1918.19062649456,1599.65634573662,2268.33468283819,6,18
"912344561",22,2005.85614168061,2003.05827583467,2228.3491786518,5,17
"912344562",23,2113.77432613436,1571.91949373539,2248.68783741607,7,16
"912344563",20,2004.93404279148,1815.28472004708,2185.35845629437,4,16
"912344564",20,1972.64539279189,1536.35714279331,2185.35845629437,5,15
"912344565",26,2029.9646947591,1839.87400932526,2305.75108410937,8,18
"912344566",22,2117.20178324353,1685.80596554355,2228.3491786518,7,15
"912344567",19,2011.6307761437,1976.34173361219,2162.56636020013,4,15
"912344568",28,2094.29698127819,1873.25988698357,2340.94327947849,7,21
"912344569",22,2036.6296176056,2336.99867745871,2228.3491786518,4,18
"912344570",27,2442.51270952546,2367.22009113081,2323.60649590586,6,21
"912344571",27,2204.99865305164,1795.42128534254,2323.60649590586,3,24
"912344572",31,2448.56907405194,2325.95021887096,2390.15469389133,9,22
"912344574",139,3044.46019197373,947.747214041134,3248.04687922572,47,92
"912344576",70,2679.31410583709,1947.476574512,2823.11677003184,24,46
"912344583",12,1801.77001906763,1802.05911155332,1968.69006049611,4,8
"912344584",15,1809.8876173465,1591.08085700465,2060.56118614118,4,11
"912344585",16,1744.47205718319,1389.98070210414,2087.92318348224,4,12
"912344586",17,1782.58879083287,1462.25600376377,2113.95669457394,5,12
"912344587",12,1855.73539590478,2014.70168016059,1968.69006049611,4,8
"912344588",20,1759.99870255992,920.07475893536,2185.35845629437,5,15
"912344589",17,1761.43030085757,1671.47390925232,2113.95669457394,4,13
"912344590",11,1883.4289011011,1890.51464765442,1933.98659929558,3,8
"912344591",14,1752.69936815229,1362.15263797769,2031.70713799962,2,12
"912344592",19,1820.98711333515,1528.32635664988,2162.56636020013,4,15
"912344593",17,1869.35153877539,1766.99423364773,2113.95669457394,4,13
"912344594",17,1766.25089216714,1715.94743252012,2113.95669457394,3,14
"912344595",15,1682.46164820964,1460.07088506172,2060.56118614118,3,12
"912344596",14,1666.16085762572,1412.37477023953,2031.70713799962,3,11
"912344597",6,1588.95205145632,1484.92463732889,1708.62817714657,2,4
"912344598",11,1704.64232163625,1771.67600538035,1933.98659929558,2,9
"912344599",14,1733.14411319942,1559.23849278242,2031.70713799962,2,12
"912344600",14,1840.17560332323,1722.25360339119,2031.70713799962,3,11
"912344601",15,1797.1079029075,1889.44491421528,2060.56118614118,5,10
"912344602",13,1781.71720673829,1730.37307027637,2001.16379457045,3,10
"912344603",17,1697.96461703489,1316.92313375328,2113.95669457394,4,13
"912344604",11,1772.43085138947,1596.4379978643,1933.98659929558,3,8
"912344605",18,1777.50098823346,1404.536530844,2138.79896507223,4,14
"912344606",16,1836.28836365593,1656.25562828968,2087.92318348224,4,12
"912344610",3,1457.98289787004,1310.97913510883,1482.92019466158,0,3
"912344611",5,1521.60107383745,1458.81481814924,1646.12614877363,2,3
"912344613",4,1519.07121919174,1572.73281143487,1572.73281143487,1,3
"912344615",2,1329.39960247251,1364.97646362037,1364.97646362037,0,2
"912344616",6,1553.72416597775,1646.67127809561,1708.62817714657,3,3
"912344618",1,1158.1580747686,1184.66451052022,1184.66451052022,1,0
"912344621",1,1158.1580747686,1166.2279550584,1184.66451052022,1,0
"912344623",4,1504.71716026846,1428.65377165302,1572.73281143487,1,3
"912344624",2,1312.20988091708,1340.02077931755,1364.97646362037,2,0
"912344625",1,1158.1580747686,1137.59268953501,1184.66451052022,1,0
"912344632",3,1429.79819096952,1482.92019466158,1482.92019466158,2,1
"912344633",2,1342.49914198821,1284.35008681117,1364.97646362037,0,2
"912344634",4,1511.18573615525,1470.85025774305,1572.73281143487,2,2
"912344635",6,1545.93022092129,1410.06845881571,1708.62817714657,0,6
"912344640",5,1611.87179758888,1558.2434099925,1646.12614877363,2,3
"912344641",2,1297.55089769445,1282.34681965324,1364.97646362037,0,2
"912344642",6,1673.21390374495,1692.3022778347,1708.62817714657,2,4
"912344655",13,1913.74854218314,1861.46468363164,2001.16379457045,4,9
"912344657",17,1874.29305523154,1951.75223450891,2113.95669457394,3,14
"912344658",16,1942.66099019397,1870.76054058313,2087.92318348224,4,12
"912344663",24,1899.39869050567,1676.25325161237,2268.33468283819,6,18
"912344664",21,1825.15810533909,1775.96929627901,2207.26116887512,4,17
"912344667",18,2018.82587887719,1953.52143031146,2138.79896507223,4,14
"912344668",20,1927.96907826437,1683.12024040873,2185.35845629437,3,17
"912344671",11,1893.49688920588,1813.1117196185,1933.98659929558,3,8
"912344672",10,1851.87012099739,1894.77560632703,1896.67490607898,3,7
"912344673",22,1872.69420458602,1832.09564411004,2228.3491786518,5,17
"912344674",15,1928.58658470079,1985.26536147546,2060.56118614118,5,10
"912344679",16,1972.8507790812,1746.92533705172,2087.92318348224,5,11
"912344680",16,1849.54299081461,1834.8138461772,2087.92318348224,3,13
"912344681",19,1902.11925535559,1794.83071632801,2162.56636020013,3,16
"912344682",13,1876.72324487451,1775.58213762391,2001.16379457045,1,12
"912344687",21,1886.61261494239,1757.65446871163,2207.26116887512,5,16
"912344688",17,1987.58180655124,1747.3066700993,2113.95669457394,3,14
"912344689",19,1904.44222598265,1843.24147647891,2162.56636020013,4,15
"912344695",18,1921.25452401542,1600.45049791119,2138.79896507223,5,13
"912344696",15,1865.48144500927,1792.59933511063,2060.56118614118,4,11
"912344703",13,1869.5709578778,1731.4944688602,2001.16379457045,3,10
"912344704",16,1882.54571530383,1987.37556494617,2087.92318348224,5,11
"912344711",9,1843.08168786857,1928.12636336216,1856.26587460569,3,6
"912344712",17,1898.39808812701,2007.07298314022,2113.95669457394,4,13
"912344713",19,1979.30215584151,2001.7507866562,2162.56636020013,2,17
"912344714",17,1857.93461012992,1842.85604232502,2113.95669457394,1,16
"912344715",24,1799.9322670999,1581.55732708757,2268.33468283819,4,20
"912344716",23,1894.06577577614,1587.46414006446,2248.68783741607,6,17
"912344717",17,1897.63178882253,1782.65841961263,2113.95669457394,3,14
"912344718",17,1830.84813107255,1574.72404503004,2113.95669457394,2,15
"912344719",13,1831.78060150834,1510.96979398746,2001.16379457045,3,10
"912344720",16,1902.55441490053,1719.40407084132,2087.92318348224,3,13
"912344721",18,1900.81038290468,1525.63713483917,2138.79896507223,5,13
"912344722",17,1800.93999359917,1746.85896933841,2113.95669457394,3,14
"912344723",3,1469.25216534244,1449.58737164595,1482.92019466158,1,2
"912344725",3,1398.46704240366,1430.52780936639,1482.92019466158,1,2
"912344726",24,2366.72696363028,2544.67223280307,2268.33468283819,5,19
"912344727",16,1968.83330825917,1812.54224997125,2087.92318348224,3,13
"912344728",18,2050.32416497367,2086.84298211499,2138.79896507223,5,13
"912344729",16,2033.7896827418,1844.16646204894,2087.92318348224,3,13
"912344730",12,1875.40847933994,1677.53824325837,1968.69006049611,4,8
"912344731",12,1947.85727518075,1796.22067028014,1968.69006049611,4,8
"912344732",25,2297.05005355518,2030.12312127705,2287.34065519221,9,16
"912344733",22,2074.49092551991,2093.73820931394,2228.3491786518,6,16
"912344734",15,2078.25578860144,2244.19449111258,2060.56118614118,4,11
"912344735",21,2248.28353264687,2581.45775826358,2207.26116887512,3,18
"912344736",12,1826.26353770938,1496.82070712691,1968.69006049611,3,9
"912344737",23,2166.97429035777,1854.64744132292,2248.68783741607,7,16
"912344738",19,2065.97268766183,2120.6055033587,2162.56636020013,6,13
"912344739",17,1990.76000424935,1439.2661569879,2113.95669457394,4,13
"912344740",24,2064.25775646745,1952.30397493585,2268.33468283819,6,18
"912344741",18,1970.20248400545,2018.06541080263,2138.79896507223,5,13
"912344742",20,2150.22218646739,2082.09557303001,2185.35845629437,6,14
"912344743",20,2209.7266205524,2542.80288985674,2185.35845629437,5,15
"912344744",25,2316.73369520804,2257.10659915808,2287.34065519221,6,19
"912344745",16,2172.14639275836,2548.79060866411,2087.92318348224,4,12
"912344746",20,2153.94708679211,2394.64223236892,2185.35845629437,5,15
"912344748",15,1963.91537597324,1958.67093072461,2060.56118614118,2,13
"912344750",12,2117.89004190371,2432.62276381594,1968.69006049611,1,11
"912344751",16,2088.87742864482,2354.74595192004,2087.92318348224,5,11
"912344752",22,2392.66035866143,2124.07920837423,2228.3491786518,5,17
"912344753",12,1910.38646332877,1856.40020659947,1968.69006049611,3,9
"912344754",21,2098.77282935737,1965.90111364436,2207.26116887512,5,16
"912344756",21,1960.10278825745,1724.30287048587,2207.26116887512,6,15
"912344757",18,2087.75495400236,1798.83978844193,2138.79896507223,6,12
"912344758",9,1886.70374650032,1917.96001322006,1856.26587460569,3,6
"912344759",12,1907.75607583027,1909.62104095457,1968.69006049611,5,7
"912344763",17,1915.69547009418,1921.84326744989,2113.95669457394,4,13
"912344766",17,1915.69547009418,1921.84326744989,2113.95669457394,4,13
"912344771",7,1680.63455849308,1677.33953467699,1763.32076508842,2,5
"912344772",15,1938.95518081636,1858.26443642476,2060.56118614118,6,9
"912344773",10,1925.16124660036,1898.06889327627,1896.67490607898,2,8
"912344794",24,2121.69915210045,1888.96694814648,2268.33468283819,5,19
"912344795",26,2075.63852597243,1907.49451909957,2305.75108410937,4,22
"912344796",19,2094.84694298117,1858.34694763378,2162.56636020013,3,16
"912344797",22,2037.3914002892,2048.8219398873,2228.3491786518,3,19
"912344798",15,1953.87193204079,2017.91044067769,2060.56118614118,2,13
"912344799",12,1941.00633631845,2102.23629900926,1968.69006049611,2,10
"912344800",11,1762.91986224636,1717.72758566586,1933.98659929558,1,10
"912344801",19,1976.97703156043,1539.02700321324,2162.56636020013,3,16
"912344802",20,2026.89146735451,2195.45365774505,2185.35845629437,2,18
"912344803",19,1943.42877601609,2042.18794849316,2162.56636020013,2,17
"912344804",27,2021.11603191825,1807.37682496296,2323.60649590586,6,21
"912344805",23,2076.94334454711,1831.0871394545,2248.68783741607,5,18
"912344808",24,2066.36005784485,1933.49216933712,2268.33468283819,6,18
"912344809",16,1926.64251546259,1847.76302366932,2087.92318348224,2,14
"912344811",20,2165.06235489314,1903.01617732226,2185.35845629437,2,18
"912344812",20,2053.06455874879,2054.36617512703,2185.35845629437,4,16
"912344813",17,2031.67440958762,1849.98453458532,2113.95669457394,1,16
"912344814",18,1908.40580985146,1740.75385136246,2138.79896507223,3,15
"912344815",15,1922.3379714188,1938.62087631149,2060.56118614118,3,12
"912344816",17,1942.4580188561,1568.03242050385,2113.95669457394,3,14
"912344817",19,1983.85213568741,1929.80746632706,2162.56636020013,4,15
"912344818",21,2061.43206891254,2018.41892114266,2207.26116887512,7,14
"912344819",22,2141.45161203686,1773.81828159869,2228.3491786518,4,18
"912344820",15,2129.84563001557,1966.3925757666,2060.56118614118,3,12
"912344821",22,2107.22593075377,2171.32947001221,2228.3491786518,8,14
"912344822",21,2158.35115965285,1833.60774182986,2207.26116887512,3,18
"912344823",16,1990.75780601277,1918.85404331004,2087.92318348224,1,15
"912344826",20,2153.85739310764,1968.06581452962,2185.35845629437,2,18
"912344827",18,1987.02366075047,1772.19243153847,2138.79896507223,3,15
"912344828",16,1966.98279264966,1723.270687256,2087.92318348224,3,13
"912344829",20,1959.29063918142,1700.65687988546,2185.35845629437,5,15
"912344830",16,1888.44030278531,1589.65627543009,2087.92318348224,4,12
"912344831",17,1914.50342192577,1528.56393649247,2113.95669457394,4,13
"912344832",23,1874.07516054116,1267.55323852656,2248.68783741607,4,19
"912344835",23,1993.97623349264,1714.47841201857,2248.68783741607,4,19
"912344836",27,1976.01609426148,1711.63788165974,2323.60649590586,7,20
"912344838",22,2042.07117060607,1574.1738786978,2228.3491786518,5,17
"912344839",25,1894.71821256552,1484.32159092247,2287.34065519221,4,21
"912344840",23,1974.68920030534,1559.83030785942,2248.68783741607,4,19
"912344841",20,1914.00844381726,1687.86734140028,2185.35845629437,3,17
"912344842",18,1913.01687506158,1615.95844353899,2138.79896507223,3,15
"912344843",16,1869.52818734118,1656.05704527217,2087.92318348224,3,13
"912344844",12,1789.77054438435,1729.56199447036,1968.69006049611,2,10
"912344845",22,1861.13057118331,1466.9011870475,2228.3491786518,5,17
"912344846",22,1802.77302409283,1543.78625961563,2228.3491786518,3,19
"912344847",28,1973.01479484509,1548.35863494735,2340.94327947849,5,23
"912344848",24,1842.14147806179,1583.82092063068,2268.33468283819,5,19
"912344849",25,1876.41482600255,1237.97392293379,2287.34065519221,4,21
"912344851",16,1861.34171501311,1717.00626568378,2087.92318348224,3,13
"912344852",13,1938.09336123749,1861.4682115819,2001.16379457045,2,11
"912344853",24,1951.5037237841,1556.58019322623,2268.33468283819,4,20
"912344854",19,1957.48628715615,1715.46033232817,2162.56636020013,2,17
"912344855",26,1848.21998568708,1364.13759922234,2305.75108410937,4,22
"912344856",22,1856.14477177781,1606.32958415319,2228.3491786518,3,19
"912344857",21,1991.50373651173,1726.70885615641,2207.26116887512,5,16
"912344858",21,1950.4339942655,1506.37729149907,2207.26116887512,3,18
"912344859",18,1970.08059255046,1602.75509029156,2138.79896507223,4,14
"912344860",22,1993.35148913006,1618.92400051992,2228.3491786518,5,17
"912344861",20,1811.64255886175,1428.75078330802,2185.35845629437,3,17
"912344862",19,1886.99286700033,1668.95186885779,2162.56636020013,4,15
"912344863",19,1918.86210438572,1826.18179745369,2162.56636020013,3,16
"912344864",24,1889.27231462793,1780.80711285863,2268.33468283819,4,20
"912344865",19,1990.91243727261,2048.14479428623,2162.56636020013,2,17
"912344866",16,1880.30899310249,1892.20069269254,2087.92318348224,3,13
"912344867",18,1920.18312322236,1613.48869868688,2138.79896507223,2,16
"912344868",18,1977.36683515957,1638.43700051037,2138.79896507223,3,15
"912344889",42,2216.05071787797,2505.35050744842,2543.21752514954,17,25
"912344891",65,3044.9316889992,3961.99278959491,2780.67589681985,24,41
"912344892",46,2741.32572370325,3583.85988413047,2590.94954296761,19,27
"912344905",49,2975.09816274962,3228.60201392926,2624.62502504328,24,25
"912344906",52,2888.90378641606,4059.85631365243,2656.6981055205,19,33
"912344907",56,2751.51133518157,3269.11431352449,2697.24673169728,21,35
"912344913",37,2432.90790103445,2752.00303756644,2478.17471526668,17,20
"912344917",46,3073.34889850606,3545.09663528473,2590.94954296761,20,26
"912344920",39,2294.91223046719,2791.62596191214,2504.98447234734,15,24
"912344933",48,3042.30041610699,3513.53130811465,2613.58673801098,20,28
"912344939",35,2836.41065536949,3218.24935668464,2450.1860183293,13,22
"912344960",52,3175.90603415182,3583.74684007853,2656.6981055205,22,30
"912344970",82,3138.94336370821,3114.98246615266,2915.91045786314,29,53
"912344972",51,2764.45617122113,3118.78950249335,2646.17454577679,19,32
"912345003",6,1573.09427745459,1550.75492541564,1708.62817714657,0,6
"912345004",5,1526.1754038826,1475.83567347263,1646.12614877363,1,4
"912345005",4,1506.2659374016,1373.49388715788,1572.73281143487,0,4
"912345027",8,1720.40052991342,1711.59999601395,1812.11073017574,3,5
"912345033",23,2318.36256175185,2560.01000113823,2248.68783741607,4,19
"912345034",27,2365.36209993122,2446.41173663832,2323.60649590586,4,23
"912345035",23,2536.80150342274,2602.1531045936,2248.68783741607,6,17
"912345036",20,2407.67108851702,2529.51304832291,2185.35845629437,3,17
"912345037",31,2547.73698951345,2506.96493484647,2390.15469389133,7,24
"912345038",35,2539.88836857623,2839.65041265072,2450.1860183293,7,28
"912345041",15,1749.85010830874,1428.34220187802,2060.56118614118,4,11
"912345043",8,1573.82550277292,1471.75353884926,1812.11073017574,2,6
"912345044",19,1818.8222462227,1516.82343118151,2162.56636020013,3,16
"912345045",12,1740.23217220888,1725.16426923017,1968.69006049611,4,8
"912345046",7,1657.22221418631,1484.89469798327,1763.32076508842,3,4
"912345051",17,1834.71394281454,1664.55958850895,2113.95669457394,3,14
"912345073",9,1786.00022522722,1886.67740282597,1856.26587460569,1,8
"912345074",9,1826.04517173874,1676.88529233514,1856.26587460569,3,6
"912345080",8,1710.01468386461,1120.63096417899,1812.11073017574,1,7
"912345081",9,1830.79473376445,1848.00299448444,1856.26587460569,2,7
"912345082",9,1751.52480754401,1634.98907541119,1856.26587460569,2,7
"912345083",6,1649.96854874923,1664.28248176148,1708.62817714657,0,6
"912345084",7,1699.53342722344,1732.733963828,1763.32076508842,1,6
"912345091",9,1744.33554118839,1278.65591623189,1856.26587460569,1,8
"912345092",10,1751.85024442588,1518.50855372066,1896.67490607898,0,10
"912345093",7,1668.23134976139,1488.50863063012,1763.32076508842,1,6
"912345094",11,1786.01030809557,1544.89300401672,1933.98659929558,3,8
"912345095",14,1712.91524073003,1466.67538265855,2031.70713799962,0,14
"912345096",14,1707.37907162167,935.396842435293,2031.70713799962,2,12
"912345097",9,1747.80160274968,1804.50919652706,1856.26587460569,0,9
"912345098",6,1639.41403379284,1415.68144101058,1708.62817714657,0,6
"912345099",6,1712.91783101678,1757.71498449876,1708.62817714657,1,5
"912345100",8,1765.10479266041,1802.18019258006,1812.11073017574,2,6
"912345101",7,1662.38993155805,1569.2939715687,1763.32076508842,1,6
"912345102",12,1759.36405323632,1696.18623968844,1968.69006049611,2,10
"912345103",9,1725.52477577603,1566.79885029678,1856.26587460569,1,8
"912345104",8,1695.85535140601,1492.64005044122,1812.11073017574,2,6
"912345105",5,1637.68022633328,1728.24438172487,1646.12614877363,0,5
"912345106",5,1639.67142778817,1798.69342088452,1646.12614877363,0,5
"912345107",10,1786.01876151651,1860.10443670222,1896.67490607898,1,9
"912345108",12,1762.94992888529,1624.40754834016,1968.69006049611,3,9
"912345109",12,1787.46966342592,1581.49970531017,1968.69006049611,2,10
"912345110",7,1657.47881234254,1579.42246788147,1763.32076508842,1,6
"912345111",7,1701.66351839944,1782.05125983537,1763.32076508842,0,7
"912345112",5,1637.68022633328,1769.17585426959,1646.12614877363,0,5
"912345113",6,1653.8961533709,1617.12498245455,1708.62817714657,1,5
"912345114",5,1654.15582111192,1702.58151909476,1646.12614877363,1,4
"912345115",7,1768.26701377042,1944.31895059852,1763.32076508842,2,5
"912345116",11,1790.96340414969,1579.4593162839,1933.98659929558,3,8
"912345117",9,1720.58392318414,1576.83678830483,1856.26587460569,1,8
"912345118",7,1756.46334909791,1882.652055902,1763.32076508842,1,6
"912345119",7,1740.64920360142,1938.60052546859,1763.32076508842,1,6
"912345120",6,1555.10351702639,1358.51547438127,1708.62817714657,2,4
"912345121",4,1492.7202302652,1345.23312133636,1572.73281143487,1,3
"912345122",1,1171.73368704246,1086.71437887242,1184.66451052022,0,1
"912345123",4,1493.71864291705,1366.48073227559,1572.73281143487,0,4
"912345124",3,1435.6619444338,1305.67102858283,1482.92019466158,1,2
"912345126",11,1663.85483836435,1143.53437946622,1933.98659929558,2,9
"912345273",14,1898.71091992223,1893.71545468435,2031.70713799962,5,9
"912345280",10,1804.81396869298,1749.3115506178,1896.67490607898,5,5
"912345281",14,1825.05744241718,1770.37741042714,2031.70713799962,5,9
"912345282",14,1658.26826576094,1175.77660106258,2031.70713799962,3,11
"912345283",9,1793.91813116892,1705.9972044598,1856.26587460569,3,6
"912345284",13,1858.41795954094,1749.10015081607,2001.16379457045,5,8
"912345286",10,1787.79636183271,1804.5668787555,1896.67490607898,3,7
"912345360",48,2827.60184455976,2764.86341509635,2613.58673801098,17,31
"912345361",51,2677.00182554028,2661.91168244843,2646.17454577679,23,28
"912345362",56,2590.95639600883,2602.06785662004,2697.24673169728,24,32
"912345363",51,2865.19830291665,2738.83831527187,2646.17454577679,20,31
"912345364",49,2886.59347281167,2624.94311630961,2624.62502504328,19,30
"912345365",54,2978.64827437763,2832.65836447914,2677.2712016452,18,36
"912345366",46,2997.13235830429,3109.25745760596,2590.94954296761,15,31
"912345367",58,3301.27755254388,3317.87361942755,2716.66249357165,26,32
"912345368",59,3244.71601581252,3611.36692156969,2726.17127719361,25,34
"912345369",61,2534.70838054689,2410.49546745132,2744.81051624266,14,47
"912345370",72,3094.93635340793,3811.11974091107,2839.4193288992,32,40
"912345371",68,3235.21532555202,4562.97365428289,2806.43931339586,27,41
"912345372",40,2860.93832788748,3157.55817587831,2517.98110851286,14,26
"912345373",34,2376.73687255988,2883.22785539769,2435.71163614839,12,22
"912345374",63,3098.8903737695,3634.3871542686,2762.96971264875,25,38
"912345375",58,2482.33795364761,2953.34955837057,2716.66249357165,24,34
"912345376",73,3357.62449703167,2826.12937470678,2847.4358582506,27,46
"912345377",66,3326.44499450481,3191.98143835982,2789.3669207067,27,39
"912345378",48,2595.56543017676,2207.21438979233,2613.58673801098,18,30
"912345379",41,2747.20690187032,2129.22638638162,2530.72175773865,13,28
"912345380",46,2720.38283647986,2295.24705865309,2590.94954296761,19,27
"912345381",66,3214.47260184654,2614.52790028604,2789.3669207067,26,40
"912345382",69,3170.57482409028,2724.81074492316,2814.82611826518,28,41
"912345383",90,3026.13886702616,2475.5106548894,2971.92401064611,31,59
"912345384",62,2835.15058545593,2586.76703581601,2753.94837323248,24,38
"912345385",60,2739.32808003191,2345.07594777669,2735.5526890818,26,34
"912345386",64,2835.03856627242,2573.653645316,2771.87783482774,23,41
"912345387",71,2974.02679511696,2796.67044988099,2831.31372136695,27,44
"912345388",82,3649.79546730219,4267.58277003871,2915.91045786314,30,52
"912345389",69,3499.13851207277,3322.78315739677,2814.82611826518,28,41
"912345390",61,3159.33053325588,3519.51441482568,2744.81051624266,19,42
"912345393",25,2245.5209360701,1926.33204580998,2287.34065519221,7,18
"912345394",24,2139.10603712342,1825.33848484993,2268.33468283819,5,19
"912345395",21,2206.40908002648,1801.38307702843,2207.26116887512,6,15
"912345396",32,2414.86281135943,2520.69712634166,2405.71569249515,13,19
"912345397",49,3100.24119450889,2838.36731318024,2624.62502504328,19,30
"912345398",25,2224.63188808058,2169.96260228383,2287.34065519221,9,16
"912345399",51,2636.3792316865,2492.66642262399,2646.17454577679,22,29
"912345400",52,2828.77168874354,3088.78516940267,2656.6981055205,20,32
"912345401",61,2884.64971112426,2983.48992431401,2744.81051624266,29,32
"912345402",51,2640.14478218509,2593.22430007228,2646.17454577679,23,28
"912345403",46,2505.2543918515,2427.74649830939,2590.94954296761,18,28
"912345404",10,1927.69620860897,1997.74826099435,1896.67490607898,2,8
"912345405",17,2150.97258012583,2243.22036194275,2113.95669457394,3,14
"912345406",31,2125.26308041837,2329.43281667156,2390.15469389133,5,26
"912345407",40,2571.85649196839,2356.19585505236,2517.98110851286,14,26
"912345408",47,2577.14142368909,2440.97046364982,2602.36394728806,20,27
"912345409",46,2723.28918727563,2467.83357769151,2590.94954296761,17,29
"912345410",51,2919.26139234762,2899.99698080557,2646.17454577679,22,29
"912345411",63,3038.88160426831,3198.36103384349,2762.96971264875,26,37
"912345412",51,2716.09902121816,2981.73028715952,2646.17454577679,22,29
"912345413",51,2783.1301642423,2608.26658637,2646.17454577679,21,30
"912345414",53,2558.85220451497,2326.5822501371,2667.061866114,25,28
"912345415",54,3028.79076516005,2850.71568286783,2677.2712016452,18,36
"912345416",48,2087.15325439142,1520.62492848257,2613.58673801098,17,31
"912345417",56,2506.18188253381,2436.36287324577,2697.24673169728,24,32
"912345418",45,2553.5798775948,2094.33432682959,2579.33597919865,21,24
"912345419",57,2424.66984116644,2217.64695172433,2707.02236739438,21,36
"912345420",64,2710.61738667297,1945.17397846578,2771.87783482774,25,39
"912345421",53,2595.97000079348,2408.35654736372,2667.061866114,19,34
"912345434",42,2720.13604159449,2372.57446342892,2543.21752514954,21,21
"912345435",28,2604.83536234846,2216.21838221031,2340.94327947849,13,15
"912345437",67,2861.94476802134,2891.87500474822,2797.95380131742,23,44
"912345440",63,2815.75030450335,2940.47348562924,2762.96971264875,20,43
"912345441",43,2682.63672158213,2807.20354250971,2555.47878346624,12,31
"912345442",65,2833.97334131215,1770.73686882056,2780.67589681985,22,43
"912345443",54,2887.091920666,2028.71562342055,2677.2712016452,22,32
"912345444",63,2983.89995215844,2034.68200565,2762.96971264875,23,40
"912345445",73,3022.15485032152,2017.72776056855,2847.4358582506,27,46
"912345446",69,2994.78441790228,3095.27803475211,2814.82611826518,23,46
"912345447",59,2661.96659027552,2775.35882362161,2726.17127719361,19,40
"912345448",46,2783.74513972996,3026.20554666377,2590.94954296761,18,28
"912345449",60,2711.71399157841,2788.54390079501,2735.5526890818,18,42
"912345450",70,2850.62341244155,1556.92548937129,2823.11677003184,25,45
"912345451",80,2667.16632278208,1652.44512019605,2901.2306171403,26,54
"912345452",64,2776.40263053237,2490.52037315919,2771.87783482774,21,43
"912345453",67,2434.95593821165,1811.76352252735,2797.95380131742,24,43
"912345454",12,1857.90715268336,1733.45370958637,1968.69006049611,2,10
"912345455",10,1819.43206560852,1692.13657733903,1896.67490607898,2,8
"912345456",55,2837.71648773034,2872.12108632882,2687.33120998132,18,37
"912345457",56,3065.69954742985,2890.9049732523,2697.24673169728,18,38
"912345458",85,2832.20230782446,2433.42728319348,2937.40494579778,31,54
"912345459",92,2923.26611294983,2186.69103188175,2985.30521778333,37,55
"912345460",55,2810.42627698036,2411.11393108691,2687.33120998132,22,33
"912345461",60,3071.20531517827,2636.97401158684,2735.5526890818,15,45
"912345462",67,3037.24228202091,2664.70510497492,2797.95380131742,28,39
"912345463",47,2886.50241732946,2657.73152402592,2602.36394728806,25,22
"912345464",33,2532.26482989093,2322.88784725083,2420.89448855093,14,19
"912345466",42,2794.98041900281,2528.70813285594,2543.21752514954,25,17
"912345467",20,2032.39409289119,1566.73901148547,2185.35845629437,9,11
"912345468",22,2143.48131215266,1984.77439458891,2228.3491786518,7,15
"912345471",85,3271.30556325402,2839.53854399123,2937.40494579778,24,61
"912345472",39,2889.1792993742,2873.65964376947,2504.98447234734,11,28
"912345473",49,2695.23287888274,2310.0567977299,2624.62502504328,17,32
"912345474",52,3450.40507523362,3274.9453326841,2656.6981055205,19,33
"912345475",48,2951.98160655543,2879.32314413402,2613.58673801098,15,33
"912345476",61,3224.69380895524,3224.49632112537,2744.81051624266,19,42
"912345477",86,3369.56214272198,3487.86977228142,2944.43562859908,32,54
"912345478",29,2584.43500681922,2402.60154954054,2357.79423966008,9,20
"912345479",20,2072.48636548593,1784.61300675051,2185.35845629437,8,12
"912345481",39,2412.55655917356,2247.28972376347,2504.98447234734,13,26
"912345482",55,2499.9994460066,1776.77053420639,2687.33120998132,18,37
"912345483",50,2829.18697154244,2536.88251211982,2635.48551585152,13,37
"912345484",58,3165.85710228517,2907.30254630793,2716.66249357165,18,40
"912345485",60,2818.32488174987,1864.45798376363,2735.5526890818,11,49
"912345489",49,2479.40301899285,2119.25282833216,2624.62502504328,22,27
"912345490",61,2987.10351793039,2966.31030899469,2744.81051624266,21,40
"912345491",51,2816.58413677397,2529.20053359414,2646.17454577679,22,29
"912345492",59,2678.44082622457,1901.49686376713,2726.17127719361,23,36
"912345493",32,2180.92852194608,2004.78753976138,2405.71569249515,12,20
"912345494",49,2725.47715488357,2114.47931662295,2624.62502504328,16,33
"912345495",62,3216.65637320721,2849.55247054923,2753.94837323248,18,44
"912345496",79,3462.83315103943,3438.68006315861,2893.78092561085,31,48
"912345497",66,3548.02259692949,3205.7755199292,2789.3669207067,21,45
"912345498",61,2790.52291910846,2451.56529988459,2744.81051624266,18,43
"912345499",49,2542.01849625395,2508.42034450601,2624.62502504328,20,29
"912345500",87,3019.39371913987,2724.1231479983,2951.40156710974,32,55
"912345501",54,2544.04084639377,2667.51218528119,2677.2712016452,16,38
"912345502",69,2651.43571070814,2186.93590006875,2814.82611826518,19,50
"912345503",80,3975.27896635722,3924.18935135857,2901.2306171403,26,54
"912345504",66,3520.52422587049,3190.95915777298,2789.3669207067,20,46
"912345505",48,2602.50747496569,2232.80856613104,2613.58673801098,19,29
"912345506",55,2880.0723533142,2217.79502745412,2687.33120998132,18,37
"912345507",79,3436.06430470711,3805.90615967374,2893.78092561085,25,54
"912345508",73,3163.69590896385,2909.52329373998,2847.4358582506,28,45
"912345509",77,2611.74116325474,2380.40481940049,2878.65357631343,23,54
"912345510",59,2723.59294577997,2199.08049857484,2726.17127719361,18,41
"912345511",75,3231.41547301426,3094.17711532981,2863.21031780169,23,52
"912345512",70,2657.75102637446,2296.11400757312,2823.11677003184,20,50
"912345513",66,3047.12218948724,2677.11880086875,2789.3669207067,26,40
"912345514",66,2686.59772220929,2421.34539413378,2789.3669207067,21,45
"912345516",82,3828.91475267805,3749.64266805888,2915.91045786314,23,59
"912345517",85,2734.11855515636,3650.59411174123,2937.40494579778,27,58
"912345518",85,3673.96940855096,3811.57805166883,2937.40494579778,28,57
"912345519",73,3336.62483955688,2832.028363923,2847.4358582506,24,49
"912345520",42,2859.88943524653,2206.61114143453,2543.21752514954,17,25
"912345521",52,2585.66292368702,1890.16689332615,2656.6981055205,22,30
"912345522",35,2465.69659168904,1979.17117637992,2450.1860183293,14,21
"912345523",67,2988.65663438039,3037.59802908642,2797.95380131742,24,43
"912345524",79,3393.55840665297,3411.3740813281,2893.78092561085,29,50
"912345525",65,3196.55402151423,2695.79241763028,2780.67589681985,20,45
"912345526",62,2713.9465414013,2033.92449468244,2753.94837323248,18,44
"912345527",62,3145.94134289791,2838.53251945955,2753.94837323248,22,40
"912345528",83,3661.72278803068,3896.26222866595,2923.1438046077,30,53
"912345531",55,2853.46228600378,2884.29882789547,2687.33120998132,16,39
"912345532",59,2773.08345317926,2344.37739704205,2726.17127719361,24,35
"912345533",66,3606.24771448783,3607.80628758061,2789.3669207067,23,43
"912345534",56,3218.83889855376,2329.11280577788,2697.24673169728,24,32
"912345535",67,2515.54003524067,1922.86423384983,2797.95380131742,20,47
"912345536",60,3530.48792156173,2904.98861973192,2735.5526890818,20,40
"912345537",78,3186.6215275241,2806.91704406995,2886.25582696583,25,53
"912345538",74,3139.34823403257,2898.91446457473,2855.36548874306,22,52
"912345547",8,1616.24611010267,1547.13008767859,1812.11073017574,2,6
"912345595",19,2035.42345611572,1879.59131459111,2162.56636020013,4,15
"912345596",8,1692.31062245629,1436.00208438186,1812.11073017574,1,7
"912345597",17,1905.2306502839,1542.94323784764,2113.95669457394,3,14
"912345598",13,1808.46221298468,1574.77054803766,2001.16379457045,2,11
"912345599",13,1999.11664078034,1799.88855433671,2001.16379457045,5,8
"912345600",14,1999.09200806117,1951.2759140038,2031.70713799962,5,9
"912345601",3,1444.99417681959,1365.34598505524,1482.92019466158,0,3
"912345602",7,1645.00681203309,1589.80840502868,1763.32076508842,3,4
"912345603",10,1650.31579292988,1394.40323780474,1896.67490607898,2,8
"912345604",13,1870.10223120354,1474.18182845092,2001.16379457045,5,8
"912345605",12,1829.50036279287,1601.8575150236,1968.69006049611,3,9
"912345606",14,1760.15835975982,1554.12039760506,2031.70713799962,2,12
"912345607",12,1772.99915175697,1489.79739934489,1968.69006049611,3,9
"912345608",14,1903.67450973282,1499.44709130187,2031.70713799962,4,10
"912345609",13,1882.42703418352,1897.9743650903,2001.16379457045,2,11
"912345610",17,2024.26962795595,1937.73117064199,2113.95669457394,2,15
"912345611",17,2100.66267469534,2057.12584334737,2113.95669457394,4,13
"912345612",8,1730.2187458111,1627.03093999025,1812.11073017574,3,5
"912345613",19,1895.32750159358,1771.92875289141,2162.56636020013,5,14
"912345614",11,1829.02310609068,1678.10234056368,1933.98659929558,4,7
"912345615",17,1836.62327929497,1570.23076326887,2113.95669457394,5,12
"912345616",12,1789.91778329817,1642.80197511153,1968.69006049611,3,9
"912345617",15,1979.90395282344,1853.33463327839,2060.56118614118,3,12
"912345618",16,1853.96470528865,1533.06809600252,2087.92318348224,5,11
"912345619",12,1906.5283740863,1715.83318637783,1968.69006049611,5,7
"912345621",3,1415.26525227375,1443.5846528041,1482.92019466158,1,2
"912345622",2,1317.30375788425,1364.97646362037,1364.97646362037,0,2
"912345623",2,1311.53488138081,1364.97646362037,1364.97646362037,1,1
"912345635",10,1693.12075287952,1478.19357294504,1896.67490607898,5,5
"912345636",14,1669.810033673,1350.76265661567,2031.70713799962,3,11
"912345637",17,1782.0157477878,1479.41322556417,2113.95669457394,4,13
"912345640",4,1572.01810552435,1613.34325562768,1572.73281143487,1,3
"912345641",4,1480.3159405387,1475.73124699913,1572.73281143487,1,3
"912345642",5,1559.29001433503,1485.31990384394,1646.12614877363,1,4
"912345643",8,1604.41227194899,1494.74947391939,1812.11073017574,3,5
"912345644",11,1789.73674511901,1713.20528138818,1933.98659929558,4,7
"912345645",7,1685.32217613563,1650.78997885562,1763.32076508842,4,3
"912345688",5,1615.33611413119,1556.49657487546,1646.12614877363,2,3
"912345698",18,1832.57271453859,1387.80840741007,2138.79896507223,2,16
"912345703",12,1634.32091339374,1410.98824529648,1968.69006049611,4,8
"912345704",11,1749.55775570536,1368.36826723618,1933.98659929558,3,8
"912345705",8,1610.24059334361,1185.97348353698,1812.11073017574,3,5
"912345706",12,1715.74636665454,1317.17550353959,1968.69006049611,3,9
"912345707",11,1617.45736059993,1224.82968905208,1933.98659929558,3,8
"912345708",13,1736.77135786632,1176.7792516759,2001.16379457045,3,10
"912345709",8,1615.17036691144,1321.39122836263,1812.11073017574,3,5
"912345710",56,3073.41671539737,2596.23591961895,2697.24673169728,25,31
"912345711",45,2758.43440660384,2573.91704471494,2579.33597919865,20,25
"912345712",49,2843.53223589926,2856.1178486226,2624.62502504328,17,32
"912345713",48,2907.52245181204,2897.4111301421,2613.58673801098,19,29
"912345714",47,2647.34068304918,2745.74387596421,2602.36394728806,21,26
"912345715",40,2707.02550493094,2800.44710914755,2517.98110851286,20,20
"912345716",32,2528.4113058027,2546.66109955313,2405.71569249515,14,18
"912345717",42,2763.98049239965,2861.33891334135,2543.21752514954,12,30
"912345718",64,3487.27179507601,3115.12245110895,2771.87783482774,31,33
"912345719",52,3047.85205167163,3267.39746388855,2656.6981055205,24,28
"912345720",83,3425.88214287077,3374.43695368556,2923.1438046077,33,50
"912345721",76,3456.2519070874,3261.88166453319,2870.97236507783,30,46
"912345722",60,3216.50171378147,3896.81481848281,2735.5526890818,26,34
"912345723",62,3511.75054055472,3771.56789897765,2753.94837323248,23,39
"912345724",63,3045.41797374537,3797.38072567095,2762.96971264875,23,40
"912345725",55,3217.17917437128,4160.47908866287,2687.33120998132,23,32
"912345726",74,3638.81242722219,3742.9798800593,2855.36548874306,30,44
"912345727",62,3444.25242096988,3822.26166540528,2753.94837323248,26,36
"912345728",62,3774.8858087672,4114.00902313545,2753.94837323248,21,41
"912345729",73,3965.21838290125,3759.24535852032,2847.4358582506,25,48
"912345730",63,3352.28844789032,3523.2509126911,2762.96971264875,25,38
"912345731",56,3216.2912960868,3674.4861965826,2697.24673169728,23,33
"912345732",59,3360.37764996339,3632.76161757212,2726.17127719361,22,37
"912345733",65,3470.9232588611,4082.96432265468,2780.67589681985,25,40
"912345734",41,2553.93469760775,2260.02415384314,2530.72175773865,17,24
"912345735",51,2538.65655319711,2018.48055117084,2646.17454577679,14,37
"912345736",37,2505.79142248906,2352.68962996602,2478.17471526668,15,22
"912345737",62,2627.04124834964,2588.1977221326,2753.94837323248,19,43
"912345738",39,2364.75046035319,2414.37254737123,2504.98447234734,12,27
"912345739",45,2609.35551760301,2620.03202460606,2579.33597919865,12,33
"912345740",51,2405.80893436133,2334.17536149901,2646.17454577679,19,32
"912345741",38,2323.68777185067,1639.88892167729,2491.71993967651,9,29
"912345742",38,2303.66575460845,1851.60376770877,2491.71993967651,14,24
"912345743",56,2328.03670122974,2599.3746364932,2697.24673169728,20,36
"912345744",45,2210.21784279156,1975.43557599195,2579.33597919865,17,28
"912345745",52,2645.22530554685,2542.24694178274,2656.6981055205,20,32
"912345746",56,2355.90713013534,2270.27438910275,2697.24673169728,21,35
"912345747",57,2555.1241723219,2128.36066434389,2707.02236739438,21,36
"912345748",44,2655.92961848275,2776.73712579091,2567.51523707907,18,26
"912345749",41,2266.19836112258,2173.96582495093,2530.72175773865,14,27
"912345750",55,2445.18645319196,2232.00762313872,2687.33120998132,24,31
"912345751",52,2338.9915769182,2265.51463835618,2656.6981055205,19,33
"912345752",32,2145.17450218859,1785.20297017686,2405.71569249515,9,23
"912345753",44,2122.13732759801,1785.26327048712,2567.51523707907,18,26
"912345754",25,2098.79692065421,1982.00229856188,2287.34065519221,10,15
"912345755",28,2047.11764722173,1963.53908800617,2340.94327947849,11,17
"912345756",20,1953.73423754732,1603.56925985708,2185.35845629437,8,12
"912345757",20,2012.33610837154,1839.43599761897,2185.35845629437,9,11
"912345758",18,1945.10359179782,1977.54666974372,2138.79896507223,9,9
"912345759",16,1903.55530249561,1828.56548902297,2087.92318348224,10,6
"912345760",19,2111.88412228407,1855.52749347902,2162.56636020013,10,9
"912345761",21,1937.70105696216,1808.82337651779,2207.26116887512,11,10
"912345762",20,2086.66919701846,2065.85312080829,2185.35845629437,8,12
"912345763",8,1759.08135673377,1750.1807846555,1812.11073017574,2,6
"912345764",23,2153.08118698892,2077.05370158603,2248.68783741607,10,13
"912345765",27,2193.05777882675,2101.49298168738,2323.60649590586,15,12
"912345766",40,2233.9318795585,2025.68542815103,2517.98110851286,17,23
"912345767",28,2136.94090715025,2150.97035885315,2340.94327947849,11,17
"912345768",33,2124.40981694837,1843.50832161025,2420.89448855093,9,24
"912345769",28,2071.25776886895,1927.83135329431,2340.94327947849,11,17
"912345770",36,2176.47577240643,1840.62746646877,2464.33502634194,13,23
"912345771",30,2279.22874445358,2194.1105441352,2374.18906024059,12,18
"912345772",20,1968.53404044385,1568.67727964322,2185.35845629437,8,12
"912345773",27,2062.56111022778,1720.13604962578,2323.60649590586,11,16
"912345774",36,2252.64649936714,1724.90237115821,2464.33502634194,15,21
"912345775",36,2249.01683126349,1743.3596128683,2464.33502634194,10,26
"912345776",36,2040.29869202222,1591.26472478417,2464.33502634194,13,23
"912345777",32,2107.1236131312,1776.89203306737,2405.71569249515,12,20
"912345778",23,1990.89964202894,1872.3608453288,2248.68783741607,9,14
"912345779",26,2061.25690798783,1807.66514100594,2305.75108410937,10,16
"912345780",16,1994.67548137137,1894.71489682498,2087.92318348224,7,9
"912345781",21,2130.26402009538,2313.81964868604,2207.26116887512,8,13
"912345782",24,2186.61149114944,2025.69328036566,2268.33468283819,8,16
"912345783",28,2116.88260104663,1877.20362059056,2340.94327947849,10,18
"912345784",38,2132.11005653666,1540.7716948516,2491.71993967651,13,25
"912345785",29,2018.59891061576,1849.66185257384,2357.79423966008,9,20
"912345787",29,2179.69939162118,2293.9675306258,2357.79423966008,9,20
"912345788",18,2182.14462001546,2250.71899626333,2138.79896507223,7,11
"912345789",43,2384.45344553091,1916.02457487178,2555.47878346624,16,27
"912345790",46,2199.05898256289,1798.99994514085,2590.94954296761,18,28
"912345791",35,2098.99474193207,1942.87069597422,2450.1860183293,15,20
"912345792",38,2238.76612228554,1752.84846298178,2491.71993967651,16,22
"912345793",51,2297.62731049847,2067.76997276713,2646.17454577679,19,32
"912345794",38,2221.42193204209,1780.36800085929,2491.71993967651,14,24
"912345795",42,2216.95941584694,1968.29678491376,2543.21752514954,13,29
"912345797",36,2108.45957711263,1589.59715129435,2464.33502634194,12,24
"912345798",35,2191.90774878021,1850.93323858322,2450.1860183293,13,22
"912345799",39,2151.93797332559,1775.28741088059,2504.98447234734,16,23
"912345800",40,2109.75739330599,1416.13543502304,2517.98110851286,10,30
"912345801",43,2332.09601005818,1809.28624697677,2555.47878346624,20,23
"912345802",37,2353.99218470251,1814.69931591978,2478.17471526668,15,22
"912345803",37,2351.24234631795,1654.87669627803,2478.17471526668,13,24
"912345804",46,2225.67012016496,1548.06502584762,2590.94954296761,20,26
"912345805",40,2211.04019693014,1688.36851568052,2517.98110851286,17,23
"912345806",45,2225.94463272098,1628.30848813357,2579.33597919865,20,25
"912345807",32,2133.793491711,1770.69467142349,2405.71569249515,10,22
"912345808",25,1986.17453614074,2058.49603692498,2287.34065519221,7,18
"912345809",37,2250.99595070975,1668.52289588667,2478.17471526668,14,23
"912345810",37,2156.76601013972,1712.45463736696,2478.17471526668,11,26
"912345811",40,1998.75998041496,1665.06874049574,2517.98110851286,20,20
"912345812",44,2029.33668317499,1621.48622192489,2567.51523707907,20,24
"912345813",42,2103.63018096913,1818.74257476999,2543.21752514954,15,27
"912345814",32,1892.43180909439,1382.41840721012,2405.71569249515,9,23
"912345815",36,2108.32378153117,1696.96024376185,2464.33502634194,11,25
"912345820",47,2121.51874939905,1555.90499196974,2602.36394728806,15,32
"912345821",49,2002.91164643457,2026.11989845345,2624.62502504328,15,34
"912345822",38,2084.170281608,1699.91019064974,2491.71993967651,15,23
"912345823",35,2113.63919125636,1646.47851399385,2450.1860183293,15,20
"912345824",36,2016.30090494792,1231.27597810493,2464.33502634194,14,22
"912345825",42,2067.20768697207,1579.21333982143,2543.21752514954,15,27
"912345826",18,2076.45358516512,2079.03043882563,2138.79896507223,8,10
"912345827",16,2189.3464586369,2171.12625716914,2087.92318348224,8,8
"912345828",37,2138.9476285293,2134.34429958638,2478.17471526668,11,26
"912345829",12,1963.63008722611,1782.29721959506,1968.69006049611,5,7
"912345830",28,2246.07469701626,2466.4245524445,2340.94327947849,9,19
"912345831",18,2182.34619885577,1993.52025766153,2138.79896507223,7,11
"912345832",25,2327.54435704477,2314.91002406317,2287.34065519221,9,16
"912345833",30,2143.80198774881,1832.11900825629,2374.18906024059,9,21
"912345834",34,1966.63014055157,1592.66692636709,2435.71163614839,13,21
"912345835",24,1853.63088861547,1409.23561513879,2268.33468283819,8,16
"912345836",35,2224.44500710888,1977.80865503066,2450.1860183293,17,18
"912345837",38,2680.76843063045,2748.12083476474,2491.71993967651,19,19
"912345838",34,2542.21621387044,2193.72164400662,2435.71163614839,17,17
"912345839",34,2245.56981821765,1986.96058889927,2435.71163614839,16,18
"912345840",30,2090.11918523493,1633.93197816963,2374.18906024059,12,18
"912345841",33,2090.8971537282,1571.25352837435,2420.89448855093,14,19
"912345842",48,2236.75571099897,1613.26049526548,2613.58673801098,17,31
"912345843",55,2399.74905628313,1656.83036841212,2687.33120998132,21,34
"912345844",70,2255.64592489607,1346.14344816534,2823.11677003184,22,48
"912345845",54,2381.01111799407,2060.40940827695,2677.2712016452,19,35
"912345846",58,2575.69679036057,2116.68382119179,2716.66249357165,17,41
"912345847",46,2468.20650583384,2138.55078793661,2590.94954296761,19,27
"912345848",32,2229.6673060022,1737.56874576004,2405.71569249515,8,24
"912345849",84,2811.30736059342,1816.31654557957,2930.30814451558,23,61
"912345850",69,2869.04976226417,2315.0092613782,2814.82611826518,23,46
"912345851",59,2658.13818029363,1846.56721206905,2726.17127719361,18,41
"912345852",80,2241.02562280076,1574.44526444969,2901.2306171403,23,57
"912345853",75,2111.22420755484,1337.65118754388,2863.21031780169,22,53
"912345854",68,2452.50821062109,1856.52093918312,2806.43931339586,24,44
"912345855",98,2328.05987013052,2022.80757675528,3024.10627920296,26,72
"912345856",85,2578.48289667234,1866.94568657702,2937.40494579778,20,65
"912345857",68,2682.83884790801,2233.60897906302,2806.43931339586,23,45
"912345858",86,3105.84800836433,2565.26700697871,2944.43562859908,27,59
"912345859",96,3207.71850722017,2588.95227349536,3011.38790884243,28,68
"912345860",106,2932.834012827,2368.36894944067,3073.00222293854,33,73
"912345861",74,2930.81068271872,3180.81272482196,2855.36548874306,23,51
"912345862",67,3612.55397906843,2713.59887400362,2797.95380131742,20,47
"912345863",68,2797.36798921173,2800.97356839165,2806.43931339586,22,46
"912345864",58,2871.69604142053,2493.29538550313,2716.66249357165,20,38
"912345865",103,3665.65288408961,3971.71258513571,3055.02181112984,32,71
"912345866",69,3188.99033103227,2202.79309416414,2814.82611826518,23,46
"912345867",65,3458.39695900258,3578.50752207305,2780.67589681985,19,46
"912345868",75,2903.35406897421,2263.06979663152,2863.21031780169,26,49
"912345869",75,2800.9586741547,2516.60284488626,2863.21031780169,21,54
"912345870",63,3313.7148028895,2759.76111272695,2762.96971264875,20,43
"912345871",96,3233.27973819361,2998.71284835729,3011.38790884243,28,68
"912345872",58,2578.11841621063,1938.32852682185,2716.66249357165,16,42
"912345873",60,3222.45266107812,3000.09142959798,2735.5526890818,17,43
"912345874",94,3010.46606557341,2324.56268176556,2998.45695239283,37,57
"912345875",81,3285.07324069816,2927.01003563077,2908.60658576875,29,52
"912345876",57,3231.49034014025,2547.78725773116,2707.02236739438,20,37
"912345877",64,3242.49161046534,3233.77559576888,2771.87783482774,20,44
"912345878",69,2891.41466309245,2307.64197992075,2814.82611826518,24,45
"912345879",70,3092.23931584346,2639.94479423613,2823.11677003184,22,48
"912345880",39,2735.62883033852,2389.74638738145,2504.98447234734,17,22
"912345881",54,2956.9029189371,2953.43269041148,2677.2712016452,24,30
"912345882",48,2801.04502319885,2832.81007832884,2613.58673801098,20,28
"912345883",93,3416.32761325276,3015.30789738213,2991.90921350397,25,68
"912345884",48,2879.61291447547,2763.32891562,2613.58673801098,20,28
"912345885",50,3141.59236547924,3925.06767753165,2635.48551585152,19,31
"912345886",100,2855.72074339305,2096.90679842151,3036.61979185145,28,72
"912345887",74,3756.07775049978,4171.70446428167,2855.36548874306,29,45
"912345888",56,3064.8945495793,2930.73980960901,2697.24673169728,20,36
"912345889",95,2915.47323698252,3022.73649499644,3004.94950458202,33,62
"912345890",88,2931.49443975765,2259.85768951252,2958.30409156145,38,50
"912345891",96,3242.72275730359,3235.65610367696,3011.38790884243,39,57
"912345892",50,2566.50072400635,2321.53160237366,2635.48551585152,16,34
"912345893",72,2698.38378236475,2058.4580053355,2839.4193288992,29,43
"912345894",64,2470.32364358277,1705.13584906812,2771.87783482774,21,43
"912345895",56,2796.86378700028,2517.54142536454,2697.24673169728,23,33
"912345896",44,2363.40558422641,1899.32734392273,2567.51523707907,14,30
"912345897",65,3130.64439420241,2698.94364431651,2780.67589681985,23,42
"912345898",83,2392.32034302723,1643.09910035416,2923.1438046077,31,52
"912345899",70,2610.74110407722,2349.73889066207,2823.11677003184,28,42
"912345900",77,2776.15034720443,2190.63790139176,2878.65357631343,29,48
"912345901",96,2760.98299442885,2215.29611077592,3011.38790884243,38,58
"912345902",73,2833.54071295133,2352.50293847246,2847.4358582506,27,46
"912345903",50,2415.0448936373,1892.00979469145,2635.48551585152,16,34
"912345908",55,2429.82994738874,2438.39587177756,2687.33120998132,22,33
"912345909",60,2524.07560134343,2061.44663513,2735.5526890818,24,36
"912345910",57,2144.64379937465,1870.49800157591,2707.02236739438,24,33
"912345911",62,2360.0376379201,1790.5587494584,2753.94837323248,25,37
"912345912",18,1979.83484252101,2028.51288114284,2138.79896507223,7,11
"912345913",20,2095.42803427731,2104.26316962718,2185.35845629437,6,14
"912345914",29,2624.81807547017,2781.82328702783,2357.79423966008,7,22
"912345915",26,2571.27173664338,2895.26842465026,2305.75108410937,5,21
"912345916",34,2425.24838147994,2831.31605649764,2435.71163614839,8,26
"912345917",38,2683.38691812043,2930.26840969057,2491.71993967651,9,29
"912345918",34,2655.62570540299,2917.24254026104,2435.71163614839,8,26
"912345919",38,2704.87702486051,2575.77909960343,2491.71993967651,7,31
"912345949",16,1818.26746075749,1496.92358754788,2087.92318348224,3,13
"912345957",62,2957.19587048738,2269.57779464912,2753.94837323248,20,42
"912345962",65,2800.25560880649,1954.17975061403,2780.67589681985,18,47
"912345963",65,2882.68095868469,2562.9638461061,2780.67589681985,21,44
"912345964",52,2481.72415258277,1898.39712524979,2656.6981055205,16,36
"912345965",38,2569.77199102085,2660.61997575188,2491.71993967651,11,27
"912345966",56,2892.68315280406,2222.47320271711,2697.24673169728,19,37
"912345967",44,2913.14735555154,2281.76245359882,2567.51523707907,14,30
"912345968",28,2520.52512866764,2536.45503100054,2340.94327947849,5,23
"912345969",44,2780.96307285952,3004.19183139928,2567.51523707907,13,31
"912345970",50,2812.40706235204,2613.50818610066,2635.48551585152,12,38
"912345971",53,3392.73138155393,3182.17499332944,2667.061866114,20,33
"912345972",59,3162.18278020056,3469.81964880723,2726.17127719361,17,42
"912345973",86,3160.92367549406,2088.46605834888,2944.43562859908,25,61
"912345974",100,3350.06704315938,2740.78156658519,3036.61979185145,34,66
"912345975",86,3265.05816403035,2281.4168249157,2944.43562859908,25,61
"912345976",83,3917.38846188981,3904.01036203191,2923.1438046077,27,56
"912345977",75,3322.50776730218,3526.03370082109,2863.21031780169,26,49
"912345978",75,2554.00891839049,1451.17173590154,2863.21031780169,22,53
"912345979",35,2184.20379015292,2277.8316283712,2450.1860183293,8,27
"912345980",67,3424.77796882667,3261.65788696375,2797.95380131742,29,38
"912345981",76,2680.49222045763,1597.983184859,2870.97236507783,24,52
"912345982",26,2400.36918579378,2346.28778070835,2305.75108410937,8,18
"912345983",69,2492.25964110666,1587.35269586257,2814.82611826518,29,40
"912345984",80,3187.50520728724,1795.39936786245,2901.2306171403,31,49
"912345985",84,2886.03083483881,2637.93304425919,2930.30814451558,31,53
"912345986",78,2770.51175594187,2493.02892633079,2886.25582696583,24,54
"912345987",109,2464.0499422967,1201.21321083044,3090.58221916578,35,74
"912345988",68,2786.18159303824,1934.54063142198,2806.43931339586,25,43
"912345989",53,2260.44327528053,1388.70497815345,2667.061866114,15,38
"912345990",93,2954.72319887112,1824.05472061799,2991.90921350397,26,67
"912345991",87,2500.71211218687,1816.7349529967,2951.40156710974,37,50
"912345992",86,2911.60418166088,2422.30391867584,2944.43562859908,27,59
"912345993",101,3291.55995672319,1896.8610903088,3042.80202352452,39,62
"912345994",52,2801.18261295244,2491.19540826349,2656.6981055205,22,30
"912345995",58,2901.69962835415,2176.97611311691,2716.66249357165,22,36
"912345996",34,2122.27979743628,1793.95856400285,2435.71163614839,13,21
"912345997",44,2507.92168702646,1936.80524979937,2567.51523707907,17,27
"912345998",22,2245.48909160742,2258.68680474166,2228.3491786518,7,15
"912345999",22,2055.05218500387,1894.78184588379,2228.3491786518,8,14
"912346000",68,2935.30243970914,1964.97929481311,2806.43931339586,23,45
"912346001",44,2468.38770640255,2055.15506643236,2567.51523707907,16,28
"912346002",47,2351.61356500753,2180.5909420449,2602.36394728806,20,27
"912346003",73,2571.92462908105,2658.92198589909,2847.4358582506,22,51
"912346004",59,2437.3401281253,1825.44959920678,2726.17127719361,19,40
"912346005",58,2573.70781211738,2506.18851981718,2716.66249357165,15,43
"912346006",75,2465.80823787297,2310.78332830345,2863.21031780169,17,58
"912346007",68,3401.11462332297,2533.06761006569,2806.43931339586,24,44
"912346008",62,2968.44495139644,2605.47040673597,2753.94837323248,22,40
"912346009",39,2467.45682520011,2221.87070739983,2504.98447234734,14,25
"912346010",41,2635.10367100149,2524.28537081074,2530.72175773865,12,29
"912346011",51,2886.83724894225,2474.9095468413,2646.17454577679,18,33
"912346012",68,3349.40170550388,3114.38635550803,2806.43931339586,23,45
"912346013",75,3337.93921428181,2770.86925459899,2863.21031780169,26,49
"912346014",84,3107.91399109217,2642.22524355197,2930.30814451558,26,58
"912346015",96,2738.88508572226,2147.75594974504,3011.38790884243,28,68
"912346016",65,3105.02228172244,2284.31768875999,2780.67589681985,21,44
"912346017",84,2951.19144140676,2686.76732904871,2930.30814451558,33,51
"912346018",84,2886.30948779965,2292.64051459518,2930.30814451558,34,50
"912346019",114,2452.36813232132,1342.41691104316,3119.04491539519,42,72
"912346020",44,1937.44910519129,979.02867728731,2567.51523707907,11,33
"912346021",91,2578.09426754183,1277.47889246788,2978.64386243803,31,60
"912346022",107,2372.65329323681,1156.72644949387,3078.90571391637,28,79
"912346023",109,2218.40063321188,1268.01901910362,3090.58221916578,44,65
"912346024",80,2724.15102213915,2155.7037119182,2901.2306171403,24,56
"912346025",107,2601.71703161755,1648.57178964248,3078.90571391637,42,65
"912346026",31,2451.53143098382,2514.50630867449,2390.15469389133,9,22
"912346027",58,3323.36973884844,2680.76973332545,2716.66249357165,20,38
"912346028",33,2178.21355789964,2154.55235023624,2420.89448855093,15,18
"912346029",49,2187.996541664,1771.70869743066,2624.62502504328,22,27
"912346030",23,2129.56985615644,1996.79406889075,2248.68783741607,6,17
"912346031",23,2085.35288074505,1954.70674707695,2248.68783741607,6,17
"912346032",77,3240.55635807742,2754.71806884392,2878.65357631343,28,49
"912346033",81,3089.83661326268,2159.58014493947,2908.60658576875,26,55
"912346034",95,2851.32779620226,1735.60400971829,3004.94950458202,35,60
"912346035",62,2576.58777623586,1999.93396982265,2753.94837323248,17,45
"912346036",43,2530.02631271934,2349.495577015,2555.47878346624,14,29
"912346037",81,2973.28805993645,2137.07438451102,2908.60658576875,26,55
"912346038",47,2622.40779525491,2338.46729237192,2602.36394728806,21,26
"912346039",66,3294.83821781115,2657.4285272123,2789.3669207067,22,44
"912346040",61,3229.41215897769,2837.52224699403,2744.81051624266,23,38
"912346041",62,2542.24468668665,2469.13365601636,2753.94837323248,15,47
"912346042",50,2813.80686441902,2659.50454736234,2635.48551585152,16,34
"912346043",49,2233.32787327771,2200.39010642615,2624.62502504328,10,39
"912346044",70,3046.84668017166,3072.54387335985,2823.11677003184,26,44
"912346045",71,2520.1862404037,1997.03220956038,2831.31372136695,25,46
"912346046",44,2126.95678641732,2153.95106106361,2567.51523707907,12,32
"912346047",75,2898.03467534706,2358.43550783358,2863.21031780169,28,47
"912346048",67,2676.70726309255,2506.65084364664,2797.95380131742,24,43
"912346049",7,1695.25906384387,1602.07023107664,1763.32076508842,2,5
"912346050",8,1663.06969885902,1566.02839401863,1812.11073017574,4,4
"912346051",12,1724.51316180166,1484.28937180719,1968.69006049611,4,8
"912346052",5,1585.03728852431,1538.34162493865,1646.12614877363,2,3
"912346053",18,1783.49616007588,1348.77457284077,2138.79896507223,5,13
"912346054",19,1840.69679446117,1488.12729200528,2162.56636020013,4,15
"912346055",9,1626.79191418399,1295.55016034805,1856.26587460569,2,7
"912346056",12,1793.47955277199,1754.89743518328,1968.69006049611,5,7
"912346057",12,1688.29872505885,1503.51064065823,1968.69006049611,4,8
"912346058",10,1733.02972020102,1551.07089909184,1896.67490607898,4,6
"912346059",12,1763.62595975284,1754.49985349975,1968.69006049611,3,9
"912346060",14,1743.05844167561,1017.19385611445,2031.70713799962,5,9
"912346061",11,1782.97597865942,1433.0864223406,1933.98659929558,3,8
"912346062",18,1837.18612292982,1430.18041158024,2138.79896507223,4,14
"912346063",5,1633.11816363792,1529.00390243061,1646.12614877363,2,3
"912346064",8,1713.21469027378,1565.98120708023,1812.11073017574,3,5
"912346065",12,1700.05549115154,1185.86043287329,1968.69006049611,4,8
"912346066",18,1896.31163432645,1431.53304235632,2138.79896507223,5,13
"912346067",16,1754.73195239846,1417.61167959409,2087.92318348224,4,12
"912346068",11,1692.15561830407,1318.59105185883,1933.98659929558,3,8
"912346069",19,1728.16850503316,976.139647280114,2162.56636020013,4,15
"912346070",9,1697.81336161818,1326.17038439505,1856.26587460569,2,7
"912346112",31,2047.1813685745,1649.72681579976,2390.15469389133,11,20
"912346113",44,2022.93460065668,1814.26511658132,2567.51523707907,13,31
"912346118",24,1947.16617298358,1499.96109413576,2268.33468283819,8,16
"912346119",23,1792.87655032289,1214.97649697728,2248.68783741607,9,14
"912346123",17,1856.73238067383,1546.30113248069,2113.95669457394,7,10
"912346150",26,2052.29634229895,1633.71187225962,2305.75108410937,8,18
"912346199",18,1840.75754751609,1592.2530847733,2138.79896507223,6,12
"912346262",16,1778.57961039696,1774.09569643573,2087.92318348224,6,10
"912346263",23,1820.51338474244,1670.49402866556,2248.68783741607,8,15
"912346268",12,1784.07809798595,1839.51709626301,1968.69006049611,4,8
"912346269",9,1717.19382107047,1696.94171344586,1856.26587460569,4,5
"912346274",6,1588.40930780788,1461.24881951512,1708.62817714657,2,4
"912346275",10,1674.54403704102,1471.91551264221,1896.67490607898,4,6
"912346280",9,1686.08581595491,1701.65438575233,1856.26587460569,3,6
"912346281",12,1795.48044724154,1762.40801035161,1968.69006049611,3,9
"912346282",13,1824.72591340472,1739.07363309169,2001.16379457045,3,10
"912346283",11,1757.32099836984,1762.45974929937,1933.98659929558,2,9
"912346285",11,1730.14082095935,1724.56946036941,1933.98659929558,3,8
"912346287",10,1743.42588055912,1677.64893613516,1896.67490607898,4,6
"912346288",8,1728.72236458599,1745.23535825313,1812.11073017574,4,4
"912346289",11,1694.33202204926,1542.50386989462,1933.98659929558,4,7
"912346290",16,1887.41967400733,1649.56528297568,2087.92318348224,7,9
"912346291",16,1746.63330881366,1431.73182780849,2087.92318348224,5,11
"912346292",17,1841.50522717114,1624.55540760789,2113.95669457394,5,12
"912346293",12,1760.721420981,1450.46056308533,1968.69006049611,4,8
"912346294",13,1775.25363354377,1602.36309908931,2001.16379457045,4,9
"912346295",14,1860.58311057389,1728.4079069253,2031.70713799962,5,9
"912346296",9,1717.10426467992,1534.03112510803,1856.26587460569,3,6
"912346297",13,1868.23131050815,1710.30883057568,2001.16379457045,6,7
"912346299",12,1797.51424212339,1577.83241691531,1968.69006049611,5,7
"912346300",11,1788.71016846963,1597.51893279331,1933.98659929558,4,7
"912346301",13,1799.07523931917,1598.17779854831,2001.16379457045,4,9
"912346302",14,1824.56285006575,1696.03981022197,2031.70713799962,4,10
"912346303",12,1765.51350010132,1835.25466429131,1968.69006049611,4,8
"912346304",11,1781.06815631973,1766.71829647901,1933.98659929558,4,7
"912346305",10,1762.48660323663,1630.72644406074,1896.67490607898,4,6
"912346306",13,1810.28229875657,1806.62529518203,2001.16379457045,3,10
"912346307",16,1728.0119336139,1696.00631383647,2087.92318348224,4,12
"912346308",16,1805.36546130077,1653.54699769822,2087.92318348224,3,13
"912346309",18,1888.51370812813,1550.18229998336,2138.79896507223,5,13
"912346319",65,3067.99552497094,2879.40477295348,2780.67589681985,25,40
"912346320",69,2637.65311260951,2754.68358753029,2814.82611826518,28,41
"912346325",40,2528.14400280181,2249.75284708833,2517.98110851286,15,25
"912346326",42,2569.3887987003,2100.61463234929,2543.21752514954,16,26
"912346337",38,2481.62298395984,2649.47498263507,2491.71993967651,10,28
"912346338",31,2333.32993385212,2264.67377163178,2390.15469389133,13,18
"912346341",28,2440.72603469443,2399.56712612891,2340.94327947849,11,17
"912346342",42,2753.66340895225,2487.93303428471,2543.21752514954,14,28
"912346348",58,2311.42314720812,2067.32777406876,2716.66249357165,19,39
"912346349",57,2554.67145712377,1643.60866901694,2707.02236739438,21,36
"912346351",7,1741.24184982417,1675.53432614411,1763.32076508842,2,5
"912346352",10,1820.83783693422,1576.40422336025,1896.67490607898,3,7
"912346353",8,1731.87934369971,1669.35802174753,1812.11073017574,2,6
"912346354",7,1663.2426690568,1494.71152203487,1763.32076508842,2,5
"912346361",27,2240.08274674203,1965.21902307593,2323.60649590586,9,18
"912346362",27,2174.08534525415,1653.20457761285,2323.60649590586,9,18
"912346363",24,2117.49597903172,1595.74935308154,2268.33468283819,8,16
"912346366",24,2537.10316853756,2445.21891776695,2268.33468283819,6,18
"912346367",39,2591.55726822156,3125.47759593007,2504.98447234734,7,32
"912346368",39,2706.83971842808,2895.16758662702,2504.98447234734,7,32
"912346369",35,2596.01604478608,2805.45099892121,2450.1860183293,8,27
"912346370",38,2832.844307827,3176.45002884798,2491.71993967651,8,30
"912346371",50,2427.18167869947,2071.72304632961,2635.48551585152,9,41
"912346372",28,2530.12848513089,2515.52033437669,2340.94327947849,6,22
"912346373",46,2600.77747977521,2492.90050443545,2590.94954296761,8,38
"912346377",2,1340.79519043948,1244.12063445693,1364.97646362037,0,2
"912346378",3,1436.27481961039,1394.95867633727,1482.92019466158,1,2
"912346420",1,1176.51947704734,1179.01283015622,1184.66451052022,0,1
"912346421",2,1340.79519043948,1287.05590608486,1364.97646362037,0,2
"912346493",21,1939.89455920646,1545.75232729926,2207.26116887512,5,16
"912346494",17,1801.85594805206,1461.49960458497,2113.95669457394,3,14
"912346495",9,1792.44065943564,1627.50446558612,1856.26587460569,0,9
"912346496",17,1829.00288230229,1590.88803259221,2113.95669457394,4,13
"912346497",16,1716.21580986116,1236.72286367626,2087.92318348224,2,14
"912346498",16,1664.12729243502,1234.63440746705,2087.92318348224,3,13
"912346499",21,1772.33339691864,1651.15126140487,2207.26116887512,3,18
"912346500",19,1679.73451723858,1646.70371530719,2162.56636020013,2,17
"912346502",16,1952.0329544374,1759.56603544863,2087.92318348224,2,14
"912346503",10,1879.9629977085,1815.69661452252,1896.67490607898,0,10
"912346504",23,1864.87041605065,1532.89575028074,2248.68783741607,4,19
"912346526",46,2313.57338984982,1933.72347805681,2590.94954296761,15,31
"912346549",34,2429.25863455471,2248.34416443215,2435.71163614839,10,24
"912346581",14,2012.51204723397,2028.27468582033,2031.70713799962,3,11
"912346723",21,2211.84681115518,2437.45651055848,2207.26116887512,5,16
"912346731",29,2494.05546649101,2530.60768945317,2357.79423966008,5,24
"912346737",29,2399.7951615383,2460.54177022476,2357.79423966008,6,23
"912346738",27,2358.12766444651,2418.79284131844,2323.60649590586,6,21
"912346739",36,2239.64748346306,2190.1366749138,2464.33502634194,8,28
"912346741",32,2326.77946475421,2354.54194804849,2405.71569249515,5,27
"912346742",30,2417.1670128649,2408.0053570552,2374.18906024059,4,26
"912346744",25,2390.39050543417,2605.3037676572,2287.34065519221,6,19
"912346745",24,2256.96662847609,2460.78322970499,2268.33468283819,5,19
"912346746",24,2254.53000685084,2514.18088019494,2268.33468283819,6,18
"912346747",35,2416.07979617347,2089.64588166722,2450.1860183293,8,27
"912346749",24,2378.07625524924,2373.67836774289,2268.33468283819,8,16
"912346758",16,1746.52477310635,1579.79490859031,2087.92318348224,2,14
"912346760",44,2615.84850721026,2398.11443856623,2567.51523707907,22,22
"912346763",50,2895.46164729105,3048.49475663098,2635.48551585152,18,32
"912346764",63,3055.66367831598,2877.59571836912,2762.96971264875,22,41
"912346813",41,2671.16760763813,2264.43287950174,2530.72175773865,20,21
"912346908",7,1609.10697445515,1625.65332788661,1763.32076508842,4,3
"912346912",7,1625.45484165673,1705.24703921544,1763.32076508842,3,4
"912346954",15,1862.15962715516,1652.55886344432,2060.56118614118,2,13
"912346955",17,1972.00378655026,1925.83199821516,2113.95669457394,3,14
"912346957",19,1860.5098840661,1851.36947026508,2162.56636020013,4,15
"912346958",15,1820.09851435732,1779.11952276701,2060.56118614118,4,11
"912346959",24,1859.62036042833,1609.51708986383,2268.33468283819,4,20
"912346960",19,1818.08419240559,1758.25704254813,2162.56636020013,2,17
"912346961",20,1794.64203627661,1474.05351121903,2185.35845629437,5,15
"912346962",10,1759.98231689275,1627.58507531381,1896.67490607898,1,9
"912346965",13,1806.01906450728,1595.38031145517,2001.16379457045,2,11
"912346966",11,1772.09186079088,1817.17226214671,1933.98659929558,2,9
"912346967",18,1832.30989595189,1738.22289257715,2138.79896507223,3,15
"912346968",16,1779.89838909197,1826.75735849994,2087.92318348224,5,11
"912346969",11,1809.71343451984,1743.36476332245,1933.98659929558,3,8
"912346970",16,1819.30716751195,1550.46926580022,2087.92318348224,5,11
"912346971",12,1751.7722102815,1668.65365228759,1968.69006049611,2,10
"912346973",13,1830.59052999002,1816.07662169671,2001.16379457045,2,11
"912346974",21,1865.12023315351,1574.76761784233,2207.26116887512,4,17
"912346975",17,1798.62450483884,1598.13867048419,2113.95669457394,3,14
"912346976",14,1853.68706495061,1486.16663135364,2031.70713799962,1,13
"912346977",12,1759.29034564617,1665.71396568029,1968.69006049611,2,10
"912346978",21,1951.86216408097,1866.62253820128,2207.26116887512,6,15
"912346979",14,1830.12879246211,1685.24027644808,2031.70713799962,3,11
"912346980",15,1865.35880888106,1473.97060970099,2060.56118614118,3,12
"912346982",12,1760.0401088739,1551.75008234436,1968.69006049611,5,7
"912346983",21,1913.74129453913,1655.35716530769,2207.26116887512,3,18
"912346984",11,1780.43043101545,1737.34646007279,1933.98659929558,1,10
"912346985",16,1904.7573399963,1832.59384189186,2087.92318348224,2,14
"912346987",20,1940.37744782635,1593.01406668711,2185.35845629437,4,16
"912346988",14,1778.90252077035,1561.26547122594,2031.70713799962,4,10
"912346989",13,1752.52574998458,1586.12937456102,2001.16379457045,2,11
"912346990",13,1818.89190804966,1740.82328984396,2001.16379457045,2,11
"912346991",18,1742.9334188312,1800.32114363842,2138.79896507223,3,15
"912346992",12,1869.9681540023,1847.80310199868,1968.69006049611,4,8
"912346994",17,1979.2879895729,1861.60647862162,2113.95669457394,2,15
"912346995",10,1711.52961160484,1758.13166838149,1896.67490607898,2,8
"912346996",16,1918.07315941371,1663.15496020187,2087.92318348224,3,13
"912346997",11,1782.21715889301,1702.53985541938,1933.98659929558,3,8
"912347004",16,1779.77647891925,1499.79641584836,2087.92318348224,5,11
"912347005",15,1800.81014370527,1524.04607350225,2060.56118614118,4,11
"912347017",15,1704.62988456505,1410.5725764432,2060.56118614118,4,11
"912347129",50,3105.84039399672,3304.18236722943,2635.48551585152,17,33
"912347134",62,2819.91100605379,3248.72248057449,2753.94837323248,27,35
"912347390",68,3059.79038478518,3082.71817652865,2806.43931339586,25,43
"912347391",66,3143.09337649989,3368.70396045172,2789.3669207067,26,40
"912347392",94,3297.20017478509,3064.64410588578,2998.45695239283,38,56
"912347393",72,2944.27513182841,2567.73420042488,2839.4193288992,30,42
"912347394",98,3167.93906699367,2609.73341171617,3024.10627920296,32,66
"912347395",84,3500.85009524876,3826.94312076621,2930.30814451558,30,54
"912347396",63,3290.90742795473,3216.40422046604,2762.96971264875,16,47
"912347397",76,3128.61366835459,3378.12808001885,2870.97236507783,27,49
"912347398",76,2896.2161061272,3143.92995842524,2870.97236507783,28,48
"912347399",80,2743.87517745222,2282.09530305614,2901.2306171403,31,49
"912347400",44,2670.93049889607,2625.129327207,2567.51523707907,20,24
"912347401",57,2904.01595459052,2767.86649894931,2707.02236739438,24,33
"912347402",98,3078.36635873422,2833.306444668,3024.10627920296,35,63
"912347403",66,2946.32401635476,3643.75165916251,2789.3669207067,26,40
"912347404",77,3035.28766825883,3688.039469684,2878.65357631343,27,50
"912347405",75,3221.38553457823,3890.79314502147,2863.21031780169,27,48
"912347406",76,2745.2445387176,1831.41312359827,2870.97236507783,25,51
"912347407",73,2922.13120383683,2682.3575057262,2847.4358582506,25,48
"912347408",81,2189.19371335135,1972.01597455401,2908.60658576875,27,54
"912347409",72,2536.16572207868,1660.65174827376,2839.4193288992,25,47
"912347410",119,2173.96834036045,1410.42062224856,3146.53110896604,39,80
"912347411",103,2562.59735716537,2207.8481732273,3055.02181112984,27,76
"912347412",109,3059.26704484214,2476.12596960426,3090.58221916578,34,75
"912347413",90,2598.72244184757,2169.31314010541,2971.92401064611,35,55
"912347414",93,2781.42470994907,2475.88237242288,2991.90921350397,34,59
"912347415",88,2936.64311075186,2293.84455967834,2958.30409156145,27,61
"912347416",57,3035.36028530446,2899.93871438039,2707.02236739438,22,35
"912347417",48,3044.18229335887,2675.14584721618,2613.58673801098,18,30
"912347418",59,2909.42762667037,3246.65681980195,2726.17127719361,20,39
"912347419",88,2878.69232232349,3655.65135039911,2958.30409156145,30,58
"912347420",64,3181.39292634763,2541.49772687799,2771.87783482774,24,40
"912347421",79,3667.19341276876,3510.99554653146,2893.78092561085,29,50
"912347422",80,2895.2860659598,3158.42663410346,2901.2306171403,28,52
"912347423",58,3163.00941759012,3332.56635302831,2716.66249357165,16,42
"912347424",52,2624.14023357503,2145.75807657203,2656.6981055205,20,32
"912347425",50,2324.97985182672,2251.03646286061,2635.48551585152,18,32
"912347426",68,2867.54713205164,2009.92960510806,2806.43931339586,23,45
"912347427",64,2249.26053846855,1536.87596439558,2771.87783482774,23,41
"912347428",62,2786.12549622886,1747.4091377088,2753.94837323248,26,36
"912347430",77,3355.9760704144,3408.41147730899,2878.65357631343,32,45
"912347432",74,2972.1965509783,2351.06264629725,2855.36548874306,27,47
"912347433",60,2934.42061271475,2631.96987195956,2735.5526890818,21,39
"912347434",85,3438.7592946456,3000.83709139465,2937.40494579778,29,56
"912347437",75,3015.69503964868,2442.55213237677,2863.21031780169,34,41
"912347438",79,3355.34126466705,2828.32340247375,2893.78092561085,32,47
"912347439",76,3230.76456345622,2816.53428447254,2870.97236507783,31,45
"912347440",67,2471.0803770986,1499.03346221322,2797.95380131742,27,40
"912347441",45,2405.04908096432,1787.32990022255,2579.33597919865,24,21
"912347442",60,2835.85988333016,2124.85418199338,2735.5526890818,22,38
"912347443",49,2677.43379253232,1829.03372552878,2624.62502504328,21,28
"912347444",79,3027.93047362527,2563.66703614314,2893.78092561085,34,45
"912347445",85,3522.78078288943,2764.03204706949,2937.40494579778,37,48
"912347446",52,3130.19009305219,3288.17155345646,2656.6981055205,25,27
"912347447",72,3386.31158359385,2854.19785117221,2839.4193288992,29,43
"912347448",79,3216.94655257577,3035.38816246615,2893.78092561085,34,45
"912347449",65,2820.7346646338,2634.1767981244,2780.67589681985,23,42
"912347450",48,2564.57858637644,1816.26627091598,2613.58673801098,19,29
"912347451",47,2563.40994560526,1689.5746781492,2602.36394728806,16,31
"912347452",86,2763.76188100412,1740.92405085987,2944.43562859908,37,49
"912347453",69,2941.92513512934,3056.26971461286,2814.82611826518,31,38
"912347454",68,2908.53078546269,2958.33324845473,2806.43931339586,25,43
"912347455",85,3315.44800664283,2049.29727699021,2937.40494579778,33,52
"912347456",86,3451.09007285615,3553.47208393973,2944.43562859908,31,55
"912347457",85,3389.36761794957,3354.17358821396,2937.40494579778,33,52
"912347458",63,2790.32158961723,2452.48321661286,2762.96971264875,27,36
"912347459",95,3048.10270164844,2979.84549836338,3004.94950458202,41,54
"912347460",87,3096.69967590033,2808.55726789605,2951.40156710974,35,52
"912347461",55,2585.59948785557,2213.33729027806,2687.33120998132,19,36
"912347462",53,2996.7763742369,2238.90873985255,2667.061866114,18,35
"912347463",58,3003.78570076014,2439.61133969001,2716.66249357165,26,32
"912347464",73,3111.66663528633,3054.72649940217,2847.4358582506,29,44
"912347466",74,2704.64283807379,2308.05099232358,2855.36548874306,31,43
"912347467",74,3076.9842579967,2866.40047480654,2855.36548874306,30,44
"912347468",86,3195.61031232198,3114.64706822554,2944.43562859908,31,55
"912347469",42,2251.68324323076,1799.70165183551,2543.21752514954,12,30
"912347470",43,2173.73183708111,1682.4456810691,2555.47878346624,14,29
"912347471",40,2705.29607873335,2167.92300350923,2517.98110851286,18,22
"912347472",33,2293.14585171224,1797.73437339983,2420.89448855093,15,18
"912347473",67,3003.74858507971,2782.15441487079,2797.95380131742,25,42
"912347474",62,2742.10340966179,2705.70513534836,2753.94837323248,28,34
"912347475",80,3261.31776212662,2976.75218553735,2901.2306171403,31,49
"912347476",79,2700.80796824357,2422.4809380209,2893.78092561085,33,46
"912347477",61,2989.77821651494,2875.49303382583,2744.81051624266,22,39
"912347478",70,2788.09845659753,2468.04756349618,2823.11677003184,27,43
"912347479",33,2356.0573888598,1935.79503643214,2420.89448855093,14,19
"912347480",31,2134.54470961545,1559.1313626912,2390.15469389133,11,20
"912347481",75,2677.27142912661,2121.87199051236,2863.21031780169,29,46
"912347482",76,2960.25450598777,2908.72681958722,2870.97236507783,29,47
"912347483",78,2762.9152251214,2813.76604240502,2886.25582696583,26,52
"912347484",82,2874.06277696577,1509.99492003846,2915.91045786314,32,50
"912347485",75,2785.66668085582,2299.83583526497,2863.21031780169,21,54
"912347486",79,3144.98310052785,2620.3674366364,2893.78092561085,28,51
"912347487",53,2843.50742738628,2973.90704317065,2667.061866114,17,36
"912347488",78,3036.80325629611,2374.41365111143,2886.25582696583,27,51
"912347489",62,2975.62091365113,2450.78506276488,2753.94837323248,21,41
"912347490",38,2561.54177542558,1958.72075704349,2491.71993967651,16,22
"912347491",61,2376.56162885009,2042.59342920291,2744.81051624266,16,45
"912347497",55,2172.41522223248,1772.91845588034,2687.33120998132,23,32
"912347498",46,2225.8618539629,2309.9143902376,2590.94954296761,21,25
"912347499",48,2450.65417155897,1992.31072117231,2613.58673801098,21,27
"912347500",48,2237.0250982335,2172.63726390497,2613.58673801098,18,30
"912347501",42,2372.50803002591,2299.3805029399,2543.21752514954,18,24
"912347502",23,2029.54039036182,2129.12230194447,2248.68783741607,10,13
"912347503",39,2340.45999335005,2017.38644447237,2504.98447234734,19,20
"912347504",45,2480.83571492806,2450.94802008887,2579.33597919865,22,23
"912347505",34,2404.60375958742,2239.27513650763,2435.71163614839,9,25
"912347506",100,3594.54710819711,4155.76040400685,3036.61979185145,39,61
"912347507",85,3108.68360277585,4014.02374405876,2937.40494579778,29,56
"912347508",70,3192.54712523928,3559.01580917161,2823.11677003184,30,40
"912347509",57,3044.43901747849,3487.76320000778,2707.02236739438,20,37
"912347510",55,3087.73221303924,3106.64432582744,2687.33120998132,21,34
"912347511",70,3344.67288649159,3279.97045579508,2823.11677003184,30,40
"912347512",72,3087.16718414167,3723.44989647805,2839.4193288992,27,45
"912347519",66,2601.8583556692,2417.71277657149,2789.3669207067,28,38
"912347524",72,3093.98144157458,3056.82892368662,2839.4193288992,27,45
"912347525",66,2908.88443792035,2865.04730724598,2789.3669207067,22,44
"912347548",111,3080.13027182338,2466.82900861355,3102.08949329874,39,72
"912347549",62,2486.60555740985,1777.04037031325,2753.94837323248,26,36
"912347553",44,2504.44834028656,1972.85729010957,2567.51523707907,18,26
"912347554",39,2583.79908229061,2258.01927672501,2504.98447234734,16,23
"912347555",44,2178.7796775082,1922.53340480595,2567.51523707907,18,26
"912347556",42,2388.61648075379,2035.53891487256,2543.21752514954,21,21
"912347557",52,2380.73060494352,1943.05574729368,2656.6981055205,24,28
"912347558",55,2501.63151988594,1911.59767092919,2687.33120998132,22,33
"912347559",62,3378.611003006,4500.25963705746,2753.94837323248,21,41
"912347560",55,3002.01287449429,3482.19726409548,2687.33120998132,24,31
"912347569",62,2087.55258957754,1773.10530196031,2753.94837323248,20,42
"912347570",51,2230.75508610884,2095.83995979635,2646.17454577679,14,37
"912347586",56,2601.30447628987,1680.75590730123,2697.24673169728,19,37
"912347587",50,2733.79032135478,2417.88573894813,2635.48551585152,20,30
"912347628",50,2440.90318547728,1880.40348216274,2635.48551585152,19,31
"912347629",65,2843.62079034137,2850.33312062163,2780.67589681985,27,38
"912347630",45,2419.88195806912,2415.12338452604,2579.33597919865,14,31
"912347639",49,2552.24977326024,2151.88268208482,2624.62502504328,16,33
"912347652",74,2855.97103230936,2531.00108372968,2855.36548874306,28,46
"912347653",79,3782.46529536878,3634.42243618388,2893.78092561085,29,50
"912347658",48,2523.06507755491,2107.55607053803,2613.58673801098,16,32
"912347659",47,2991.62470729519,2327.49957871706,2602.36394728806,16,31
"912347660",38,2418.18903940248,2358.68860886207,2491.71993967651,14,24
"912347669",39,2448.64066613998,2201.64318757253,2504.98447234734,15,24
"912347682",71,2928.42036563421,2873.15888551602,2831.31372136695,30,41
"912347683",73,3592.99536969114,3013.53042586126,2847.4358582506,31,42
"912347686",66,2531.36794354441,2519.14717435077,2789.3669207067,22,44
"912347687",64,2649.73271204449,2306.90373806692,2771.87783482774,22,42
"912347693",46,2297.1219816547,2231.28087965448,2590.94954296761,17,29
"912347694",60,2376.47787345025,2433.46376861627,2735.5526890818,18,42
"912347703",57,2401.53096363933,2258.47519993189,2707.02236739438,18,39
"912347714",67,2432.85046392976,2356.81110507859,2797.95380131742,33,34
"912347720",38,2493.59461942624,2575.26915412137,2491.71993967651,16,22
"912347721",50,2423.39930651627,2170.42863390031,2635.48551585152,16,34
"912347726",43,2704.80100544501,2264.60253840326,2555.47878346624,17,26
"912347733",52,2736.30846218504,2180.6197427484,2656.6981055205,22,30
"912347742",57,2524.09476881184,2472.81535232648,2707.02236739438,23,34
"912347743",57,2758.83338253656,3079.36785561933,2707.02236739438,24,33
"912347744",40,2304.24749801241,2281.88454415578,2517.98110851286,12,28
"912347745",57,2641.68925760218,2595.25634640434,2707.02236739438,17,40
"912347764",62,2411.4276370316,2136.73867750469,2753.94837323248,28,34
"912347765",65,2627.81219587372,2119.21328399192,2780.67589681985,21,44
"912347766",65,3184.75598737286,3103.6813492773,2780.67589681985,26,39
"912347767",65,2830.47602637027,2343.74094177351,2780.67589681985,26,39
"912347768",65,2413.31001039306,1730.52469791587,2780.67589681985,22,43
"912347769",74,2333.04386272064,2352.6445254308,2855.36548874306,27,47
"912347770",64,3006.98617229402,3156.61419140105,2771.87783482774,27,37
"912347771",64,2693.25680720865,2402.74898336602,2771.87783482774,26,38
"912347772",76,3077.73517760626,3235.14792788294,2870.97236507783,35,41
"912347773",79,2354.65148607252,2019.09926356353,2893.78092561085,27,52
"912347774",59,2372.62629458334,2008.8822600581,2726.17127719361,27,32
"912347775",76,2538.44160586693,2376.28583737865,2870.97236507783,27,49
"912347776",67,2548.4796065801,2460.62773696699,2797.95380131742,27,40
"912347777",81,2766.7263621458,2331.65998712116,2908.60658576875,37,44
"912347778",76,2832.0453331183,2684.63222137132,2870.97236507783,29,47
"912347779",77,2710.12759130126,1801.67748710313,2878.65357631343,24,53
"912347780",79,3124.48017750739,1813.48394397472,2893.78092561085,27,52
"912347781",59,2254.17132455043,2417.41545793208,2726.17127719361,22,37
"912347782",66,2285.2042227476,1878.16510916891,2789.3669207067,22,44
"912347783",56,2261.8148235947,1802.56133576144,2697.24673169728,17,39
"912347784",58,2273.9981883784,2084.51057251084,2716.66249357165,21,37
"912347785",60,2184.74070595205,1266.4935809139,2735.5526890818,18,42
"912347786",44,2207.26363291221,1545.88458529794,2567.51523707907,18,26
"912347787",42,2325.67155779329,1797.12533871331,2543.21752514954,16,26
"912347788",72,2627.27988009725,1939.04987825134,2839.4193288992,28,44
"912347789",59,2815.96147295196,2067.50849288498,2726.17127719361,25,34
"912347790",75,2868.43522340955,2933.74760473851,2863.21031780169,31,44
"912347791",83,3259.69014120661,3239.97151965948,2923.1438046077,40,43
"912347792",74,2590.56916537687,2457.40274881762,2855.36548874306,27,47
"912347793",93,3112.06362368252,2807.26100634169,2991.90921350397,40,53
"912347794",75,2795.27051752173,2305.8038580248,2863.21031780169,25,50
"912347795",30,2215.26766684178,1796.04905067501,2374.18906024059,9,21
"912347828",8,1758.33105151379,1626.34882135157,1812.11073017574,2,6
"912347829",4,1481.85201631946,1323.64253823482,1572.73281143487,1,3
"912347830",3,1439.8353651524,1333.6342504277,1482.92019466158,1,2
"912347831",4,1466.22361533402,1343.59464404924,1572.73281143487,0,4
"912347834",12,1558.84534680763,949.794537700899,1968.69006049611,2,10
"912347835",9,1631.68511664538,1196.7920279878,1856.26587460569,2,7
"912347836",6,1592.6402510709,1436.08553701005,1708.62817714657,1,5
"912347837",10,1654.73466493952,1327.76508114613,1896.67490607898,3,7
"912347838",9,1648.73614499634,1437.41413503184,1856.26587460569,3,6
"912347839",3,1423.61669099069,1457.71411938187,1482.92019466158,1,2
"912347840",5,1485.05523636953,1184.22351669422,1646.12614877363,0,5
"912347842",5,1489.5014226738,1095.33531720544,1646.12614877363,0,5
"912347843",3,1420.88006076079,1464.70177384509,1482.92019466158,0,3
"912347852",9,1800.1508693893,1730.78847237105,1856.26587460569,2,7
"912347853",18,1792.48189929813,1757.23751225673,2138.79896507223,2,16
"912347854",14,1745.30179745972,1697.05531548093,2031.70713799962,2,12
"912347855",11,1783.04693288898,1608.01118490128,1933.98659929558,2,9
"912347856",6,1678.12854294157,1618.7698802997,1708.62817714657,2,4
"912347858",12,1794.70401064623,1886.42032475821,1968.69006049611,2,10
"912347859",8,1764.53440510733,1718.21208228802,1812.11073017574,2,6
"912347860",13,1839.64936475062,1731.0897014598,2001.16379457045,3,10
"912347861",8,1726.77618139025,1688.09016311241,1812.11073017574,2,6
"912347862",11,1739.7362958183,1813.66765568455,1933.98659929558,3,8
"912347863",9,1791.77104481041,1762.39491673849,1856.26587460569,2,7
"912347864",9,1789.0180088497,1752.05939713372,1856.26587460569,3,6
"912347865",8,1736.45846317433,1724.75816006322,1812.11073017574,2,6
"912347866",8,1764.53440510733,1686.59274114504,1812.11073017574,2,6
"912347867",11,1877.13107021375,1753.92587543678,1933.98659929558,3,8
"912349127",14,1638.21656518473,1054.19647198193,2031.70713799962,2,12
"912349128",12,1693.7753920408,1257.74755920213,1968.69006049611,3,9
"912349129",14,1673.53554119568,1375.20871851184,2031.70713799962,3,11
"912349130",8,1621.83730757546,1358.56059005251,1812.11073017574,2,6
"912349131",7,1675.73440998474,1607.7748221273,1763.32076508842,3,4
"912349132",12,1724.93724662641,1476.00034081303,1968.69006049611,3,9
"912349133",14,1796.40630458617,1594.71082768914,2031.70713799962,4,10
"912349134",16,1739.60327888862,1325.39661644177,2087.92318348224,3,13
"912349135",14,1828.76798898639,1847.48348171697,2031.70713799962,5,9
"912349136",15,1847.77107149331,1911.10813679496,2060.56118614118,4,11
"912349137",14,1850.35661619563,1922.0889962132,2031.70713799962,4,10
"912349138",13,1829.93945627201,1347.45015975453,2001.16379457045,4,9
"912349139",13,1763.32429955956,1548.37299787002,2001.16379457045,4,9
"912349140",13,1739.56009698044,1509.9730567608,2001.16379457045,4,9
"912349141",13,1730.71786702041,1316.17196708104,2001.16379457045,3,10
"912349142",10,1699.19986479021,1263.44603586618,1896.67490607898,3,7
"912349143",14,1836.14603718107,1868.4571288877,2031.70713799962,5,9
"912349144",16,1841.68912368449,1750.69607430028,2087.92318348224,3,13
"912349145",9,1737.23789515974,1692.91640491098,1856.26587460569,3,6
"912349146",11,1802.48274815601,1914.53864153736,1933.98659929558,5,6
"912349147",14,1726.59583356963,1517.80480197677,2031.70713799962,3,11
"912349148",15,1724.31677932692,1382.50816244866,2060.56118614118,3,12
"912349149",7,1705.4811037157,1685.16090158081,1763.32076508842,2,5
"912349150",9,1760.77190520823,1689.39867657624,1856.26587460569,4,5
"912349151",9,1734.63857873933,1484.7982206236,1856.26587460569,2,7
"912349152",10,1795.77609854386,1755.73176109916,1896.67490607898,2,8
"912349153",11,1741.89025987346,1378.23136373115,1933.98659929558,3,8
"912349154",11,1739.28802732334,1376.06630055081,1933.98659929558,3,8
"912349155",13,1801.47030798168,1426.83715658901,2001.16379457045,3,10
"912349156",11,1683.55550891132,1446.20137159579,1933.98659929558,3,8
"912349157",13,1765.19536274345,1695.0266179496,2001.16379457045,4,9
"912349158",14,1791.28270164644,2013.93543105928,2031.70713799962,4,10
"912349159",15,1801.30214709391,1723.09725960715,2060.56118614118,5,10
"912349160",14,1826.13922965089,1691.99283496972,2031.70713799962,4,10
"912349161",8,1673.7857371218,1355.97642235028,1812.11073017574,3,5
"912349162",8,1655.89461452586,1521.16768498822,1812.11073017574,2,6
"912349163",4,1568.69264005966,1562.68340262163,1572.73281143487,2,2
"912349164",5,1629.90482599211,1684.62773462721,1646.12614877363,1,4
"912349165",11,1680.07424234573,1526.15791114807,1933.98659929558,3,8
"912349166",13,1737.54207458708,1533.78302051001,2001.16379457045,3,10
"912349167",11,1699.28899990782,1298.44745762993,1933.98659929558,3,8
"912349168",13,1694.59161525363,1471.12166189693,2001.16379457045,3,10
"912349169",12,1772.65264110005,1294.89776800411,1968.69006049611,4,8
"912349170",14,1728.23893715652,1463.5958529784,2031.70713799962,4,10
"912349171",13,1703.54224715194,1462.4812101462,2001.16379457045,5,8
"912349172",12,1783.96066950764,1534.31069606847,1968.69006049611,4,8
"912349173",2,1363.86032653284,1357.07552586102,1364.97646362037,1,1
"912349174",4,1516.03025468959,1565.4248710839,1572.73281143487,1,3
"912349175",21,1750.54311176133,1193.23652979098,2207.26116887512,8,13
"912349176",17,1774.53675269462,1371.8188712954,2113.95669457394,5,12
"912349177",17,1794.83946962575,1373.01116750019,2113.95669457394,5,12
"912349178",18,1752.5666377424,1507.28476203508,2138.79896507223,7,11
"912349179",24,1753.08863127957,1114.99822838325,2268.33468283819,5,19
"912349180",20,1682.76310855262,1398.49446392666,2185.35845629437,7,13
"912349181",22,1691.48864578752,1221.4881979045,2228.3491786518,5,17
"912349182",19,1867.12577860687,1494.43404620889,2162.56636020013,5,14
"912349183",17,1864.96169751944,1713.12392094633,2113.95669457394,5,12
"912349184",18,1832.34773603941,1630.32075425334,2138.79896507223,4,14
"912349185",12,1783.34427403437,1523.53795043696,1968.69006049611,3,9
"912349187",6,1616.61325276706,1463.89304836064,1708.62817714657,2,4
"912349188",16,1779.2882417509,1334.87814136732,2087.92318348224,4,12
"912349189",18,1835.1372852963,1535.34812633646,2138.79896507223,5,13
"912349190",12,1864.24047043875,1797.32511738622,1968.69006049611,3,9
"912349191",12,1827.34660887365,1699.45759504275,1968.69006049611,3,9
"912349192",9,1699.12522293093,1606.4513294488,1856.26587460569,3,6
"912349193",12,1785.32513252296,1625.4820934396,1968.69006049611,4,8
"912349194",7,1588.71487588233,1572.71240641151,1763.32076508842,1,6
"912349195",6,1562.79115968992,1551.56278651226,1708.62817714657,1,5
"912349196",4,1502.85167529139,1537.55092546968,1572.73281143487,0,4
"912349197",5,1546.61530445321,1560.38795603981,1646.12614877363,1,4
"912349198",7,1595.73986206206,1664.99465438643,1763.32076508842,2,5
"912349199",7,1620.43783308067,1706.15520793773,1763.32076508842,2,5
"912349200",8,1675.88781761181,1561.33499943831,1812.11073017574,3,5
"912349201",6,1621.06760426541,1546.40430837818,1708.62817714657,2,4
"912349202",7,1605.81623603874,1481.04855024982,1763.32076508842,3,4
"912349203",6,1612.23767771791,1608.88118427663,1708.62817714657,2,4
"912349205",3,1423.00921718486,1408.77948973186,1482.92019466158,1,2
"912349206",14,1866.64266096952,1722.4873176529,2031.70713799962,4,10
"912349207",13,1799.99071726571,1588.69278816308,2001.16379457045,3,10
"912349208",18,1828.54118936208,1578.5094833801,2138.79896507223,4,14
"912349209",17,1765.03809568548,1608.85503765737,2113.95669457394,4,13
"912349210",14,1879.2909119669,1956.91170154829,2031.70713799962,4,10
"912349211",14,1859.58047689622,1787.20369139231,2031.70713799962,5,9
"912349212",16,1822.71628411873,1758.3903423995,2087.92318348224,4,12
"912349213",18,1835.9429355999,1866.21727861599,2138.79896507223,4,14
"912349214",13,1873.92963203055,1728.51979304399,2001.16379457045,4,9
"912349215",13,1891.14823525183,1880.27539360073,2001.16379457045,5,8
"912349216",18,1800.29546850018,1581.96842552207,2138.79896507223,3,15
"912349217",11,1749.76377793435,1437.66263630482,1933.98659929558,3,8
"912349218",19,1768.25903744361,1501.39477895815,2162.56636020013,5,14
"912349219",21,1755.84874531056,1453.03695315561,2207.26116887512,4,17
"912349220",11,1790.0728253553,1696.11057017428,1933.98659929558,4,7
"912349221",11,1731.31792651301,1191.67112095165,1933.98659929558,3,8
"912349222",12,1808.81757348356,1702.61086040537,1968.69006049611,4,8
"912349224",13,1848.65072461954,1839.9346777044,2001.16379457045,3,10
"912349225",14,1874.21527488064,1685.0222839622,2031.70713799962,3,11
"912349226",11,1869.37451793812,1860.97354191644,1933.98659929558,3,8
"912349227",13,1874.06656622635,1767.63491867752,2001.16379457045,3,10
"912349228",11,1715.78286510275,1414.82105481,1933.98659929558,3,8
"912349229",14,1845.85371851589,1943.02979346674,2031.70713799962,4,10
"912349230",15,1909.59229599897,1807.55376368142,2060.56118614118,4,11
"912349231",13,1856.84002910859,1827.37867069696,2001.16379457045,3,10
"912349232",21,1813.6894446201,1703.48495906213,2207.26116887512,5,16
"912349233",15,1918.70216911331,1971.42357460922,2060.56118614118,5,10
"912349234",10,1770.76355669695,1649.39242945091,1896.67490607898,4,6
"912349235",10,1840.48864337977,1820.77747229404,1896.67490607898,3,7
"912349236",17,1763.814928311,1491.1058996215,2113.95669457394,4,13
"912349237",13,1795.90799635709,1651.89366666602,2001.16379457045,3,10
"912349238",13,1776.63155973725,1731.71192037265,2001.16379457045,4,9
"912349239",11,1732.32702422408,1537.19043271027,1933.98659929558,3,8
"912349240",10,1729.3043636069,1297.34661080921,1896.67490607898,3,7
"912349241",12,1789.32928134272,1666.94729362083,1968.69006049611,3,9
"912349242",13,1873.92963203055,1882.89956392868,2001.16379457045,4,9
"912349243",10,1836.12539100906,1832.28260420262,1896.67490607898,4,6
"912349244",16,1876.23161934324,1692.63487046419,2087.92318348224,4,12
"912349245",17,1801.36109817432,1534.92115896509,2113.95669457394,3,14
"912349246",15,1899.10377626043,1696.17825846536,2060.56118614118,4,11
"912349247",19,1853.59340300517,1606.43623766296,2162.56636020013,4,15
"912349248",17,1845.57971143877,1799.60007628511,2113.95669457394,4,13
"912349249",16,1879.60110183208,1738.1344456007,2087.92318348224,4,12
"912349250",15,1801.42112645528,1578.02427352092,2060.56118614118,4,11
"912349251",13,1786.59285832334,1779.26627535605,2001.16379457045,4,9
"912349253",8,1765.37485360177,1721.66312810281,1812.11073017574,2,6
"912349254",9,1777.54669044752,1836.24838525106,1856.26587460569,2,7
"912349255",5,1650.28324376403,1816.82415454557,1646.12614877363,0,5
"912349258",9,1791.52474356062,1993.38235561531,1856.26587460569,1,8
"912349259",8,1729.24356694734,1781.98690918196,1812.11073017574,1,7
"912349264",9,1696.03270234764,1630.74085652464,1856.26587460569,2,7
"912349265",12,1747.47524748457,1512.21119114112,1968.69006049611,1,11
"912349266",10,1776.01475469573,1752.73913047624,1896.67490607898,2,8
"912349267",10,1683.28173165905,1571.18977071276,1896.67490607898,0,10
"912349268",9,1777.99876787184,1754.00357571069,1856.26587460569,2,7
"912349270",11,1761.90846741528,1865.45232536051,1933.98659929558,1,10
"912349272",6,1653.8961533709,1693.2704568714,1708.62817714657,1,5
"912349273",8,1694.00992042589,1489.67430385247,1812.11073017574,1,7
"912349274",6,1689.62232699943,1813.69754933903,1708.62817714657,0,6
"912349275",10,1701.91987194284,1331.91920773777,1896.67490607898,1,9
"912349277",9,1748.49579826114,1868.09728318129,1856.26587460569,1,8
"912349279",7,1693.0080196572,1370.7957631652,1763.32076508842,0,7
"912349280",10,1672.34613435,1651.27924073111,1896.67490607898,0,10
"912349281",8,1750.00542714546,1784.36090159372,1812.11073017574,0,8
"912349282",11,1711.95878330697,1671.176035124,1933.98659929558,0,11
"912349283",12,1671.76621198807,1290.12525996031,1968.69006049611,1,11
"912349284",12,1762.94992888529,1624.40754834016,1968.69006049611,3,9
"912349285",6,1653.8961533709,1617.12498245455,1708.62817714657,1,5
"912349286",8,1724.43928681746,1414.43707374901,1812.11073017574,2,6
"912349287",7,1702.5401794992,1440.49971777219,1763.32076508842,1,6
"912349288",10,1814.77026160174,1889.44541823683,1896.67490607898,2,8
"912349289",9,1702.30786088422,1363.74086896812,1856.26587460569,2,7
"912349290",5,1661.99189573918,1681.95118659895,1646.12614877363,0,5
"912349291",6,1697.91889604399,1766.38283655519,1708.62817714657,0,6
"912349292",5,1608.56638524722,1703.36012144854,1646.12614877363,1,4
"912349293",6,1721.77497995665,1782.79195759616,1708.62817714657,0,6
"912349294",5,1642.6200192731,1658.28915382188,1646.12614877363,1,4
"912349295",7,1677.63536853089,1266.08427777865,1763.32076508842,1,6
"912349296",9,1800.25481403123,1401.82815612104,1856.26587460569,3,6
"912349298",8,1762.68195250863,1779.09548495149,1812.11073017574,2,6
"912349299",7,1769.25625735609,1778.57914803184,1763.32076508842,2,5
"912349300",9,1635.39883776744,996.455635815012,1856.26587460569,0,9
"912349302",6,1685.74136438971,1751.75955999647,1708.62817714657,1,5
"912349303",7,1717.53224047466,1827.2082018933,1763.32076508842,2,5
"912349304",8,1795.87570790074,1757.4585899303,1812.11073017574,3,5
"912349305",5,1642.6200192731,1624.11612270109,1646.12614877363,1,4
"912349306",12,1842.20393249804,1865.56899134709,1968.69006049611,2,10
"912349308",11,1833.09162948014,1877.13491489848,1933.98659929558,2,9
"912349309",5,1652.50216632943,1730.61312757331,1646.12614877363,0,5
"912349310",6,1679.78399337103,1741.98883737298,1708.62817714657,1,5
"912349312",7,1603.53781610299,1351.6720589859,1763.32076508842,1,6
"912349313",5,1583.92345512963,1548.13181512878,1646.12614877363,1,4
"912349316",9,1566.94566506802,1179.34392437689,1856.26587460569,2,7
"912349317",8,1570.19660200331,1058.10563181886,1812.11073017574,1,7
"912349318",6,1594.83744289604,1578.79000968595,1708.62817714657,2,4
"912349319",11,1648.34834217381,1464.78804375837,1933.98659929558,4,7
"912349320",4,1542.07460496898,1522.87413775297,1572.73281143487,3,1
"912349321",12,1870.41008559125,1954.85077080408,1968.69006049611,4,8
"912349322",8,1840.34003826351,1777.46299904561,1812.11073017574,3,5
"912349323",13,1878.05400487909,1891.49544909576,2001.16379457045,4,9
"912349324",9,1794.23027474534,1761.46032805002,1856.26587460569,3,6
"912349325",10,1736.32126004848,1642.33440381023,1896.67490607898,2,8
"912349326",9,1793.91813116892,1705.9972044598,1856.26587460569,3,6
"912349327",15,1772.79716260539,1208.45788224941,2060.56118614118,5,10
"912349328",19,1879.52242024338,1618.12535055024,2162.56636020013,4,15
"912349329",9,1760.39671651577,1716.0897938727,1856.26587460569,3,6
"912349330",17,1729.91815654543,1521.0264600814,2113.95669457394,4,13
"912349331",10,1766.43930567591,1548.9351587453,1896.67490607898,3,7
"912349332",14,1724.71672593869,1427.71976289038,2031.70713799962,4,10
"912349333",10,1759.55326385174,1460.97244183698,1896.67490607898,3,7
"912349334",8,1775.49122791805,1704.23594433149,1812.11073017574,3,5
"912349335",12,1816.26840085792,1902.27978827303,1968.69006049611,4,8
"912349336",13,1846.50496771624,1619.99639743803,2001.16379457045,4,9
"912349337",12,1832.43687489895,1637.37895266524,1968.69006049611,3,9
"912349338",11,1756.91795195661,1550.68826392206,1933.98659929558,4,7
"912349339",17,1805.2578615496,1693.96380515681,2113.95669457394,5,12
"912349340",11,1846.94909007513,1861.2596163249,1933.98659929558,4,7
"912349341",9,1708.81151570655,1661.2131296446,1856.26587460569,3,6
"912349342",4,1542.20293086405,1440.6251584405,1572.73281143487,2,2
"912349343",7,1690.82664637545,1596.94847270921,1763.32076508842,3,4
"912349344",11,1804.83434427018,1758.61869907376,1933.98659929558,3,8
"912349345",11,1690.59506334802,1648.65435609573,1933.98659929558,3,8
"912349346",10,1733.88048315682,1719.14821433684,1896.67490607898,3,7
"912349347",15,1767.11631502993,1589.32241702102,2060.56118614118,3,12
"912349348",12,1716.39178965864,1338.3475633464,1968.69006049611,4,8
"912349349",12,1748.39787227246,1655.21693964709,1968.69006049611,3,9
"912349350",9,1712.52163526614,1718.85530446989,1856.26587460569,3,6
"912349351",15,1761.49133861612,1492.0255346538,2060.56118614118,4,11
"912349352",17,1702.30071615698,1353.29881334745,2113.95669457394,4,13
"912349353",10,1792.4411927215,1673.1644813937,1896.67490607898,3,7
"912349354",12,1670.64123570514,1567.33433364322,1968.69006049611,3,9
"912349355",15,1760.47200787409,1348.18825628162,2060.56118614118,5,10
"912349356",11,1802.88720960715,1703.42758538226,1933.98659929558,4,7
"912349357",9,1660.18628323293,1337.09256759649,1856.26587460569,2,7
"912349358",12,1767.40541825829,1627.89512475632,1968.69006049611,4,8
"912349359",13,1760.63119433747,1565.69848513947,2001.16379457045,3,10
"912349360",19,1793.07115456908,1677.94460939843,2162.56636020013,5,14
"912349362",18,1798.73123772633,1448.56166046648,2138.79896507223,5,13
"912349363",14,1707.87557957555,1177.37017703595,2031.70713799962,4,10
"912349364",18,1751.49124155744,1306.70899465364,2138.79896507223,5,13
"912349365",16,1800.00082705246,1641.36395183852,2087.92318348224,5,11
"912349366",17,1766.86815873883,1448.91102403357,2113.95669457394,4,13
"912349367",18,1747.414221424,1303.92440587467,2138.79896507223,4,14
"912349368",22,1754.67213078258,1185.18132518604,2228.3491786518,5,17
"912349369",17,1766.17384678788,1393.33550288936,2113.95669457394,4,13
"912349370",19,1741.16422779407,1420.48089864373,2162.56636020013,4,15
"912349371",14,1774.82220388677,1730.90171965147,2031.70713799962,4,10
"912349372",16,1784.78421101726,1518.98109424408,2087.92318348224,5,11
"912349373",12,1732.05966262511,1654.90199545408,1968.69006049611,3,9
"912349374",10,1735.1043360266,1796.40110539591,1896.67490607898,4,6
"912349375",15,1765.64007062707,1645.61084084091,2060.56118614118,3,12
"912349376",8,1711.26947013307,1576.78748683562,1812.11073017574,2,6
"912349377",11,1791.90945480708,1508.71138134619,1933.98659929558,4,7
"912349379",13,1860.70000657678,1747.58374850315,2001.16379457045,4,9
"912349380",17,1829.6116790112,1906.52256759414,2113.95669457394,5,12
"912349381",13,1858.71943625494,1701.02576219268,2001.16379457045,5,8
"912349382",14,1893.25524631909,1800.97988050699,2031.70713799962,4,10
"912349383",11,1834.35199128512,1799.36256549803,1933.98659929558,4,7
"912349384",13,1846.19286448689,1668.63992429525,2001.16379457045,4,9
"912349385",11,1780.46123725631,1597.1610360611,1933.98659929558,2,9
"912349386",15,1812.48425969979,1793.89303189266,2060.56118614118,4,11
"912349387",20,1801.94178816231,1953.541931576,2185.35845629437,6,14
"912349388",13,1808.693078436,1723.98431584514,2001.16379457045,4,9
"912349389",15,1830.48160011504,1466.716914855,2060.56118614118,3,12
"912349390",22,1755.3884109937,1325.43695236524,2228.3491786518,5,17
"912349391",11,1831.69641990787,1675.28453736786,1933.98659929558,3,8
"912349392",7,1680.87062929004,1594.29008714344,1763.32076508842,3,4
"912349393",14,1851.24151940536,1802.30278236836,2031.70713799962,4,10
"912349394",13,1850.51286656677,1647.42347212246,2001.16379457045,5,8
"912349395",12,1781.18739141544,1609.02909486614,1968.69006049611,4,8
"912349396",10,1785.85001780514,1355.83558009061,1896.67490607898,4,6
"912349397",16,1869.81366076932,1837.18899094507,2087.92318348224,3,13
"912349398",12,1789.85296613012,1675.61805062663,1968.69006049611,3,9
"912349399",15,1854.29222656367,1513.04392976273,2060.56118614118,4,11
"912349400",10,1820.44173748789,1887.85825468993,1896.67490607898,3,7
"912349401",8,1771.94552915025,1807.97836435119,1812.11073017574,2,6
"912349402",12,1883.09985206054,1969.87811229057,1968.69006049611,4,8
"912349403",3,1435.48897613853,1247.22324201427,1482.92019466158,0,3
"912349404",5,1585.3572101579,1491.60390321976,1646.12614877363,0,5
"912349405",2,1340.79519043948,1261.94286823747,1364.97646362037,0,2
"912349407",6,1528.27125599885,1121.46504729608,1708.62817714657,1,5
"912349408",6,1590.5844087181,1449.26670268298,1708.62817714657,1,5
"912349409",6,1600.00564868329,1439.34602922318,1708.62817714657,1,5
"912349410",6,1555.10351702639,1540.25190739695,1708.62817714657,2,4
"912349411",9,1622.34105350855,1391.03083500528,1856.26587460569,2,7
"912349412",13,1652.93328873186,1536.3657608994,2001.16379457045,3,10
"912349413",10,1655.39850378786,1337.29721425397,1896.67490607898,2,8
"912349414",5,1485.05523636953,1184.22351669422,1646.12614877363,0,5
"912349415",5,1489.5014226738,1088.56499299344,1646.12614877363,0,5
"912349416",3,1420.88006076079,1464.70177384509,1482.92019466158,0,3
"912349417",3,1439.8353651524,1332.73630278294,1482.92019466158,1,2
"912349418",4,1500.65733324928,1456.81343839107,1572.73281143487,0,4
"912349420",9,1631.68511664538,1196.7920279878,1856.26587460569,2,7
"912349421",17,1759.25598920744,1341.61659273492,2113.95669457394,4,13
"912349422",16,1725.30313581631,1392.61115999644,2087.92318348224,2,14
"912349423",20,1804.38933106612,1164.94199371866,2185.35845629437,4,16
"912349424",17,1833.74011102303,1403.93698531995,2113.95669457394,5,12
"912349425",18,1887.63104608728,1426.54362341756,2138.79896507223,5,13
"912349426",13,1831.67027715468,1355.54971261171,2001.16379457045,4,9
"912349427",14,1876.79170989186,1981.5011252794,2031.70713799962,5,9
"912349428",11,1881.75181212793,1845.99451433319,1933.98659929558,4,7
"912349429",8,1811.06743359756,1819.74651202871,1812.11073017574,4,4
"912349430",11,1844.91617269693,1786.90409343675,1933.98659929558,5,6
"912349431",10,1822.14395628395,1788.95559404589,1896.67490607898,4,6
"912349432",12,1840.27284223795,1775.05902928437,1968.69006049611,3,9
"912349433",11,1818.67462658599,1835.75074902965,1933.98659929558,3,8
"912349434",12,1828.72669152551,1631.15956499839,1968.69006049611,4,8
"912349435",16,1878.07495263892,1626.8966697313,2087.92318348224,4,12
"912349436",11,1822.84466896691,1642.41812404064,1933.98659929558,4,7
"912349437",14,1869.25007158651,1825.44279329494,2031.70713799962,4,10
"912349438",16,1825.64735358679,1366.38713579822,2087.92318348224,4,12
"912349439",12,1882.46396378414,1382.38968668074,1968.69006049611,3,9
"912349440",17,1682.71532221879,977.78472015019,2113.95669457394,5,12
"912349441",16,1752.23115602444,1073.15250040795,2087.92318348224,4,12
"912349442",16,1855.10301718203,1717.23933629247,2087.92318348224,4,12
"912349443",17,1750.40853210594,1571.64988212673,2113.95669457394,4,13
"912349444",10,1645.92212644852,1372.46289890677,1896.67490607898,4,6
"912349445",12,1664.9336620222,1238.45204340827,1968.69006049611,3,9
"912349446",10,1720.72901271792,1667.3533728391,1896.67490607898,3,7
"912349447",9,1647.54687209612,1541.73028114975,1856.26587460569,2,7
"912349448",13,1817.92948726624,1848.5341802719,2001.16379457045,3,10
"912349449",13,1757.57072378754,1559.96916789871,2001.16379457045,5,8
"912349450",17,1851.24428727963,1862.45374940575,2113.95669457394,5,12
"912349451",13,1858.15930682308,1922.47443997833,2001.16379457045,4,9
"912349452",14,1837.94656871819,1695.92453406726,2031.70713799962,4,10
"912349453",17,1855.03883250289,1846.80249428006,2113.95669457394,6,11
"912349454",11,1819.8345007512,1677.5234008734,1933.98659929558,3,8
"912349455",12,1862.31192352,1885.47501042747,1968.69006049611,4,8
"912349456",19,1767.67141075182,1275.21111490554,2162.56636020013,3,16
"912349457",22,1713.91489030686,967.56977902217,2228.3491786518,4,18
"912349458",19,1744.62799443615,1078.6232471695,2162.56636020013,3,16
"912349459",17,1823.22304135145,1195.3331653587,2113.95669457394,4,13
"912349460",3,1384.66675302346,1406.61371103534,1482.92019466158,0,3
"912349461",1,1152.12913723444,1127.00397591397,1184.66451052022,0,1
"912349462",14,1548.72456613121,1009.28556884779,2031.70713799962,4,10
"912349463",13,1595.44538356929,952.879399272883,2001.16379457045,4,9
"912349464",13,1741.84122926427,1508.46283545559,2001.16379457045,4,9
"912349465",11,1629.63104347349,919.926199046837,1933.98659929558,3,8
"912349466",10,1657.42412102717,1538.79401133411,1896.67490607898,3,7
"912349467",10,1628.95656810346,1479.65246410296,1896.67490607898,3,7
"912349468",7,1596.26042032786,1119.46750312673,1763.32076508842,3,4
"912349469",9,1608.3070516873,1093.49300116779,1856.26587460569,2,7
"912349470",12,1703.39649199653,1767.05062020174,1968.69006049611,3,9
"912349471",9,1638.35162380288,1595.44923392812,1856.26587460569,2,7
"912349472",9,1621.01180567942,1568.24385953522,1856.26587460569,2,7
"912349473",12,1689.07622173366,1376.56957646329,1968.69006049611,2,10
"912349474",10,1665.10591605036,1285.67842485329,1896.67490607898,2,8
"912349475",13,1668.83135174555,1192.31502570116,2001.16379457045,5,8
"912349476",12,1685.54216245975,1619.49884549657,1968.69006049611,3,9
"912349477",6,1560.45285660871,1499.26904060768,1708.62817714657,0,6
"912349478",10,1651.67277989071,1505.89504656588,1896.67490607898,2,8
"912349479",10,1715.92209525588,1653.71523230077,1896.67490607898,4,6
"912349480",11,1596.92365823764,1211.17141760064,1933.98659929558,2,9
"912349481",14,1678.30158194743,1105.66667903815,2031.70713799962,3,11
"912349482",13,1669.50161440983,1278.14278024789,2001.16379457045,5,8
"912349483",13,1687.6150870039,1206.44177414143,2001.16379457045,4,9
"912349484",8,1593.14878853995,1460.50890413737,1812.11073017574,2,6
"912349485",5,1483.73404408773,1470.46133441102,1646.12614877363,0,5
"912349487",6,1573.15040710568,1522.64286902961,1708.62817714657,0,6
"912349488",12,1620.40205689665,1204.05596166624,1968.69006049611,2,10
"912349489",11,1598.76159063728,1499.47401741062,1933.98659929558,2,9
"912349490",9,1591.87664460472,1224.69238254503,1856.26587460569,1,8
"912349491",9,1676.6793807718,1387.7783031723,1856.26587460569,1,8
"912349492",11,1698.91683116507,1546.00815566637,1933.98659929558,4,7
"912349493",12,1675.41539121727,1426.05910569055,1968.69006049611,3,9
"912349494",13,1644.64236097369,1517.47877627471,2001.16379457045,4,9
"912349495",9,1654.77727024975,1567.05559510842,1856.26587460569,3,6
"912349496",14,1677.81164599405,1191.89514927255,2031.70713799962,4,10
"912349497",11,1676.39652369336,1249.25571672369,1933.98659929558,4,7
"912349498",17,1622.81143076035,828.711331864681,2113.95669457394,4,13
"912349499",14,1699.20139300912,1263.34774121696,2031.70713799962,4,10
"912349500",13,1641.69727536588,1275.11752111307,2001.16379457045,3,10
"912349501",16,1624.0051272633,965.294148863117,2087.92318348224,2,14
"912349502",10,1649.93776699649,1345.63085426682,1896.67490607898,3,7
"912349503",8,1604.10633385578,1239.87592911546,1812.11073017574,2,6
"912349504",17,1824.68768613595,1518.22735770385,2113.95669457394,6,11
"912349505",14,1818.45177377031,1564.54035552524,2031.70713799962,4,10
"912349506",18,1821.74364040782,1539.30229721054,2138.79896507223,5,13
"912349507",16,1832.25877381411,1732.58515838427,2087.92318348224,4,12
"912349508",17,1905.51841550773,1512.57210807352,2113.95669457394,5,12
"912349509",18,1836.33759732486,1721.10754631663,2138.79896507223,5,13
"912349510",13,1886.17654733716,1922.56662896374,2001.16379457045,4,9
"912349511",16,1871.73679716184,1654.67019607162,2087.92318348224,5,11
"912349512",17,1800.47678141351,1778.43220106693,2113.95669457394,4,13
"912349513",20,1853.52571722491,1621.99127622463,2185.35845629437,6,14
"912349514",9,1787.14849020801,1666.47265098638,1856.26587460569,3,6
"912349515",8,1687.56556101057,1689.61615836628,1812.11073017574,3,5
"912349516",12,1773.6648258705,1370.53022119986,1968.69006049611,4,8
"912349517",11,1804.77731613815,1760.28358484687,1933.98659929558,5,6
"912349518",10,1796.77567317506,1772.98673403158,1896.67490607898,3,7
"912349519",8,1716.01225926319,1713.60676630545,1812.11073017574,3,5
"912349520",15,1768.79306983483,1195.72980313506,2060.56118614118,4,11
"912349521",14,1782.92538455671,1241.16649788651,2031.70713799962,4,10
"912349522",13,1809.44782144666,1461.58976010429,2001.16379457045,2,11
"912349523",15,1661.33232796791,958.531070717346,2060.56118614118,4,11
"912349524",14,1726.34307947221,1506.59594063743,2031.70713799962,5,9
"912349525",15,1753.4368506828,1546.00663177949,2060.56118614118,3,12
"912349526",15,1755.75959195914,1493.72584544726,2060.56118614118,4,11
"912349527",15,1760.26197984515,1470.94940287074,2060.56118614118,4,11
"912349528",19,1615.46315456701,1050.7496787602,2162.56636020013,5,14
"912349529",10,1769.3899291772,1587.31493345437,1896.67490607898,3,7
"912349530",14,1780.23187054691,1555.50823697572,2031.70713799962,3,11
"912349531",9,1734.00560003776,1510.36439365702,1856.26587460569,2,7
"912349532",18,1809.23091143703,1577.00071666481,2138.79896507223,5,13
"912349533",18,1826.92485612262,1664.86028738094,2138.79896507223,5,13
"912349534",14,1712.08225309468,1758.78209573317,2031.70713799962,3,11
"912349535",9,1687.94978347591,1377.79928261223,1856.26587460569,3,6
"912349536",13,1810.8840669951,1953.31322302382,2001.16379457045,4,9
"912349537",12,1848.87791338747,1933.90275469359,1968.69006049611,2,10
"912349538",17,1823.52837343875,1885.81930150144,2113.95669457394,3,14
"912349539",14,1902.95613858256,1907.44681314725,2031.70713799962,4,10
"912349540",15,1920.74109645989,1920.06314550865,2060.56118614118,4,11
"912349541",15,1882.09963633458,1953.74072481953,2060.56118614118,5,10
"912349542",15,1905.93691974642,1681.90680670143,2060.56118614118,4,11
"912349559",12,1758.31327948132,1646.79155834142,1968.69006049611,1,11
"912349583",20,1805.02973171888,1476.96236601754,2185.35845629437,5,15
"912349593",11,1839.14174755538,1707.90825591636,1933.98659929558,3,8
"912349605",23,2042.5411065451,1450.88398397405,2248.68783741607,5,18
"912349607",32,1870.15143750988,1359.4130238474,2405.71569249515,6,26
"912349608",23,1992.96999861308,1439.2017305631,2248.68783741607,4,19
"912349610",29,2148.30711866413,1378.1603183972,2357.79423966008,6,23
"912349612",23,1950.25888114653,1282.3871902849,2248.68783741607,5,18
"912349613",23,1914.56195126762,1558.05551114143,2248.68783741607,3,20
"912349702",7,1649.67758584295,1704.54263903933,1763.32076508842,1,6
"912349703",9,1621.68674798107,1256.36292760891,1856.26587460569,1,8
"912349704",6,1555.01133752391,1331.25913251112,1708.62817714657,1,5
"912349705",7,1622.42439825829,1531.97258563552,1763.32076508842,1,6
"912349706",7,1636.80786939881,1730.96142649818,1763.32076508842,1,6
"912349707",7,1589.70044815686,1300.96658857839,1763.32076508842,2,5
"912349708",9,1706.02199595337,1743.90501073481,1856.26587460569,1,8
"912349709",8,1626.21910253695,1506.08578748074,1812.11073017574,2,6
"912349725",8,1705.340654162,1689.60916137409,1812.11073017574,3,5
"912349726",1,1161.73054778348,1159.49316804608,1184.66451052022,0,1
"912349727",3,1443.55359762675,1443.27199045718,1482.92019466158,1,2
"912349728",4,1508.31283787556,1544.31548801488,1572.73281143487,1,3
"912349729",6,1693.65232414268,1653.09865616935,1708.62817714657,2,4
"912349730",4,1551.99817751276,1606.97628582058,1572.73281143487,0,4
"912349731",3,1462.05363048004,1495.27309432216,1482.92019466158,2,1
"912349732",3,1458.75835505736,1482.92019466158,1482.92019466158,1,2
"912349733",11,1710.87049720784,1407.59227081444,1933.98659929558,3,8
"912349734",13,1830.31782581705,1527.87223055518,2001.16379457045,4,9
"912349735",3,1472.63045812309,1502.69773945629,1482.92019466158,1,2
"912349736",1,1158.1580747686,1184.66451052022,1184.66451052022,1,0
"912349737",1,1158.1580747686,1184.66451052022,1184.66451052022,1,0
"912349738",2,1294.80977874145,1303.92936312956,1364.97646362037,2,0
"912349739",2,1321.6396047043,1364.97646362037,1364.97646362037,2,0
"912349742",5,1556.86979259587,1624.66202231872,1646.12614877363,1,4
"912349743",4,1565.41134863356,1519.2582327512,1572.73281143487,1,3
"912349744",5,1564.09404797346,1511.27438256396,1646.12614877363,2,3
"912349745",3,1452.18100194327,1471.9524199818,1482.92019466158,1,2
"912349746",1,1166.48076072443,1184.66451052022,1184.66451052022,1,0
"912349747",2,1380.25876398244,1364.97646362037,1364.97646362037,0,2
"912349748",2,1321.6396047043,1364.97646362037,1364.97646362037,2,0
"912349749",9,1805.94823448827,1765.34034444971,1856.26587460569,3,6
"912349750",2,1327.75669022694,1342.12583799767,1364.97646362037,2,0
"912349751",5,1573.67338966683,1623.97117237993,1646.12614877363,2,3
"912349752",2,1309.73849757372,1364.97646362037,1364.97646362037,0,2
"912349753",3,1408.62461236138,1372.28507059071,1482.92019466158,2,1
"912349754",10,1714.68901067904,1595.28509741007,1896.67490607898,4,6
"912349755",14,1865.40348012322,1516.43632609703,2031.70713799962,4,10
"912349756",18,1889.98698612885,1635.41797689207,2138.79896507223,6,12
"912349759",14,1959.57558856319,1690.13997009138,2031.70713799962,5,9
"912349760",19,1883.72939156109,1746.40594092169,2162.56636020013,4,15
"912349761",21,1863.26365172316,1610.57686774491,2207.26116887512,4,17
"912349762",4,1530.66611287053,1504.98246487515,1572.73281143487,2,2
"912349763",2,1370.04708787715,1302.23502001735,1364.97646362037,1,1
"912349764",2,1303.6812205037,1283.8423401636,1364.97646362037,1,1
"912349765",2,1298.99390489522,1250.47405296395,1364.97646362037,1,1
"912349766",16,1790.28371825437,1330.13627578973,2087.92318348224,4,12
"912349767",14,1790.53296413758,1633.04208290377,2031.70713799962,2,12
"912349768",18,1840.79110478691,1422.57040616366,2138.79896507223,3,15
"912349769",14,1809.70239417171,1607.86541325505,2031.70713799962,4,10
"912349774",3,1466.82311609986,1464.69915820298,1482.92019466158,1,2
"912349775",9,1654.6593786007,1504.06314437518,1856.26587460569,0,9
"912349776",11,1799.27274115987,1723.29521613817,1933.98659929558,1,10
"912349777",19,1841.36800359003,1568.57789299024,2162.56636020013,5,14
"912349778",1,1166.48076072443,1184.66451052022,1184.66451052022,1,0
"912349779",3,1409.23980159338,1482.92019466158,1482.92019466158,2,1
"912349816",6,1626.35801762953,1610.01637965256,1708.62817714657,1,5
"912349817",3,1458.56852009454,1440.95540563331,1482.92019466158,0,3
"912349818",9,1740.03507510201,1611.34984937341,1856.26587460569,2,7
"912349819",14,1816.08399494063,1625.62547473125,2031.70713799962,4,10
"912349820",9,1625.20662544781,1513.96533023998,1856.26587460569,3,6
"912349821",9,1702.69809590125,1577.91202557409,1856.26587460569,3,6
"912349860",17,1799.81445782446,1773.58267687568,2113.95669457394,5,12
"912349861",13,1702.58799149894,1720.3698575433,2001.16379457045,4,9
"912349862",12,1837.95218854503,1555.32457936933,1968.69006049611,4,8
"912349863",18,1914.46060944058,1553.57150580654,2138.79896507223,5,13
"912349868",3,1420.36143481589,1404.1301777973,1482.92019466158,1,2
"912349869",6,1723.3015958829,1722.36239826182,1708.62817714657,1,5
"912349870",4,1509.25927395459,1475.3276369688,1572.73281143487,1,3
"912349871",11,1758.91672756742,1820.05049264112,1933.98659929558,3,8
"912349872",1,1157.36185322259,1110.50252495643,1184.66451052022,0,1
"912349873",2,1349.57368813546,1279.52664732978,1364.97646362037,1,1
"912349874",1,1157.36185322259,1117.97651538634,1184.66451052022,0,1
"912349875",3,1423.44629316604,1402.28464250135,1482.92019466158,1,2
"912349876",2,1293.91961058023,1188.25500100716,1364.97646362037,1,1
"912349877",2,1293.91961058023,1212.27717080193,1364.97646362037,1,1
"912349878",5,1519.99275051489,1455.05647835186,1646.12614877363,3,2
"912349879",2,1293.91961058023,1190.51656845748,1364.97646362037,1,1
"912349880",2,1354.87552912533,1283.51663709292,1364.97646362037,1,1
"912349881",2,1293.91961058023,1140.70737695925,1364.97646362037,1,1
"912349882",10,1771.82232069014,1597.24975201615,1896.67490607898,2,8
"912349883",10,1734.00246696194,1613.02375765323,1896.67490607898,1,9
"912349884",9,1728.35736769405,1606.54790602196,1856.26587460569,3,6
"912349885",10,1773.75592370759,1691.20021704306,1896.67490607898,3,7
"912349886",3,1411.92549888629,1482.92019466158,1482.92019466158,1,2
"912349887",1,1166.3302342754,1184.66451052022,1184.66451052022,0,1
"912349888",8,1614.28394024379,1509.66553014742,1812.11073017574,1,7
"912349889",4,1518.93261770296,1554.74818393281,1572.73281143487,1,3
"912349890",10,1684.09327007455,1410.39696930627,1896.67490607898,0,10
"912349891",12,1733.17868643943,1425.40722194268,1968.69006049611,2,10
"912349892",8,1667.43801650326,1404.52515772089,1812.11073017574,1,7
"912349893",4,1575.68253607557,1531.07388419164,1572.73281143487,2,2
"912349894",15,1815.65900634192,1458.90854154464,2060.56118614118,4,11
"912349895",7,1619.33841990415,1282.4967927287,1763.32076508842,2,5
"912349896",7,1551.8999664133,1524.1109510427,1763.32076508842,2,5
"912349897",5,1525.24660598509,1482.88163122348,1646.12614877363,2,3
"912349898",10,1766.72124941157,1436.73817137891,1896.67490607898,2,8
"912349899",8,1758.9822113955,1486.98297969695,1812.11073017574,1,7
"912349900",4,1479.95023938814,1352.96129789209,1572.73281143487,2,2
"912349901",3,1393.38830622769,1271.27192410401,1482.92019466158,0,3
"912349902",3,1422.64835407722,1286.29674276888,1482.92019466158,2,1
"912349903",5,1525.0407031142,1290.49488573716,1646.12614877363,2,3
"912349904",3,1422.64835407722,1255.78357312969,1482.92019466158,2,1
"912349905",3,1422.64835407722,1332.15105680203,1482.92019466158,2,1
"912349906",3,1378.83497595843,1210.92598311998,1482.92019466158,1,2
"912349907",4,1479.95023938814,1222.13717613162,1572.73281143487,2,2
"912349908",3,1422.64835407722,1254.65505330821,1482.92019466158,2,1
"912349909",4,1475.05153823052,1341.66673062924,1572.73281143487,3,1
"912349910",2,1293.91961058023,1217.21803914533,1364.97646362037,1,1
"912349911",5,1509.38358415791,1486.28107272277,1646.12614877363,3,2
"912349912",8,1739.36562085022,1508.10012723766,1812.11073017574,1,7
"912349913",10,1691.16338418636,1576.20955382937,1896.67490607898,3,7
"912349914",11,1830.42557460351,1736.37038473288,1933.98659929558,4,7
"912349915",9,1708.60113604482,1561.02344660968,1856.26587460569,2,7
"912349916",1,1166.48076072443,1184.66451052022,1184.66451052022,1,0
"912349917",2,1356.7769647325,1322.99440778333,1364.97646362037,1,1
"912349918",6,1611.71984477921,1581.49613973235,1708.62817714657,4,2
"912349919",6,1711.35969547508,1736.94680257083,1708.62817714657,2,4
"912349920",6,1665.72230000012,1645.5256968338,1708.62817714657,2,4
"912349921",9,1684.73147570322,1455.67629716663,1856.26587460569,1,8
"912349922",13,1775.02248485558,1460.72396354635,2001.16379457045,3,10
"912349923",1,1179.80732233099,1170.17312599152,1184.66451052022,0,1
"912349924",10,1712.73874216735,1366.87548436695,1896.67490607898,3,7
"912349925",13,1722.38909117924,1678.73958436793,2001.16379457045,5,8
"912349926",13,1864.21569084865,1761.2200566712,2001.16379457045,4,9
"912349927",14,1771.91408019652,1479.20008832893,2031.70713799962,2,12
"912349928",3,1422.64835407722,1276.52291270204,1482.92019466158,2,1
"912349929",2,1293.91961058023,1127.73941165698,1364.97646362037,1,1
"912349930",11,1767.6888240541,1414.11766849978,1933.98659929558,2,9
"912349931",15,1751.24854713467,1300.33381697649,2060.56118614118,3,12
"912349932",19,1820.8391007215,1468.93965255922,2162.56636020013,4,15
"912349933",17,1866.09796848701,1716.34292339988,2113.95669457394,3,14
"912349934",11,1770.3996141433,1550.86559506014,1933.98659929558,3,8
"912349935",16,1829.15506028943,1677.60001384967,2087.92318348224,2,14
"912349936",13,1716.95778827726,1543.52627894548,2001.16379457045,3,10
"912349937",13,1756.94943611509,1602.95196079003,2001.16379457045,4,9
"912349938",14,1839.53725225479,1660.90457027022,2031.70713799962,2,12
"912349939",14,1839.17239906822,1748.70267380148,2031.70713799962,2,12
"912349940",13,1779.16818150024,1538.4187918973,2001.16379457045,2,11
"912349941",13,1710.51082260958,1409.78205803762,2001.16379457045,4,9
"912349942",17,1727.87905514252,1264.20911802229,2113.95669457394,3,14
"912349943",14,1854.58984492452,1605.80147262806,2031.70713799962,2,12
"912349944",18,1867.96190394759,1377.91094755056,2138.79896507223,3,15
"912349945",20,1872.70476297895,1507.25179716049,2185.35845629437,4,16
"912349946",14,1714.27933362606,1599.60288597382,2031.70713799962,4,10
"912349947",13,1827.00257786033,1692.51969580563,2001.16379457045,3,10
"912349948",21,1861.39690187644,1622.93449698473,2207.26116887512,5,16
"912349949",15,1869.61640300901,1486.057826638,2060.56118614118,4,11
"912349950",18,1851.49776364714,1740.98174354775,2138.79896507223,4,14
"912349951",18,1871.1223262944,1753.45739799367,2138.79896507223,3,15
"912349952",20,1876.58931187145,1674.22017097977,2185.35845629437,4,16
"912349953",19,1802.87436519167,1830.56674387261,2162.56636020013,4,15
"912349954",15,1791.83738135167,1679.66837189277,2060.56118614118,3,12
"912349955",13,1750.08095544645,1807.15073075826,2001.16379457045,3,10
"912349956",19,1785.06870285485,1652.86845008933,2162.56636020013,4,15
"912349957",17,1903.52023307066,1730.45642592662,2113.95669457394,3,14
"912349958",14,1822.96343404053,1608.5920321014,2031.70713799962,2,12
"912349959",12,1726.22008607877,1466.13047235013,1968.69006049611,2,10
"912349960",15,1713.63125166935,1586.48535894601,2060.56118614118,4,11
"912349961",18,1727.2355465259,1677.07636896,2138.79896507223,2,16
"912349962",16,1747.04639573927,1542.66970977932,2087.92318348224,4,12
"912349963",13,1813.2324875407,1661.57124778903,2001.16379457045,3,10
"912350023",30,2174.71541084275,2026.90762290936,2374.18906024059,6,24
"912350027",18,1976.97707513798,2081.68780396976,2138.79896507223,7,11
"912350028",11,1807.99197544121,1786.41917580002,1933.98659929558,3,8
"912350043",8,1716.14079783653,1528.15346648742,1812.11073017574,2,6
"912350074",10,1837.28576617564,1799.32766641275,1896.67490607898,3,7
"912350082",11,1885.01858877216,1780.89185392861,1933.98659929558,2,9
"912350134",22,2247.30442634544,2300.20631450978,2228.3491786518,8,14
"912350188",16,1833.61573024797,1577.55954760121,2087.92318348224,2,14
"912350212",46,2480.68394195538,2256.38903885895,2590.94954296761,20,26
"912350213",43,2529.85588449535,2668.94352579776,2555.47878346624,20,23
"912350228",22,2207.26684404176,2338.67781078177,2228.3491786518,8,14
"912350229",37,2384.24348256182,2769.9967200585,2478.17471526668,17,20
"912350232",40,2454.91866677693,2147.7727178742,2517.98110851286,16,24
"912350233",36,2366.95968147872,2229.15906859968,2464.33502634194,17,19
"912350234",33,2432.9847266062,2470.5430627263,2420.89448855093,14,19
"912350235",37,2637.61243914849,2550.58052695557,2478.17471526668,18,19
"912350236",40,2715.48791197747,3451.85278662558,2517.98110851286,17,23
"912350237",43,2911.29286882981,3228.23154827788,2555.47878346624,17,26
"912350238",32,2263.08006192992,2020.94678804519,2405.71569249515,16,16
"912350239",39,2163.45137723029,1555.96376929625,2504.98447234734,17,22
"912350240",32,2326.55300267733,1670.61805663332,2405.71569249515,15,17
"912350241",43,2305.55788315799,1814.84388368496,2555.47878346624,20,23
"912350242",37,2536.36557349718,2108.30659246038,2478.17471526668,18,19
"912350243",28,2309.31954870536,1804.40862771963,2340.94327947849,9,19
"912350244",23,2073.45782131045,1439.41521036566,2248.68783741607,11,12
"912350245",34,1972.57672735338,1595.10109799652,2435.71163614839,12,22
"912350275",24,2185.78123730776,1502.64598059576,2268.33468283819,7,17
"912350289",17,1938.79035522794,1475.46231152294,2113.95669457394,6,11
"912350292",9,1776.26902232527,1749.66343799451,1856.26587460569,3,6
"912350294",74,2799.24292677415,2249.56231829289,2855.36548874306,27,47
"912350295",60,2537.1537716535,1844.34934798031,2735.5526890818,20,40
"912350313",44,2651.81148577809,1685.46735487311,2567.51523707907,17,27
"912350314",55,2553.43244090718,1724.87929379618,2687.33120998132,21,34
"912350315",51,2801.03854631226,2763.50357843211,2646.17454577679,11,40
"912350316",58,2914.26660000961,2501.76973258106,2716.66249357165,15,43
"912350317",75,3112.28596349551,2535.3035661168,2863.21031780169,22,53
"912350318",98,2763.81950351872,1873.63084730003,3024.10627920296,26,72
"912350319",99,2414.82157983909,1109.16806376271,3030.38817685238,33,66
"912350320",79,2805.71108016911,1795.99820983465,2893.78092561085,24,55
"912350321",89,2604.87427715533,1477.41486773416,2965.14449011489,31,58
"912350322",91,3117.03627359031,1752.52154503127,2978.64386243803,28,63
"912350323",104,2752.29560236031,1404.76737191577,3061.06104536539,33,71
"912350324",75,2782.49628713689,1677.85727383792,2863.21031780169,22,53
"912350327",91,2329.35513671661,1879.68592714193,2978.64386243803,33,58
"912350328",128,2587.84090592193,1203.03216787423,3193.77171424625,45,83
"912350331",86,2567.42168965173,1849.54942699479,2944.43562859908,37,49
"912350332",75,2753.22324404676,2044.57131104612,2863.21031780169,23,52
"912350333",80,2814.87397630247,2347.43618862497,2901.2306171403,30,50
"912350334",41,2599.56053726016,2062.14475688372,2530.72175773865,14,27
"912350335",94,2933.96717176759,1627.69975494893,2998.45695239283,31,63
"912350336",67,2428.97718108842,1870.55485249815,2797.95380131742,25,42
"912350337",52,2169.02188318508,1627.38031478583,2656.6981055205,18,34
"912350338",28,2355.44469873013,2214.52472352799,2340.94327947849,13,15
"912350339",79,2447.62043353183,1086.39026454298,2893.78092561085,31,48
"912350340",67,2510.64993057993,1261.57975853153,2797.95380131742,18,49
"912350341",116,3559.51640024072,2073.64923111716,3130.15231772002,35,81
"912350342",95,2841.69206129367,2510.4664033644,3004.94950458202,25,70
"912350343",77,2783.48459775203,1618.89805590943,2878.65357631343,26,51
"912350344",66,2637.29445490549,1650.79889945533,2789.3669207067,23,43
"912350345",84,2923.78925375574,1922.21580625953,2930.30814451558,23,61
"912350346",86,3566.87764208656,2797.52842602927,2944.43562859908,25,61
"912350347",92,3109.55023751357,1899.19203237657,2985.30521778333,24,68
"912350348",102,3071.33129460186,1888.19002389078,3048.93574640007,26,76
"912350349",84,3294.29731967093,2159.11829416831,2930.30814451558,19,65
"912350350",71,3294.8035877355,2786.4707758929,2831.31372136695,24,47
"912350351",105,3222.03442347221,1633.31457166895,3067.05425459434,34,71
"912350352",92,2612.29178104717,1470.58462562729,2985.30521778333,33,59
"912350353",64,2680.61548852642,2309.20019498465,2771.87783482774,23,41
"912350354",71,3017.27134966781,2021.45103081179,2831.31372136695,26,45
"912350355",85,3059.31241961941,1999.16140643936,2937.40494579778,24,61
"912350356",74,2702.44752219133,1879.37514835984,2855.36548874306,16,58
"912350401",14,1921.27198867565,1822.01227451912,2031.70713799962,2,12
"912350402",14,1763.09105835651,1875.45597045618,2031.70713799962,3,11
"912350430",22,2020.64228207891,2151.6701769603,2228.3491786518,6,16
"912350442",10,1682.7522033699,1588.21114113604,1896.67490607898,2,8
"912350443",5,1575.23413711193,1556.60233979376,1646.12614877363,1,4
"912350444",10,1744.79237327976,1806.18910207798,1896.67490607898,2,8
"912350445",13,1768.3533766789,1733.24884812775,2001.16379457045,3,10
"912350446",8,1671.098792484,1555.99334335325,1812.11073017574,3,5
"912350447",7,1654.04759480822,1514.83879073697,1763.32076508842,2,5
"912350448",6,1600.69598902577,1438.29037716336,1708.62817714657,2,4
"912350449",12,1832.54693716791,1613.97586124847,1968.69006049611,5,7
"912350470",10,1669.65444451478,1542.86322327059,1896.67490607898,2,8
"912350471",14,1877.71623410281,1676.81288002934,2031.70713799962,1,13
"912350472",12,1691.39532308585,1649.13137166475,1968.69006049611,2,10
"912350473",15,1865.45009956217,1689.7674958731,2060.56118614118,2,13
"912350475",1,1158.1580747686,1133.63141032597,1184.66451052022,1,0
"912350476",2,1290.72570957893,1322.82167125199,1364.97646362037,1,1
"912350477",1,1158.1580747686,1102.46022761699,1184.66451052022,1,0
"912350486",7,1573.10455692451,1667.95524653974,1763.32076508842,2,5
"912350487",9,1722.23835607694,1655.76514171446,1856.26587460569,4,5
"912350488",4,1496.41931361627,1572.73281143487,1572.73281143487,1,3
"912350489",4,1494.68721699344,1460.79303418904,1572.73281143487,1,3
"912350490",13,1749.54219186661,1579.77525698163,2001.16379457045,4,9
"912350491",10,1728.02335198853,1665.55322535077,1896.67490607898,5,5
"912350492",13,1813.56543974008,1573.9790547087,2001.16379457045,4,9
"912350493",7,1673.0004423562,1711.75259522918,1763.32076508842,3,4
"912350503",9,1619.97845863529,1417.67736383786,1856.26587460569,3,6
"912350504",6,1497.76376578002,1538.33117176865,1708.62817714657,3,3
"912350505",2,1303.6812205037,1343.73377081397,1364.97646362037,1,1
"912350506",4,1444.8137136122,1275.9886863286,1572.73281143487,3,1
"912350511",22,1802.90952203063,1496.96247785724,2228.3491786518,7,15
"912350512",18,1809.43991679466,1574.17772565574,2138.79896507223,4,14
"912350513",22,1815.78212062946,1427.26458766311,2228.3491786518,5,17
"912350514",20,1864.9269177402,1590.0698307812,2185.35845629437,5,15
"912350519",8,1594.91685847866,1350.09284563417,1812.11073017574,4,4
"912350520",10,1677.81337816399,1437.4730705566,1896.67490607898,4,6
"912350521",10,1763.94927322906,1797.47029287964,1896.67490607898,4,6
"912350522",11,1737.49760995935,1732.49721446872,1933.98659929558,5,6
"912350523",7,1627.73831360861,1699.45141573751,1763.32076508842,3,4
"912350524",6,1577.55515975304,1603.74516983295,1708.62817714657,0,6
"912350525",6,1652.25058461084,1553.79149745714,1708.62817714657,2,4
"912350526",10,1677.83330353412,1715.37035309226,1896.67490607898,2,8
"912350527",11,1778.6431957192,1725.18960755422,1933.98659929558,2,9
"912350528",11,1656.10732892812,1606.47178637075,1933.98659929558,2,9
"912350529",12,1734.96296329038,1532.07265960853,1968.69006049611,2,10
"912350530",11,1753.18562985959,1625.9876356405,1933.98659929558,2,9
"912350531",8,1695.3504162983,1616.41113080685,1812.11073017574,3,5
"912350532",5,1566.98174602635,1535.07754476631,1646.12614877363,3,2
"912350533",4,1526.8057594399,1574.30567796861,1572.73281143487,2,2
"912350534",10,1804.19002254632,1721.25289897752,1896.67490607898,3,7
"912350543",5,1542.45559299994,1515.50574469878,1646.12614877363,0,5
"912350544",5,1562.42593317863,1510.03878474201,1646.12614877363,1,4
"912350545",9,1686.92204503634,1607.83507205865,1856.26587460569,2,7
"912350546",7,1639.64651512964,1557.0721867967,1763.32076508842,1,6
"912350551",7,1650.29949005508,1673.5304216872,1763.32076508842,4,3
"912350552",3,1424.76789848678,1449.35625705086,1482.92019466158,1,2
"912350553",4,1487.79210471516,1483.42135426925,1572.73281143487,3,1
"912350554",2,1329.21628012236,1364.97646362037,1364.97646362037,1,1
"912350555",8,1640.41398847313,1631.28721899614,1812.11073017574,1,7
"912350556",6,1641.70061137303,1604.46549925198,1708.62817714657,2,4
"912350559",11,1744.51325031975,1609.75523193232,1933.98659929558,2,9
"912350560",8,1661.42371618605,1489.18421369234,1812.11073017574,2,6
"912350561",11,1746.31063924969,1682.30084118981,1933.98659929558,2,9
"912350562",11,1720.10744215115,1611.03699084005,1933.98659929558,2,9
"912350563",2,1377.08032457344,1371.54155128157,1364.97646362037,1,1
"912350565",4,1510.55565023312,1470.6201170108,1572.73281143487,1,3
"912350566",4,1518.3816274558,1572.73281143487,1572.73281143487,0,4
"912350567",10,1722.58538749641,1538.87926761012,1896.67490607898,2,8
"912350568",5,1546.49274738397,1513.84310196941,1646.12614877363,2,3
"912350569",8,1695.93939204612,1618.06981158482,1812.11073017574,2,6
"912350570",8,1704.07091617053,1646.8710444416,1812.11073017574,2,6
"912350571",8,1634.96836708971,1559.88434683343,1812.11073017574,1,7
"912350572",9,1706.83418088453,1675.67816691171,1856.26587460569,2,7
"912350573",8,1695.80560708553,1621.27272418386,1812.11073017574,2,6
"912350574",8,1652.85082893332,1570.76971424192,1812.11073017574,1,7
"912350581",3,1420.36143481589,1465.75620691621,1482.92019466158,1,2
"912350586",15,1771.1405037339,1617.47827434776,2060.56118614118,3,12
"912350629",5,1578.61004538524,1500.42373060019,1646.12614877363,1,4
"912350630",6,1608.39707123082,1515.40524464855,1708.62817714657,2,4
"912350645",9,1679.22836656672,1573.30014617105,1856.26587460569,2,7
"912350687",62,2745.88336784971,2164.5444516018,2753.94837323248,16,46
"912350688",44,2584.44144402206,2397.91164204018,2567.51523707907,10,34
"912350782",16,1979.52931176708,1949.57598926169,2087.92318348224,5,11
"912350783",23,2002.44673664684,1829.16405759924,2248.68783741607,7,16
"912350784",18,2129.4795357373,2104.51803547573,2138.79896507223,5,13
"912350785",27,2156.93186787779,1792.78297882356,2323.60649590586,6,21
"912350800",25,2113.08523487109,1986.60574903981,2287.34065519221,8,17
"912350806",27,1865.61329328551,1108.23488630121,2323.60649590586,10,17
"912350819",16,1792.97964666978,1476.85659695642,2087.92318348224,4,12
"912350821",15,1835.18889596905,1612.45879544247,2060.56118614118,5,10
"912350822",12,1745.94843473089,1382.58333342019,1968.69006049611,3,9
"912350823",11,1756.64503188597,1655.38508763708,1933.98659929558,2,9
"912350824",22,1946.50960137982,1479.46736841971,2228.3491786518,6,16
"912350825",10,1755.61792792444,1546.64066887566,1896.67490607898,2,8
"912350826",21,1900.19721189113,1423.22048254858,2207.26116887512,5,16
"912350828",15,1931.05091593946,1516.69492660626,2060.56118614118,3,12
"912350829",16,1918.13973313542,1459.64338295671,2087.92318348224,3,13
"912350830",16,1795.32539242685,1831.63117574477,2087.92318348224,3,13
"912350831",18,1849.25019756353,1515.63853211612,2138.79896507223,5,13
"912350833",17,1838.07140133827,1493.65643413313,2113.95669457394,3,14
"912350834",22,1894.83482507346,1518.42188784935,2228.3491786518,4,18
"912350835",13,1825.60422367668,1768.92333476794,2001.16379457045,3,10
"912350840",29,2187.9977040167,1764.5890950758,2357.79423966008,9,20
"912350841",25,2135.13545416359,2183.77817287614,2287.34065519221,9,16
"912350844",24,2116.45211592703,1722.20034025097,2268.33468283819,5,19
"912350845",29,2192.87700341219,2364.56985027787,2357.79423966008,7,22
"912350852",16,1984.51503782298,2138.43879037601,2087.92318348224,3,13
"912350854",37,2423.10639015659,2116.94014165035,2478.17471526668,10,27
"912350859",32,2533.52320134538,2298.91459958328,2405.71569249515,8,24
"912350860",22,2318.93464031255,2248.45335281973,2228.3491786518,5,17
"912350861",23,2189.33836450614,2058.83275893405,2248.68783741607,6,17
"912350862",30,2260.20277131695,2166.06969315391,2374.18906024059,8,22
"912350863",19,2080.08674763064,2021.22463638443,2162.56636020013,4,15
"912350864",22,2336.32655417469,2279.42196737564,2228.3491786518,5,17
"912350865",23,2274.62947288266,2183.53405088595,2248.68783741607,5,18
"912350866",29,2329.75079235762,2277.29442867452,2357.79423966008,5,24
"912350867",28,2265.33993339258,1773.55146308726,2340.94327947849,7,21
"912350868",28,2322.75298575087,1881.7805769079,2340.94327947849,7,21
"912350869",32,2546.47914563342,2412.32359158877,2405.71569249515,9,23
"912350870",38,2457.46529056022,2033.50882721285,2491.71993967651,10,28
"912350871",22,2190.06840036291,2148.09208257263,2228.3491786518,6,16
"912350872",22,2270.89012919712,2295.47233820936,2228.3491786518,4,18
"912350873",24,1977.76845161508,1503.18273361035,2268.33468283819,5,19
"912350874",32,2334.39424157037,1926.96367817327,2405.71569249515,7,25
"912350875",15,2036.40717600703,1874.32413220016,2060.56118614118,1,14
"912350876",14,1999.62251639718,1743.10704431994,2031.70713799962,3,11
"912350877",24,2101.74133177166,1818.98998383979,2268.33468283819,5,19
"912350878",25,2144.08066781441,1883.60089222687,2287.34065519221,4,21
"912350879",26,2241.94625849762,2114.02256131263,2305.75108410937,5,21
"912351124",10,1688.06325535509,1448.59988031344,1896.67490607898,2,8
"912351125",10,1763.71884584903,1655.58551112732,1896.67490607898,2,8
"912351126",9,1671.60230748697,1615.75486526234,1856.26587460569,2,7
"912351127",5,1559.74401194785,1619.35303415702,1646.12614877363,0,5
"912351129",11,1731.45841411262,1629.40135946397,1933.98659929558,3,8
"912351273",7,1710.42101735226,1718.43090640174,1763.32076508842,1,6
"912351274",2,1335.21376508866,1290.09161327936,1364.97646362037,1,1
"912351275",10,1919.33183873709,1742.26130466095,1896.67490607898,4,6
"912351276",5,1674.54992665708,1650.49906374881,1646.12614877363,4,1
"912351322",8,1853.33783739668,1897.24592602982,1812.11073017574,3,5
"912351323",8,1792.2418822832,1855.62611586213,1812.11073017574,3,5
"912351324",9,1813.31997694568,1851.96707690425,1856.26587460569,1,8
"912351325",1,1168.07761147649,1184.66451052022,1184.66451052022,1,0
"912351328",2,1319.69935978452,1364.97646362037,1364.97646362037,1,1
"912351329",3,1396.54496267312,1246.384847975,1482.92019466158,1,2
"912351330",6,1525.84549189312,1371.08935474441,1708.62817714657,0,6
"912351331",5,1519.91944024364,1417.37569228479,1646.12614877363,0,5
"912351332",9,1583.60775429337,1353.30802372318,1856.26587460569,0,9
"912351333",6,1525.84549189312,1393.73483120182,1708.62817714657,0,6
"912351334",11,1598.38510450067,1341.20745191883,1933.98659929558,0,11
"912351335",8,1600.84063746503,1520.69548188385,1812.11073017574,0,8
"912351336",6,1525.84549189312,1527.81222877251,1708.62817714657,0,6
"912351337",5,1513.88428202103,1446.90312323064,1646.12614877363,0,5
"912351338",4,1477.47953941629,1478.50750165799,1572.73281143487,0,4
"912351339",3,1416.68271621492,1406.95001424586,1482.92019466158,0,3
"912351340",10,1671.61110855808,1613.37520703251,1896.67490607898,2,8
"912351341",5,1519.91944024364,1411.94634520458,1646.12614877363,0,5
"912351364",9,1780.2419611242,1675.38803019292,1856.26587460569,3,6
"912351365",9,1787.91997177866,1705.8307428478,1856.26587460569,2,7
"912351366",10,1777.77814345005,1764.99136656505,1896.67490607898,2,8
"912351367",5,1589.58809333247,1569.14378370498,1646.12614877363,1,4
"912351391",5,1609.37797041413,1511.6805713562,1646.12614877363,2,3
"912351392",8,1747.55971617067,1694.63030602031,1812.11073017574,2,6
"912351393",15,1970.56151874132,1803.4524384498,2060.56118614118,3,12
"912351394",14,1932.76556291176,1886.35494168531,2031.70713799962,4,10
"912351400",3,1462.48998532316,1334.83396723623,1482.92019466158,1,2
"912351401",3,1370.13663604388,1333.65127392496,1482.92019466158,1,2
"912351402",8,1649.75945122888,1601.97453146534,1812.11073017574,3,5
"912351403",4,1525.84105727444,1394.27107339658,1572.73281143487,2,2
"912351404",3,1467.05224229073,1330.01385776812,1482.92019466158,1,2
"912351405",1,1152.96854186554,1080.2800265985,1184.66451052022,0,1
"912351406",5,1549.43812212906,1377.50090054453,1646.12614877363,4,1
"912351407",3,1411.96999425743,1211.30588856952,1482.92019466158,1,2
"912351415",3,1461.22840307828,1495.70413981801,1482.92019466158,0,3
"912351416",3,1428.781544063,1326.59758669739,1482.92019466158,1,2
"912351417",2,1357.31890381225,1346.16653128743,1364.97646362037,1,1
"912351418",2,1351.11651627742,1364.97646362037,1364.97646362037,0,2
"912351419",5,1557.64034092053,1437.83240981684,1646.12614877363,1,4
"912351420",4,1487.03153520563,1292.73841027195,1572.73281143487,1,3
"912351421",2,1296.34239218168,1198.28156435346,1364.97646362037,0,2
"912351422",2,1302.61315359408,1314.61171554668,1364.97646362037,0,2
"912351431",21,2072.54125232324,1773.17903812039,2207.26116887512,7,14
"912351432",32,2161.70530311765,2067.54101323406,2405.71569249515,12,20
"912351460",8,1724.12784128195,1640.68524641459,1812.11073017574,0,8
"912351461",6,1670.25799206734,1599.52858317672,1708.62817714657,1,5
"912351462",3,1443.33922733671,1384.50004306284,1482.92019466158,0,3
"912351463",6,1652.84093467692,1623.51276644853,1708.62817714657,0,6
"912351468",20,2006.69358789066,1586.23455282636,2185.35845629437,5,15
"912351469",17,1825.69891480175,1640.2774070703,2113.95669457394,4,13
"912351470",20,1963.02641811804,1638.31093691052,2185.35845629437,4,16
"912351471",19,1927.32233795373,1625.23326569895,2162.56636020013,4,15
"912351472",15,1859.1954580466,1593.18051147098,2060.56118614118,3,12
"912351473",10,1799.5319625345,1651.19813456967,1896.67490607898,2,8
"912351474",17,1809.38331388605,1447.75966936182,2113.95669457394,3,14
"912351475",16,1750.94300153261,1651.45538298918,2087.92318348224,4,12
"912351476",15,1874.98851097477,1608.63791323705,2060.56118614118,4,11
"912351477",16,1864.90106298233,1501.03493829458,2087.92318348224,5,11
"912351478",15,1813.45023489678,1680.3484003791,2060.56118614118,4,11
"912351479",19,1869.53514103527,1635.15099887074,2162.56636020013,5,14
"912351480",16,1846.38330108273,1789.12967935208,2087.92318348224,2,14
"912351481",13,1900.36683361017,1622.48803856901,2001.16379457045,2,11
"912351482",12,1797.15742568442,1649.13973115915,1968.69006049611,1,11
"912351483",7,1685.95449069861,1614.04017135924,1763.32076508842,1,6
"912351484",11,1842.03496908906,1753.13336452616,1933.98659929558,0,11
"912351485",14,1835.19471808384,1657.89699802191,2031.70713799962,1,13
"912351486",6,1685.55338828333,1649.10068290988,1708.62817714657,0,6
"912351487",12,1782.26617725514,1678.5840972947,1968.69006049611,1,11
"912351488",10,1837.84093737651,1783.15421033136,1896.67490607898,0,10
"912351489",9,1829.00428506805,1749.74427462333,1856.26587460569,1,8
"912351490",7,1701.61072781642,1554.94717143914,1763.32076508842,0,7
"912351491",7,1748.19003524566,1691.70008296261,1763.32076508842,0,7
"912351492",11,1874.1804438373,1836.63855571327,1933.98659929558,1,10
"912351493",7,1694.31956215008,1633.93816835362,1763.32076508842,1,6
"912351494",12,1803.93946609035,1784.3767832634,1968.69006049611,2,10
"912351495",7,1676.73406974156,1634.23297848425,1763.32076508842,1,6
"912351496",13,1918.0389168198,1916.53339652728,2001.16379457045,3,10
"912351497",18,1865.87206138001,1788.48096590359,2138.79896507223,1,17
"912351498",16,2004.43607928093,2050.92589754202,2087.92318348224,0,16
"912351499",8,1810.53155549948,1720.78905538928,1812.11073017574,0,8
"912351504",15,1955.80287899222,1794.796346406,2060.56118614118,2,13
"912351505",14,1950.868026128,1845.1276166996,2031.70713799962,0,14
"912351506",13,1865.9875905875,1824.47665605705,2001.16379457045,0,13
"912351507",12,1816.97258137382,1840.30980591675,1968.69006049611,1,11
"912351508",21,1837.03992650601,1443.09024481313,2207.26116887512,3,18
"912351509",21,1994.05507383009,1705.06651828076,2207.26116887512,5,16
"912351510",22,1905.09556600729,1657.55343589331,2228.3491786518,6,16
"912351511",20,1958.26518067175,1648.39034625047,2185.35845629437,5,15
"912351512",13,1906.29044751499,1793.30516182452,2001.16379457045,4,9
"912351513",12,1781.67289500562,1729.22030512753,1968.69006049611,2,10
"912351514",11,1760.31241319438,1539.34176083395,1933.98659929558,3,8
"912351515",6,1622.27111020902,1624.3729180954,1708.62817714657,1,5
"912351516",17,1936.93099109893,1807.23869719416,2113.95669457394,3,14
"912351517",11,1735.69633014181,1537.08117394641,1933.98659929558,1,10
"912351518",17,1883.94675748069,1727.11256437824,2113.95669457394,2,15
"912351519",14,1838.88475377109,1754.43418178291,2031.70713799962,2,12
"912351520",5,1606.05354260412,1516.06263856282,1646.12614877363,0,5
"912351521",7,1678.58403401727,1514.52141849092,1763.32076508842,0,7
"912351522",6,1694.73705966664,1591.51839644295,1708.62817714657,0,6
"912351523",8,1765.12741141329,1756.76307558121,1812.11073017574,1,7
"912351524",9,1752.5903809488,1653.72465208526,1856.26587460569,0,9
"912351525",8,1669.26127413027,1517.5656301769,1812.11073017574,1,7
"912351526",8,1727.35564817727,1703.66015642498,1812.11073017574,0,8
"912351527",8,1709.35765215364,1684.96939406764,1812.11073017574,0,8
"912351528",11,1822.41971180185,1739.81336934412,1933.98659929558,4,7
"912351529",14,1761.27108777056,1532.54606523345,2031.70713799962,4,10
"912351530",15,1861.26310426839,1564.29671535234,2060.56118614118,2,13
"912351531",6,1607.79805459395,1465.78473502865,1708.62817714657,1,5
"912351532",13,1782.29116381173,1641.3435686854,2001.16379457045,2,11
"912351533",17,1931.40753407418,1987.61060072682,2113.95669457394,4,13
"912351534",8,1763.3443303323,1687.40418509704,1812.11073017574,0,8
"912351535",8,1720.53161443072,1647.80025597003,1812.11073017574,0,8
"912351536",16,1888.90338146257,1739.75290063768,2087.92318348224,3,13
"912351537",15,1859.20838877048,1816.59025632117,2060.56118614118,2,13
"912351538",21,1879.86898203995,1742.44174247309,2207.26116887512,5,16
"912351539",6,1622.15833385729,1639.94854476575,1708.62817714657,0,6
"912351540",13,1795.48983612503,1650.81960112373,2001.16379457045,2,11
"912351541",11,1706.52308322796,1586.98879519031,1933.98659929558,3,8
"912351542",14,1836.81903723107,1671.81592583727,2031.70713799962,2,12
"912351543",11,1733.76714557529,1738.71473859905,1933.98659929558,2,9
"912351544",20,1859.91800918517,1738.43323364986,2185.35845629437,4,16
"912351545",16,1984.97745188854,2001.99775806342,2087.92318348224,3,13
"912351546",12,1887.20879313381,1817.50928311307,1968.69006049611,2,10
"912351547",15,1814.01228285597,1875.42066097514,2060.56118614118,2,13
"912351548",9,1777.97796382334,1712.03031222269,1856.26587460569,0,9
"912351549",6,1657.22977817363,1611.13214904487,1708.62817714657,0,6
"912351550",5,1675.78632685221,1503.95606370959,1646.12614877363,0,5
"912351551",5,1587.4156716335,1534.12990171121,1646.12614877363,0,5
"912351552",4,1533.67520472193,1460.38348084941,1572.73281143487,0,4
"912351553",6,1676.68646040709,1577.70484722373,1708.62817714657,0,6
"912351554",6,1645.32395221521,1498.10141257567,1708.62817714657,0,6
"912351555",15,1973.51483173206,1744.92075199274,2060.56118614118,3,12
"912351556",7,1737.76069746995,1683.87030582617,1763.32076508842,0,7
"912351557",6,1687.51006635643,1653.04346547333,1708.62817714657,0,6
"912351558",5,1665.26212748092,1614.99136026451,1646.12614877363,0,5
"912351559",8,1783.44320518969,1696.87798815936,1812.11073017574,0,8
"912351560",17,1843.0427306662,1492.28338921827,2113.95669457394,3,14
"912351561",14,1862.39676033664,1700.31368601992,2031.70713799962,2,12
"912351562",7,1654.90702217599,1526.1365137629,1763.32076508842,1,6
"912351563",7,1750.51229155642,1652.91692723474,1763.32076508842,0,7
"912351564",16,1861.11899396942,1703.06400893624,2087.92318348224,4,12
"912351565",13,1827.99225895038,1693.85736694603,2001.16379457045,2,11
"912351566",11,1771.7267160693,1584.64688548346,1933.98659929558,3,8
"912351567",11,1723.37172046542,1652.47136697542,1933.98659929558,3,8
"912351572",8,1724.30708092991,1532.47691342882,1812.11073017574,0,8
"912351573",12,1830.6130421709,1667.28429059443,1968.69006049611,1,11
"912351574",8,1753.6410115461,1567.31998301545,1812.11073017574,2,6
"912351575",10,1808.40669163223,1717.98830016241,1896.67490607898,2,8
"912351576",16,1819.63341413076,1898.48479456749,2087.92318348224,1,15
"912351577",17,2040.89673581111,1933.57548093577,2113.95669457394,2,15
"912351578",17,1913.92161479096,1871.80670802944,2113.95669457394,5,12
"912351579",15,2038.39953958092,1915.12267112047,2060.56118614118,2,13
"912351580",20,1901.29571890876,1747.32180804891,2185.35845629437,4,16
"912351581",24,1963.84049164899,1719.28039847655,2268.33468283819,7,17
"912351582",19,1850.72452981612,1732.39820940279,2162.56636020013,7,12
"912351583",18,1858.06164239521,1578.34761361176,2138.79896507223,4,14
"912351584",18,1931.73976300994,1610.03174696977,2138.79896507223,3,15
"912351585",16,1913.15526652757,1754.85937204627,2087.92318348224,3,13
"912351586",13,1938.53961490433,1853.6156560438,2001.16379457045,2,11
"912351587",16,1874.82280555456,1698.89658939585,2087.92318348224,2,14
"912351592",8,1786.74866610342,1753.31435338244,1812.11073017574,0,8
"912351593",16,1918.0975223909,1951.60478138247,2087.92318348224,1,15
"912351594",13,1813.03413699296,1682.11745220806,2001.16379457045,2,11
"912351595",8,1755.535022616,1769.62864713756,1812.11073017574,1,7
"912351596",7,1699.60140814517,1673.45470982123,1763.32076508842,0,7
"912351597",10,1817.04507246901,1859.61071810546,1896.67490607898,0,10
"912351598",10,1802.78643547517,1759.71051732896,1896.67490607898,0,10
"912351599",10,1785.72553953641,1822.67126243707,1896.67490607898,1,9
"912351600",15,1898.01412375425,1883.24881313913,2060.56118614118,2,13
"912351601",17,1921.80976070341,1670.12507779231,2113.95669457394,1,16
"912351602",10,1823.17975684224,1850.35393705616,1896.67490607898,1,9
"912351603",8,1709.21628607058,1688.9259317735,1812.11073017574,0,8
"912351604",15,1744.3009357842,1144.26529395765,2060.56118614118,0,15
"912351605",9,1736.6799286553,1651.41651895311,1856.26587460569,0,9
"912351606",11,1828.14487996038,1728.70193895417,1933.98659929558,1,10
"912351607",10,1740.61293701506,1496.87339629935,1896.67490607898,0,10
"912351608",13,1794.92976593438,1817.93947177326,2001.16379457045,2,11
"912351609",13,1859.0739544307,1591.74459021612,2001.16379457045,0,13
"912351610",13,1805.04912377712,1740.36323248901,2001.16379457045,0,13
"912351611",13,1835.447932096,1801.8627486227,2001.16379457045,1,12
"912351612",11,1843.53378901625,1849.95133953756,1933.98659929558,1,10
"912351613",11,1823.00989664095,1729.06335894523,1933.98659929558,1,10
"912351614",10,1817.94240571101,1776.54991749457,1896.67490607898,0,10
"912351615",8,1697.86695348937,1685.32303881057,1812.11073017574,0,8
"912351616",11,1861.86876148356,1832.7712538574,1933.98659929558,1,10
"912351617",9,1728.65587928262,1793.87490263536,1856.26587460569,0,9
"912351618",11,1778.82317910054,1793.14268186388,1933.98659929558,0,11
"912351619",9,1795.80423606277,1790.83147772885,1856.26587460569,0,9
"912351620",5,1599.7257674013,1660.40568969868,1646.12614877363,1,4
"912351621",5,1603.39266369314,1673.4486759994,1646.12614877363,0,5
"912351622",4,1509.30334158126,1455.9923911977,1572.73281143487,0,4
"912351623",2,1361.21281064028,1369.5449350305,1364.97646362037,0,2
"912351624",8,1737.78049627468,1765.50525637662,1812.11073017574,1,7
"912351625",9,1807.46309067497,1817.11102940322,1856.26587460569,1,8
"912351626",10,1815.78197395953,1828.93217708276,1896.67490607898,1,9
"912351627",10,1812.31377742941,1807.90887700497,1896.67490607898,1,9
"912351628",9,1789.40064552042,1666.80989319836,1856.26587460569,2,7
"912351629",6,1628.3683460072,1505.87613872594,1708.62817714657,2,4
"912351630",3,1467.4077686348,1487.10562410111,1482.92019466158,0,3
"912351631",6,1658.59939925525,1538.19422907252,1708.62817714657,3,3
"912351632",12,1787.33153173638,1704.32069752531,1968.69006049611,2,10
"912351633",12,1808.47763074698,1892.24359079154,1968.69006049611,3,9
"912351634",9,1738.1286665398,1576.5053281643,1856.26587460569,1,8
"912351635",9,1734.27818349185,1557.46701156909,1856.26587460569,1,8
"912351636",17,1991.13038901399,1831.36312751682,2113.95669457394,4,13
"912351637",17,1861.84015985535,1794.50018504774,2113.95669457394,3,14
"912351638",18,1775.03414566002,1477.21324422552,2138.79896507223,6,12
"912351639",17,1885.65323492204,1493.87513833369,2113.95669457394,5,12
"912351640",14,1943.34411244742,1758.93712464314,2031.70713799962,2,12
"912351641",13,1916.00897529902,1746.29502384957,2001.16379457045,3,10
"912351642",16,1906.60572842716,1892.96634055425,2087.92318348224,3,13
"912351643",11,1832.14504230963,1835.70477118405,1933.98659929558,1,10
"912351644",5,1548.00811977073,1436.48420701541,1646.12614877363,1,4
"912351645",7,1696.65936117558,1578.40512809427,1763.32076508842,2,5
"912351646",6,1704.83773341408,1595.6172472919,1708.62817714657,1,5
"912351647",5,1557.44383981922,1336.67572807908,1646.12614877363,2,3
"912351648",17,1926.38323249726,1700.79200062803,2113.95669457394,1,16
"912351649",23,1933.92394382831,1588.2735950816,2248.68783741607,1,22
"912351650",19,1885.80121943107,1691.4690232214,2162.56636020013,1,18
"912351651",13,1852.55250277416,1723.53342710423,2001.16379457045,0,13
"912351652",6,1624.89231048127,1563.37264057046,1708.62817714657,0,6
"912351653",11,1869.63857714168,1839.18752618778,1933.98659929558,1,10
"912351657",9,1593.51159008101,1491.8311746637,1856.26587460569,4,5
"912351659",12,1665.28415472325,1133.85381504883,1968.69006049611,1,11
"912351730",40,2531.84998347693,2323.88574652638,2517.98110851286,7,33
"912351731",26,2553.00021287796,2734.53295612799,2305.75108410937,6,20
"912351732",22,2349.29627193415,2122.91707899631,2228.3491786518,4,18
"912351733",13,2184.30851581194,2165.48792059549,2001.16379457045,2,11
"912351734",31,2616.7030677367,2592.52077131585,2390.15469389133,7,24
"912351736",47,2700.90810746432,2682.07693816495,2602.36394728806,22,25
"912351737",49,2797.87669427184,2749.57744495278,2624.62502504328,27,22
"912351738",23,2039.37865671691,1782.20497446331,2248.68783741607,9,14
"912351739",24,1995.15630213542,1719.11927309837,2268.33468283819,9,15
"912351740",19,2034.82330919998,1861.6622389016,2162.56636020013,7,12
"912351741",20,2129.85640374661,2183.45135222652,2185.35845629437,6,14
"912351742",30,2270.78453874575,2004.55747279184,2374.18906024059,12,18
"912351743",35,2136.97315429832,2073.88832682355,2450.1860183293,13,22
"912351744",43,2356.95440565216,2054.40997662066,2555.47878346624,20,23
"912351745",61,2442.33646683411,1953.94998061956,2744.81051624266,26,35
"912351746",33,2440.00981859324,2071.15877779359,2420.89448855093,14,19
"912351747",54,2789.4064257358,2450.4407034398,2677.2712016452,27,27
"912351748",55,2574.65113124064,2492.46621796494,2687.33120998132,27,28
"912351755",48,2939.87203576492,2651.04640617628,2613.58673801098,20,28
"912351756",56,2768.46687615074,2471.8586682768,2697.24673169728,23,33
"912351757",53,2997.21005133973,2465.91156184284,2667.061866114,22,31
"912351758",48,3105.78702815313,2976.7806181548,2613.58673801098,18,30
"912351762",57,2653.22052630552,2874.19938294134,2707.02236739438,20,37
"912351763",30,2597.54001250858,2701.61719979215,2374.18906024059,13,17
"912351764",27,2235.82605506709,2154.06720455805,2323.60649590586,7,20
"912351765",50,2269.1721773885,1645.02479610891,2635.48551585152,20,30
"912351766",30,2150.52187280647,2038.4057069845,2374.18906024059,11,19
"912351767",41,2434.72446149427,2416.15001868281,2530.72175773865,13,28
"912351768",26,2222.22292106278,2192.21188081554,2305.75108410937,10,16
"912351769",37,2461.34639875955,2286.56927672668,2478.17471526668,14,23
"912351770",52,2529.41585585826,2833.91766802792,2656.6981055205,19,33
"912351771",74,2568.64449336445,2135.27470710195,2855.36548874306,29,45
"912351776",47,2953.43654876424,2647.91052487346,2602.36394728806,19,28
"912351784",65,3034.03551845323,2531.35108868418,2780.67589681985,27,38
"912351785",49,2988.66926645118,2786.49287825518,2624.62502504328,18,31
"912351786",47,2311.46252892511,2388.22256342716,2602.36394728806,17,30
"912351787",37,2396.87614965382,2472.055830476,2478.17471526668,14,23
"912351798",43,2930.89743833453,2684.58583125234,2555.47878346624,15,28
"912351799",40,2475.62975065972,2564.84725359995,2517.98110851286,14,26
"912351800",42,2498.22878809295,2443.58958930364,2543.21752514954,15,27
"912351801",53,2333.79119375787,2435.7349883154,2667.061866114,15,38
"912351802",54,2316.03135629482,1949.36508512284,2677.2712016452,20,34
"912351803",55,2945.98683939032,2683.24312217139,2687.33120998132,22,33
"912351804",23,2259.27004026192,2306.32966271714,2248.68783741607,8,15
"912351805",26,1978.45519920941,1688.953459174,2305.75108410937,9,17
"912351806",29,2200.48665597036,2122.11757411678,2357.79423966008,11,18
"912351807",30,2081.17799256926,1689.11839322094,2374.18906024059,12,18
"912351808",38,2088.89983886363,1713.23941348354,2491.71993967651,13,25
"912351809",50,2319.31550517376,2141.3532475877,2635.48551585152,19,31
"912351810",55,2390.04238461505,2810.95622580257,2687.33120998132,24,31
"912351811",63,2257.27327656919,2108.74234484821,2762.96971264875,23,40
"912351816",41,2737.8804614517,2725.29484597666,2530.72175773865,13,28
"912351822",53,3033.37842503969,2972.55412729878,2667.061866114,24,29
"912351823",52,2089.70228354089,1887.57288682078,2656.6981055205,17,35
"912351824",44,2102.22427878517,2277.03100315834,2567.51523707907,17,27
"912351826",53,2221.3898204139,2516.63673495639,2667.061866114,23,30
"912351827",52,2143.79500368203,2200.42219225925,2656.6981055205,22,30
"912351833",35,2162.532448663,2052.69967663355,2450.1860183293,11,24
"912351834",45,2170.95075088287,1876.41374976743,2579.33597919865,17,28
"912351839",48,2283.01340790482,1858.25130733772,2613.58673801098,21,27
"912351840",50,2432.95385845047,1774.2226094577,2635.48551585152,20,30
"912351845",43,2427.36427261257,2283.03732251322,2555.47878346624,15,28
"912351846",38,2573.12543029636,2589.32376156706,2491.71993967651,13,25
"912351979",29,1928.77144381874,1612.56953773208,2357.79423966008,11,18
"912351980",33,2081.81989713091,1322.87393961397,2420.89448855093,15,18
"912351983",27,2229.5089382942,2120.21443984623,2323.60649590586,11,16
"912351984",34,2184.69197390591,2258.009990914,2435.71163614839,13,21
"912351985",31,2110.16066531416,1600.4046018905,2390.15469389133,16,15
"912351990",25,2222.35056237279,2227.37974980346,2287.34065519221,15,10
"912351991",24,2271.6499973914,2097.68873574264,2268.33468283819,13,11
"912351992",30,1973.56092120528,1483.24852022224,2374.18906024059,14,16
"912351993",28,2210.28085236799,1840.11244348084,2340.94327947849,11,17
"912351994",61,3080.76764980874,2849.07989019677,2744.81051624266,19,42
"912351995",59,2746.47508811037,2424.47473913279,2726.17127719361,16,43
"912352006",74,3289.71010881941,3101.24049948098,2855.36548874306,21,53
"912352007",72,3586.49413584352,3078.19251961345,2839.4193288992,21,51
"912352008",61,3032.55073855899,2502.28522906946,2744.81051624266,20,41
"912352009",70,2701.75047556066,2775.3134171236,2823.11677003184,28,42
"912352016",46,2549.34058393215,2685.23865571132,2590.94954296761,13,33
"912352017",33,2326.34591124862,2454.72105931179,2420.89448855093,9,24
"912352018",70,3000.06162371758,2697.55927974366,2823.11677003184,22,48
"912352019",57,2613.70075777584,2645.77913285917,2707.02236739438,19,38
"912352020",64,2725.25441458314,1762.05165770062,2771.87783482774,15,49
"912352021",63,3598.23730807635,2666.72284949498,2762.96971264875,21,42
"912352022",66,2614.29221047763,2000.42220565088,2789.3669207067,19,47
"912352023",45,2717.18473656597,3290.88930954425,2579.33597919865,15,30
"912352042",73,3020.78283780739,2617.31286544154,2847.4358582506,22,51
"912352043",86,2714.37782019219,2812.02576326901,2944.43562859908,26,60
"912352044",61,3153.32678978432,3082.1379163994,2744.81051624266,13,48
"912352045",52,3077.14725673897,3372.99150047633,2656.6981055205,16,36
"912352046",41,2408.2208373863,1943.60775604665,2530.72175773865,18,23
"912352047",52,2425.92251189172,2000.78346751159,2656.6981055205,23,29
"912352048",34,2224.90532531798,2197.11615705591,2435.71163614839,10,24
"912352049",41,2297.27624689219,2021.63958836302,2530.72175773865,15,26
"912352050",38,2314.1741737507,2380.89352442761,2491.71993967651,13,25
"912352051",44,2432.45813432744,2032.19188479755,2567.51523707907,14,30
"912352052",23,1936.24656044161,1544.90378068166,2248.68783741607,8,15
"912352053",40,2232.43809186272,1672.84764531034,2517.98110851286,17,23
"912352054",65,2613.19366137282,1798.58098642756,2780.67589681985,20,45
"912352055",52,2964.93075500466,2650.9837861907,2656.6981055205,19,33
"912352056",70,2907.7802193711,2985.2439159855,2823.11677003184,19,51
"912352057",77,2685.01613907958,2051.99185086979,2878.65357631343,26,51
"912352058",46,2611.28811952422,2479.73388602796,2590.94954296761,16,30
"912352059",48,2507.70113600942,2342.49462645368,2613.58673801098,8,40
"912352062",74,3517.58490587953,3315.23840018616,2855.36548874306,24,50
"912352065",44,2092.41617021343,1883.43263124394,2567.51523707907,17,27
"912352066",57,2119.62200391829,1837.51416373705,2707.02236739438,25,32
"912352067",26,2102.25198624334,1995.41778006024,2305.75108410937,11,15
"912352068",26,2069.94575554246,1963.20625788024,2305.75108410937,11,15
"912352069",30,2193.87222705622,1779.53272061763,2374.18906024059,10,20
"912352070",40,2300.60290949423,2053.03391439988,2517.98110851286,19,21
"912352071",44,2316.54831145579,1939.1845484523,2567.51523707907,19,25
"912352082",51,2955.54772105356,2111.63531253555,2646.17454577679,15,36
"912352086",32,2273.26107135874,2352.31795493023,2405.71569249515,11,21
"912352087",59,2589.16538116305,1987.63574896289,2726.17127719361,18,41
"912352088",44,2594.76376375205,2729.85518092397,2567.51523707907,13,31
"912352089",78,2574.75446524187,2305.48290051481,2886.25582696583,23,55
"912352098",77,3222.97361295344,2607.80660652317,2878.65357631343,22,55
"912352099",36,2286.09440762883,2172.52514869761,2464.33502634194,13,23
"912352101",49,2856.84200575279,2506.77901303891,2624.62502504328,16,33
"912352102",50,3210.23635092183,2870.2222725295,2635.48551585152,18,32
"912352103",33,2313.18303049659,1731.23633405464,2420.89448855093,9,24
"912352104",33,2472.1958640256,1891.70300490163,2420.89448855093,12,21
"912352107",63,2993.59656185396,2959.01824091074,2762.96971264875,15,48
"912352111",48,2762.66996840518,2702.90153399301,2613.58673801098,17,31
"912352113",70,3037.92210917816,2602.74735245134,2823.11677003184,21,49
"912352117",51,2465.16642928167,2583.17878995701,2646.17454577679,15,36
"912352118",73,2241.29445673722,1851.24305599748,2847.4358582506,16,57
"912352119",40,2627.67199649878,2970.82375642728,2517.98110851286,14,26
"912352120",65,2429.45645555046,2249.55712386155,2780.67589681985,20,45
"912352130",57,2785.61325146909,2698.08248367015,2707.02236739438,17,40
"912352131",47,2871.88336199241,2983.90596041609,2602.36394728806,16,31
"912352132",77,3017.45236930784,3151.12751960996,2878.65357631343,22,55
"912352133",89,3031.78584291614,2597.26360485615,2965.14449011489,31,58
"912352134",47,2734.58888841779,3298.28925352733,2602.36394728806,15,32
"912352144",21,1906.85926211364,2025.49924764341,2207.26116887512,5,16
"912352168",6,1643.63997290097,1573.94233126117,1708.62817714657,2,4
"912352169",6,1645.58894296431,1650.01996593463,1708.62817714657,2,4
"912352170",8,1723.16763421459,1652.81321872751,1812.11073017574,2,6
"912352171",8,1740.06533593602,1661.72842603938,1812.11073017574,3,5
"912352186",8,1853.33783739668,1897.24592602982,1812.11073017574,3,5
"912352187",8,1792.2418822832,1855.62611586213,1812.11073017574,3,5
"912352188",9,1813.31997694568,1851.96707690425,1856.26587460569,1,8
"912352198",3,1402.91749785247,1381.70283687148,1482.92019466158,1,2
"912352199",2,1325.52818701253,1351.17103410279,1364.97646362037,0,2
"912352200",4,1475.45626831831,1363.89213293809,1572.73281143487,1,3
"912352201",4,1475.45626831831,1298.61143678375,1572.73281143487,1,3
"912352203",2,1320.33302363889,1311.34251563906,1364.97646362037,1,1
"912352204",4,1475.45626831831,1462.80249824117,1572.73281143487,1,3
"912352205",3,1413.53589001467,1310.00355646207,1482.92019466158,1,2
"912352206",2,1320.33302363889,1351.17605827428,1364.97646362037,1,1
"912352207",3,1413.53589001467,1399.3163414443,1482.92019466158,1,2
"912352208",2,1320.33302363889,1320.388501203,1364.97646362037,1,1
"912352209",3,1411.75208081779,1430.22726493773,1482.92019466158,1,2
"912352210",5,1492.71465122832,1360.26422076994,1646.12614877363,1,4
"912352211",1,1167.42353790325,1172.68712418424,1184.66451052022,0,1
"912352220",5,1543.31856192444,1388.7261866938,1646.12614877363,1,4
"912352221",12,1623.47768053252,1294.36744754105,1968.69006049611,1,11
"912352222",6,1545.71927198838,1457.41242748796,1708.62817714657,0,6
"912352223",4,1476.72861870387,1479.09508717032,1572.73281143487,0,4
"912352224",5,1551.9704977642,1487.66568910493,1646.12614877363,1,4
"912352225",5,1551.9704977642,1500.57453567877,1646.12614877363,1,4
"912352226",15,1612.74929297097,1167.22965864697,2060.56118614118,0,15
"912352236",13,1839.47950803388,1775.04316294437,2001.16379457045,5,8
"912352257",12,1848.94384665926,1795.05350717703,1968.69006049611,2,10
"912352293",30,2044.80941564724,2142.06043715404,2374.18906024059,7,23
"912352333",11,1669.53071908427,1359.61958555009,1933.98659929558,2,9
"912352334",8,1545.39209028669,1422.34610509388,1812.11073017574,3,5
"912352335",9,1592.25592533908,1454.45132842457,1856.26587460569,3,6
"912352336",6,1513.996271535,1412.46000488785,1708.62817714657,1,5
"912352337",8,1663.98453918962,1685.59068829051,1812.11073017574,3,5
"912352338",7,1613.402242999,1561.84506874842,1763.32076508842,3,4
"912352339",5,1571.15834356765,1424.66209882021,1646.12614877363,1,4
"912352340",5,1528.96898711364,1581.14645056905,1646.12614877363,2,3
"912352347",10,1630.32986583333,1375.53387763693,1896.67490607898,4,6
"912352348",12,1617.58369954903,1304.05751838238,1968.69006049611,3,9
"912352353",11,1629.28929774475,1298.29051029949,1933.98659929558,3,8
"912352354",8,1632.379430238,1289.33966388563,1812.11073017574,3,5
"912352355",15,1734.06671103037,1599.08527502873,2060.56118614118,4,11
"912352356",10,1724.52052891795,1624.02856917916,1896.67490607898,3,7
"912352357",7,1595.81415644322,1336.71473522331,1763.32076508842,3,4
"912352358",6,1544.70549419127,1252.15547058508,1708.62817714657,2,4
"912352359",8,1658.80664426356,1594.00746744306,1812.11073017574,3,5
"912352360",5,1584.97577721975,1559.64026847664,1646.12614877363,2,3
"912352365",11,1585.29180271329,1360.7441954818,1933.98659929558,3,8
"912352366",10,1651.02091542646,1420.78665894997,1896.67490607898,2,8
"912352367",7,1576.06320497746,1697.46739203317,1763.32076508842,2,5
"912352368",6,1554.03740432107,1608.64914748659,1708.62817714657,1,5
"912352369",5,1525.90108277957,1479.04166219074,1646.12614877363,1,4
"912352370",8,1597.251024456,1579.16515694119,1812.11073017574,2,6
"912352375",9,1651.89440686237,1704.23846243936,1856.26587460569,4,5
"912352376",7,1640.69810589395,1634.37341399442,1763.32076508842,2,5
"912352377",7,1641.74594308393,1613.33937618956,1763.32076508842,2,5
"912352378",8,1590.29852778831,1500.98720020154,1812.11073017574,2,6
"912352379",7,1585.61028504198,1569.305557283,1763.32076508842,2,5
"912352380",12,1756.59850089651,1678.50281686405,1968.69006049611,2,10
"912352381",10,1618.63886966828,1674.03988403926,1896.67490607898,2,8
"912352382",7,1665.1518254827,1626.84480215967,1763.32076508842,2,5
"912352387",9,1647.3169177394,1675.58822018086,1856.26587460569,4,5
"912352388",9,1713.94458261384,1594.1293595505,1856.26587460569,2,7
"912352389",12,1698.73532170782,1772.06209209517,1968.69006049611,3,9
"912352390",4,1487.43818566287,1529.0332191144,1572.73281143487,1,3
"912352391",7,1638.4406899975,1694.91272615091,1763.32076508842,2,5
"912352392",8,1605.97232647144,1686.39483278656,1812.11073017574,2,6
"912352393",4,1510.76568556319,1570.83623371042,1572.73281143487,2,2
"912352394",10,1722.58590104038,1750.75750785174,1896.67490607898,3,7
"912352395",2,1317.90000378705,1364.97646362037,1364.97646362037,1,1
"912352396",3,1385.47466498958,1436.57912164902,1482.92019466158,1,2
"912352397",2,1348.39882161626,1368.39554591045,1364.97646362037,1,1
"912352398",2,1344.66647943542,1366.68493556149,1364.97646362037,2,0
"912352399",8,1606.69590518092,1503.08817960458,1812.11073017574,2,6
"912352400",5,1507.24043372212,1346.4708103899,1646.12614877363,1,4
"912352401",4,1457.28263111716,1272.23321284631,1572.73281143487,1,3
"912352402",6,1552.34300645059,1327.88295537934,1708.62817714657,2,4
"912352415",8,1589.59365365367,1376.09749208708,1812.11073017574,1,7
"912352416",8,1636.88393982607,1453.36959659655,1812.11073017574,2,6
"912352417",8,1683.17718926705,1332.14329814257,1812.11073017574,1,7
"912352418",8,1693.76838702088,1452.287320347,1812.11073017574,3,5
"912352419",2,1324.30096493139,1297.99593385555,1364.97646362037,1,1
"912352420",7,1599.2380687562,1419.1924535175,1763.32076508842,3,4
"912352421",9,1663.95813056088,1416.45023426185,1856.26587460569,3,6
"912352422",7,1627.10153058302,1453.32335150855,1763.32076508842,3,4
"912352423",8,1552.998591991,1393.27972108184,1812.11073017574,2,6
"912352424",5,1563.79693491823,1523.46586288995,1646.12614877363,2,3
"912352425",12,1541.80208386851,1429.84633767711,1968.69006049611,3,9
"912352426",9,1560.31758885323,1264.21964569004,1856.26587460569,3,6
"912352427",6,1469.74434197994,1201.73027389215,1708.62817714657,1,5
"912352428",9,1603.45684029437,1415.3194341456,1856.26587460569,3,6
"912352429",8,1632.26188912075,1406.20382419676,1812.11073017574,3,5
"912352430",5,1455.13189286058,1244.52600187532,1646.12614877363,2,3
"912352431",7,1569.32502975644,1390.41173618959,1763.32076508842,2,5
"912352432",7,1586.48299751169,1458.26340870903,1763.32076508842,1,6
"912352433",9,1624.38032783746,1522.49563408004,1856.26587460569,3,6
"912352434",9,1598.70882870097,1395.63671085672,1856.26587460569,3,6
"912352435",3,1385.6739462962,1246.71949964437,1482.92019466158,1,2
"912352436",10,1619.66803494265,1447.59043175661,1896.67490607898,3,7
"912352437",6,1560.27920001464,1323.91142203256,1708.62817714657,2,4
"912352438",3,1434.3621351892,1370.10252674079,1482.92019466158,2,1
"912352439",5,1546.82862770905,1480.65387397952,1646.12614877363,3,2
"912352440",4,1498.65930405938,1442.80641335695,1572.73281143487,2,2
"912352441",7,1625.31651027276,1614.43959952815,1763.32076508842,3,4
"912352442",7,1685.94586163333,1423.22678401689,1763.32076508842,2,5
"912352443",11,1754.99105375485,1516.04851841165,1933.98659929558,2,9
"912352444",15,1704.20311370188,1417.27019773221,2060.56118614118,4,11
"912352445",9,1715.97777983268,1392.41841412206,1856.26587460569,1,8
"912352446",2,1306.33006493936,1117.11354754405,1364.97646362037,1,1
"912352481",5,1587.88175170588,1472.88833611944,1646.12614877363,0,5
